Classifier: LinearSVC
Params: {'C': 1.0, 'class_weight': None, 'dual': True, 'fit_intercept': True, 'intercept_scaling': 1, 'loss': 'squared_hinge', 'max_iter': 1000, 'multi_class': 'ovr', 'penalty': 'l2', 'random_state': None, 'tol': 0.0001, 'verbose': 0}

Labels: None

Training accuracy: 0.9985557828860272
Training confusion matrix:
[[ 932    0    2    0    0    3    0    0    0    0    0    0    0    0    0    0    0    0    0    0]
 [   0   50    0    0    0    0    0    0    0    0    0    0    0    0    0    0    0    0    0    0]
 [   1    0  358    0    0    0    0    0    0    0    0    0    0    0    0    0    0    0    0    0]
 [   0    0    0  231    0    0    0    0    0    0    0    0    0    0    0    0    0    0    0    0]
 [   0    0    0    0  147    0    0    0    0    0    0    0    0    0    0    0    0    0    0    0]
 [   0    0    0    0    0 1235    0    0    0    0    0    0    0    0    0    0    0    0    0    0]
 [   0    0    0    0    0    0  211    0    0    0    0    0    0    0    0    0    0    0    0    0]
 [   0    0    0    0    0    0    0    1    0    0    0    0    0    0    0    0    0    0    0    0]
 [   0    0    0    0    0    0    0    0   14    0    0    0    0    0    0    0    0    0    0    0]
 [   0    0    0    0    0    0    0    0    0   98    0    0    1    0    0    0    0    0    0    0]
 [   1    0    0    0    0    0    0    0    0    0   63    0    0    0    0    0    0    0    0    0]
 [   0    0    0    0    0    0    0    0    0    0    0  422    0    0    0    0    0    0    0    0]
 [   0    0    0    0    0    0    0    0    0    0    0    0   58    0    0    0    0    0    0    0]
 [   0    0    0    0    0    0    0    0    0    0    0    0    0   20    0    0    0    0    0    0]
 [   0    0    0    0    0    0    0    0    0    0    0    0    0    0   29    0    0    0    0    0]
 [   1    0    0    0    0    1    0    0    0    0    0    0    0    0    0 1235    0    0    0    0]
 [   1    0    0    0    0    0    0    0    0    0    0    0    0    0    0    0  269    0    0    0]
 [   0    0    0    0    0    0    1    0    0    0    0    0    0    0    0    0    0 2618    0    0]
 [   0    0    0    0    0    0    0    0    0    0    0    0    0    0    0    0    0    0   75    0]
 [   0    0    0    0    0    0    0    0    0    0    0    0    0    0    0    0    0    0    0  231]]

Accuracy: 0.5451581783706464

Precision: [0.6228 0.6500 0.0085 0.0000 0.8750 0.0000 0.8000 0.0463 0.0558 1.0000 0.8879 0.0000 0.0000 0.0000 0.3414 1.0000 0.7500 0.4825 0.1682 0.4419 0.0086 0.0000 0.0234 0.0000 0.0000 0.0833]
Mean: 0.3171383687427933
Std: 0.3688686813039367

Recall: [0.8758 0.2097 1.0000 0.0000 1.0000 0.0000 1.0000 1.0000 1.0000 0.0001 0.7765 0.0000 0.0000 0.0000 0.8997 1.0000 0.1319 0.4218 0.5435 0.7140 1.0000 0.0000 1.0000 0.0000 0.0000 1.0000]
Mean: 0.5220291534307584
Std: 0.4445491286542131

F1 score: [0.7279 0.3171 0.0168 0.0000 0.9333 0.0000 0.8889 0.0885 0.1057 0.0002 0.8285 0.0000 0.0000 0.0000 0.4949 1.0000 0.2243 0.4501 0.2568 0.5459 0.0171 0.0000 0.0458 0.0000 0.0000 0.1538]
Mean: 0.2729136584289905
Std: 0.3367643983218407

Cohen Kappa score: 0.13702083174679214
Confusion matrix:
[[15253    21     1     0     0     0     0    62   219     0    25     0     0     0   110     0     4     2    27    60  1205    11   408     0     0     9]
 [   81    52   113     0     0     0     1     0     0     0     0     0     0     0     0     0     0     0     1     0     0     0     0     0     0     0]
 [    0     0     1     0     0     0     0     0     0     0     0     0     0     0     0     0     0     0     0     0     0     0     0     0     0     0]
 [  106     1     0     0     0     0     0    99     1     0     0     0     0     0    27     0     0     0     3     2     2     1     2     0     0     0]
 [    0     0     0     0    21     0     0     0     0     0     0     0     0     0     0     0     0     0     0     0     0     0     0     0     0     0]
 [   14     0     0     0     0     0     0     0     0     0     0     0     0     0    39     0     0    39     9    89     0     0     2     0     0     0]
 [    0     0     0     0     0     0     4     0     0     0     0     0     0     0     0     0     0     0     0     0     0     0     0     0     0     0]
 [    0     0     0     0     0     0     0    10     0     0     0     0     0     0     0     0     0     0     0     0     0     0     0     0     0     0]
 [    0     0     0     0     0     0     0     0    13     0     0     0     0     0     0     0     0     0     0     0     0     0     0     0     0     0]
 [ 7304     0     0     0     1     0     0    43     0     1     0     0     0     0   164     0     0     0   278     1    45     0   713     0     0     1]
 [   48     0     0     0     0     0     0     0     0     0   198     0     0     0     0     0     0     0     0     0     9     0     0     0     0     0]
 [ 1473     0     0     0     0     0     0     0     0     0     0     0     0     0     0     0     0     0     0     0     4     0     0     0     0     0]
 [    0     0     0     0     0     0     0     0     0     0     0     0     0     0    33     0     0    28     7    67     0     0     0     0     0     0]
 [    1     0     0     0     0     0     0     0     0     0     0     0     0     0    40     0     0    18     3    46     0     0     0     0     0     0]
 [    6     0     0     0     0     0     0     0     0     0     0     0     0     0   269     0     0     0    12    12     0     0     0     0     0     0]
 [    0     0     0     0     0     0     0     0     0     0     0     0     0     0     0     4     0     0     0     0     0     0     0     0     0     0]
 [   72     2     0     0     2     0     0     0     0     0     0     0     0     0     1     0    12     0     1     1     0     0     0     0     0     0]
 [    4     0     0     0     0     0     0     0     0     0     0     0     0     0    60     0     0   124     7    99     0     0     0     0     0     0]
 [    2     0     0     0     0     0     0     0     0     0     0     0     0     0    40     0     0     4    75    17     0     0     0     0     0     0]
 [   52     0     3     0     0     0     0     0     0     0     0     0     0     0     5     0     0    42    23   312     0     0     0     0     0     0]
 [    0     0     0     0     0     0     0     0     0     0     0     0     0     0     0     0     0     0     0     0    11     0     0     0     0     0]
 [    0     0     0     0     0     0     0     0     0     0     0     0     0     0     0     0     0     0     0     0     0     0     0     0     0     0]
 [    0     0     0     0     0     0     0     0     0     0     0     0     0     0     0     0     0     0     0     0     0     0    27     0     0     0]
 [   43     0     0     0     0     0     0     0     0     0     0     0     0     0     0     0     0     0     0     0     0     1     0     0     0     1]
 [   32     4     0     0     0     0     0     2     0     0     0     0     0     0     0     0     0     0     0     0     0     0     0     0     0     0]
 [    0     0     0     0     0     0     0     0     0     0     0     0     0     0     0     0     0     0     0     0     0     0     0     0     0     1]]

