Classifier: LogisticRegression
Params: {'C': 1.0, 'class_weight': None, 'dual': False, 'fit_intercept': True, 'intercept_scaling': 1, 'max_iter': 100, 'multi_class': 'ovr', 'n_jobs': 1, 'penalty': 'l2', 'random_state': None, 'solver': 'liblinear', 'tol': 0.0001, 'verbose': 0, 'warm_start': False}

Labels: None

Training accuracy: 0.995185942953424
Training confusion matrix:
[[ 919    0    3    0    0    7    0    0    0    0    0    0    0    0    0    4    2    1    0    1]
 [   0   50    0    0    0    0    0    0    0    0    0    0    0    0    0    0    0    0    0    0]
 [   1    0  358    0    0    0    0    0    0    0    0    0    0    0    0    0    0    0    0    0]
 [   0    0    0  231    0    0    0    0    0    0    0    0    0    0    0    0    0    0    0    0]
 [   0    0    0    0  147    0    0    0    0    0    0    0    0    0    0    0    0    0    0    0]
 [   4    0    1    0    0 1226    0    0    0    0    0    0    0    0    0    4    0    0    0    0]
 [   0    0    0    0    0    0  211    0    0    0    0    0    0    0    0    0    0    0    0    0]
 [   1    0    0    0    0    0    0    0    0    0    0    0    0    0    0    0    0    0    0    0]
 [   0    0    0    0    0    0    0    0   14    0    0    0    0    0    0    0    0    0    0    0]
 [   0    0    0    0    0    0    0    0    0   98    0    0    1    0    0    0    0    0    0    0]
 [   1    0    0    0    0    0    0    0    0    0   63    0    0    0    0    0    0    0    0    0]
 [   0    0    0    0    0    0    0    0    0    0    0  422    0    0    0    0    0    0    0    0]
 [   0    0    0    0    0    0    0    0    0    0    0    0   58    0    0    0    0    0    0    0]
 [   0    0    0    0    0    0    0    0    0    0    0    0    0   20    0    0    0    0    0    0]
 [   0    0    0    0    0    0    0    0    0    0    0    0    0    0   29    0    0    0    0    0]
 [   4    0    0    0    0    1    0    0    0    0    0    0    0    0    0 1232    0    0    0    0]
 [   1    0    0    0    0    0    0    0    0    0    0    0    0    0    0    0  269    0    0    0]
 [   0    0    0    0    0    0    1    0    0    0    0    0    0    0    0    0    0 2618    0    0]
 [   0    0    0    0    0    1    0    0    0    0    0    0    0    0    0    0    0    0   74    0]
 [   1    0    0    0    0    0    0    0    0    0    0    0    0    0    0    0    0    0    0  230]]

Accuracy: 0.5734672831908453

Precision: [0.6154 0.5429 0.0066 0.0000 1.0000 0.0000 1.0000 0.0212 0.0216 0.0000 0.9206 0.0000 0.0000 0.0000 0.3577 1.0000 1.0000 0.4113 0.6548 0.4617 0.0246 0.0000 0.8182 0.0000 0.0000 0.2000]
Mean: 0.348327238860711
Std: 0.3930344046103133

Recall: [0.9289 0.2298 1.0000 0.0000 1.0000 0.0000 1.0000 1.0000 1.0000 0.0000 0.6824 0.0000 0.0000 0.0000 0.8997 1.0000 0.1319 0.1735 0.3986 0.8009 1.0000 0.0000 1.0000 0.0000 0.0000 1.0000]
Mean: 0.5094454153627505
Std: 0.45109313161742365

F1 score: [0.7403 0.3229 0.0131 0.0000 1.0000 0.0000 1.0000 0.0416 0.0422 0.0000 0.7838 0.0000 0.0000 0.0000 0.5119 1.0000 0.2330 0.2440 0.4955 0.5858 0.0479 0.0000 0.9000 0.0000 0.0000 0.3333]
Mean: 0.31905323914241684
Std: 0.367510045761964

Cohen Kappa score: 0.13397863399837018
Confusion matrix:
[[16179    20    17     0     0     0     0    33   585     0    15     0     0     0   141     0     0     0     0    17   394     6     6     0     0     4]
 [   73    57   118     0     0     0     0     0     0     0     0     0     0     0     0     0     0     0     0     0     0     0     0     0     0     0]
 [    0     0     1     0     0     0     0     0     0     0     0     0     0     0     0     0     0     0     0     0     0     0     0     0     0     0]
 [   99    21     1     0     0     0     0    98     0     0     0     0     0     0    25     0     0     0     0     0     0     0     0     0     0     0]
 [    0     0     0     0    21     0     0     0     0     0     0     0     0     0     0     0     0     0     0     0     0     0     0     0     0     0]
 [   32     0     2     0     0     0     0     0     0     0     0     0     0     0    43     0     0    32     6    77     0     0     0     0     0     0]
 [    0     0     0     0     0     0     4     0     0     0     0     0     0     0     0     0     0     0     0     0     0     0     0     0     0     0]
 [    0     0     0     0     0     0     0    10     0     0     0     0     0     0     0     0     0     0     0     0     0     0     0     0     0     0]
 [    0     0     0     0     0     0     0     0    13     0     0     0     0     0     0     0     0     0     0     0     0     0     0     0     0     0]
 [ 8074     0     2     0     0     0     0   327     0     0     0     0     0     0   100     0     0     0     0     7    41     0     0     0     0     0]
 [   71     0     3     0     0     0     0     0     5     0   174     0     0     0     0     0     0     0     0     0     2     0     0     0     0     0]
 [ 1477     0     0     0     0     0     0     0     0     0     0     0     0     0     0     0     0     0     0     0     0     0     0     0     0     0]
 [    8     0     0     0     0     0     0     0     0     0     0     0     0     0    32     0     0    21     4    70     0     0     0     0     0     0]
 [   10     0     0     0     0     0     0     0     0     0     0     0     0     0    37     0     0    13     1    47     0     0     0     0     0     0]
 [   12     0     0     0     0     0     0     0     0     0     0     0     0     0   269     0     0     0     7    11     0     0     0     0     0     0]
 [    0     0     0     0     0     0     0     0     0     0     0     0     0     0     0     4     0     0     0     0     0     0     0     0     0     0]
 [   73     3     0     0     0     0     0     3     0     0     0     0     0     0     0     0    12     0     0     0     0     0     0     0     0     0]
 [   27     0     0     0     0     0     0     0     0     0     0     0     0     0    56     0     0    51     9   151     0     0     0     0     0     0]
 [    7     0     1     0     0     0     0     0     0     0     0     0     0     0    43     0     0     4    55    28     0     0     0     0     0     0]
 [   71     0     5     0     0     0     0     0     0     0     0     0     0     0     6     0     0     3     2   350     0     0     0     0     0     0]
 [    0     0     0     0     0     0     0     0     0     0     0     0     0     0     0     0     0     0     0     0    11     0     0     0     0     0]
 [    0     0     0     0     0     0     0     0     0     0     0     0     0     0     0     0     0     0     0     0     0     0     0     0     0     0]
 [    0     0     0     0     0     0     0     0     0     0     0     0     0     0     0     0     0     0     0     0     0     0    27     0     0     0]
 [   43     0     2     0     0     0     0     0     0     0     0     0     0     0     0     0     0     0     0     0     0     0     0     0     0     0]
 [   34     4     0     0     0     0     0     0     0     0     0     0     0     0     0     0     0     0     0     0     0     0     0     0     0     0]
 [    0     0     0     0     0     0     0     0     0     0     0     0     0     0     0     0     0     0     0     0     0     0     0     0     0     1]]

