Classifier: MultinomialNB
Params: {'alpha': 1.0, 'class_prior': None, 'fit_prior': True}

Labels: None

Training accuracy: 0.9267059814658803
Training confusion matrix:
[[ 794    4   17    2    0   27    0    0    0    8    0    0   45    0    0   21    9   10    0    0]
 [  10   39    1    0    0    0    0    0    0    0    0    0    0    0    0    0    0    0    0    0]
 [  14    1  317    8   10    5    0    0    0    0    0    0    0    0    0    2    2    0    0    0]
 [   2    0    0  222    4    0    0    0    0    0    0    0    0    0    0    1    0    2    0    0]
 [   0    0    0    1  143    0    1    0    0    0    0    2    0    0    0    0    0    0    0    0]
 [  59    0   14   27   11 1103    1    0    0    0    0    0    0    0    0   14    5    0    0    1]
 [   1    0    0    0    4    0  205    0    0    0    0    0    0    0    0    0    0    1    0    0]
 [   1    0    0    0    0    0    0    0    0    0    0    0    0    0    0    0    0    0    0    0]
 [   9    0    0    0    0    0    0    0    5    0    0    0    0    0    0    0    0    0    0    0]
 [   8    1    0    0    0    0    0    0    0   73    0    0   15    0    0    0    0    2    0    0]
 [   1    0    1    2    4    0    1    0    0    0   44    6    0    0    0    0    0    5    0    0]
 [   0    0    0    4    2    0    0    0    0    0    0  416    0    0    0    0    0    0    0    0]
 [   6    0    0    0    0    0    0    0    0    1    0    0   51    0    0    0    0    0    0    0]
 [   8    0    0    0    0    0    0    0    0    0    0    0    9    3    0    0    0    0    0    0]
 [   3    0    0    0    0    0    0    0    0    6    0    0   10    0    8    1    0    1    0    0]
 [  55    0    2    0    0    0    0    0    0    0    0    0    0    0    0 1177    0    0    0    3]
 [   7    0    7    0    0    3    0    0    0    0    0    0    0    0    0    2  250    1    0    0]
 [   5    0    1   13    8    0    5    0    0    0    1    0    0    0    0    0    0 2586    0    0]
 [   0    0    0    5    1    5    0    0    0    0    0    1    0    0    0    2    0    0   61    0]
 [  19    0    4    2    2    0    0    0    0    0    0    0    0    0    0    1    0    0    0  203]]

Accuracy: 0.1575130567845381

Precision: [0.3497 0.0343 0.0009 0.0000 0.1117 0.0000 0.0333 0.0117 0.0053 0.0000 0.9778 0.0000 0.0000 0.0000 0.0605 0.0189 0.0255 0.1824 0.0000 0.4615 0.1158 0.0000 0.0029 0.0000 0.0000 0.0000 0.0185]
Mean: 0.08928804531988394
Std: 0.20572960424609382

Recall: [0.2464 0.1331 1.0000 0.0000 1.0000 0.0000 1.0000 0.6000 1.0000 0.0000 0.1725 0.0000 0.0000 0.0000 0.2508 0.5000 0.1319 0.6429 0.0000 0.0137 1.0000 0.0000 0.9630 0.0000 0.0000 0.0000 1.0000]
Mean: 0.3575643096851244
Std: 0.4166544821576413

F1 score: [0.2891 0.0545 0.0018 0.0000 0.2010 0.0000 0.0645 0.0229 0.0105 0.0000 0.2933 0.0000 0.0000 0.0000 0.0975 0.0364 0.0427 0.2842 0.0000 0.0267 0.2075 0.0000 0.0058 0.0000 0.0000 0.0000 0.0364]
Mean: 0.062032879755354084
Std: 0.0966939898628003

Cohen Kappa score: -0.10552409048548883
Confusion matrix:
[[4291  545  400    0   59    0   63  462 2290    0    0    0    0    0   88   94  246  113    0    4   23   10 8677    0    0   14   38]
 [  15   33  195    0    0    0    4    1    0    0    0    0    0    0    0    0    0    0    0    0    0    0    0    0    0    0    0]
 [   0    0    1    0    0    0    0    0    0    0    0    0    0    0    0    0    0    0    0    0    0    0    0    0    0    0    0]
 [  47   16    1    0   59    0    1   31    0    0    0    0    0    0    3    7    6    0    0    0    2   19   52    0    0    0    0]
 [   0    0    0    0   21    0    0    0    0    0    0    0    0    0    0    0    0    0    0    0    0    0    0    0    0    0    0]
 [  31    0   37    0    0    0    0    2    0    0    0    0    0    0    3    0    0  119    0    0    0    0    0    0    0    0    0]
 [   0    0    0    0    0    0    4    0    0    0    0    0    0    0    0    0    0    0    0    0    0    0    0    0    0    0    0]
 [   0    0    0    0    3    0    1    6    0    0    0    0    0    0    0    0    0    0    0    0    0    0    0    0    0    0    0]
 [   0    0    0    0    0    0    0    0   13    0    0    0    0    0    0    0    0    0    0    0    0    0    0    0    0    0    0]
 [6814   11   23    0   28    0    1    2    6    0    1    0    0    0  998    1    3   73  446    0   10   12  107    0    0    1   14]
 [  95    3   81    0    6    0   17    0    3    0   44    0    0    0    5    0    0    1    0    0    0    0    0    0    0    0    0]
 [ 648  329    2    0    4    0    0    3  142    0    0    0    0    0   47    0  204   15    0    3   44   29    7    0    0    0    0]
 [   9    0   26    0    0    0    0    0    0    0    0    0    0    0    4    0    0   96    0    0    0    0    0    0    0    0    0]
 [   9    0   24    0    0    0    0    0    0    0    0    0    0    0    3    0    0   72    0    0    0    0    0    0    0    0    0]
 [  58    0   80    0    0    0   20    2    0    0    0    0    0    0   75    0    0   62    0    0    0    1    1    0    0    0    0]
 [   0    0    0    0    0    0    0    0    0    0    0    0    0    0    0    2    0    0    0    0    0    0    2    0    0    0    0]
 [  52   22    2    0    1    0    0    2    0    0    0    0    0    0    0    0   12    0    0    0    0    0    0    0    0    0    0]
 [  47    0   56    0    0    0    1    0    0    0    0    0    0    0    1    0    0  189    0    0    0    0    0    0    0    0    0]
 [  34    0   29    0    0    0    0    0    0    0    0    0    0    0   12    0    0   63    0    0    0    0    0    0    0    0    0]
 [  76    0  107    0    0    0    8    0    0    0    0    0    0    0    1    0    0  233    0    6    5    1    0    0    0    0    0]
 [   0    0    0    0    0    0    0    0    0    0    0    0    0    0    0    0    0    0    0    0   11    0    0    0    0    0    0]
 [   0    0    0    0    0    0    0    0    0    0    0    0    0    0    0    0    0    0    0    0    0    0    0    0    0    0    0]
 [   0    0    0    0    1    0    0    0    0    0    0    0    0    0    0    0    0    0    0    0    0    0   26    0    0    0    0]
 [   9    3   22    0    6    0    0    0    0    0    0    0    0    0    0    2    0    0    0    0    0    1    1    0    0    0    1]
 [  34    1    0    0    0    0    0    2    0    0    0    0    0    0    0    0    0    0    0    0    0    1    0    0    0    0    0]
 [   0    0    0    0    0    0    0    0    0    0    0    0    0    0    0    0    0    0    0    0    0    0    0    0    0    0    0]
 [   0    0    0    0    0    0    0    0    0    0    0    0    0    0    0    0    0    0    0    0    0    0    0    0    0    0    1]]

