Classifier: RandomForestClassifier
Params: {'bootstrap': True, 'class_weight': None, 'criterion': 'gini', 'max_depth': None, 'max_features': 'auto', 'max_leaf_nodes': None, 'min_impurity_decrease': 0.0, 'min_impurity_split': None, 'min_samples_leaf': 1, 'min_samples_split': 2, 'min_weight_fraction_leaf': 0.0, 'n_estimators': 100, 'n_jobs': 1, 'oob_score': False, 'random_state': None, 'verbose': 0, 'warm_start': False}

Labels: None

Training accuracy: 0.9995185942953424
Training confusion matrix:
[[ 936    0    1    0    0    0    0    0    0    0    0    0    0    0    0    0    0    0    0    0]
 [   0   50    0    0    0    0    0    0    0    0    0    0    0    0    0    0    0    0    0    0]
 [   0    0  359    0    0    0    0    0    0    0    0    0    0    0    0    0    0    0    0    0]
 [   0    0    0  231    0    0    0    0    0    0    0    0    0    0    0    0    0    0    0    0]
 [   0    0    0    0  147    0    0    0    0    0    0    0    0    0    0    0    0    0    0    0]
 [   0    0    0    0    0 1234    0    0    0    0    0    0    0    0    0    1    0    0    0    0]
 [   0    0    0    0    0    0  211    0    0    0    0    0    0    0    0    0    0    0    0    0]
 [   0    0    0    0    0    0    0    1    0    0    0    0    0    0    0    0    0    0    0    0]
 [   0    0    0    0    0    0    0    0   14    0    0    0    0    0    0    0    0    0    0    0]
 [   0    0    0    0    0    0    0    0    0   98    0    0    1    0    0    0    0    0    0    0]
 [   0    0    0    0    0    0    0    0    0    0   64    0    0    0    0    0    0    0    0    0]
 [   0    0    0    0    0    0    0    0    0    0    0  422    0    0    0    0    0    0    0    0]
 [   0    0    0    0    0    0    0    0    0    0    0    0   58    0    0    0    0    0    0    0]
 [   0    0    0    0    0    0    0    0    0    0    0    0    0   20    0    0    0    0    0    0]
 [   0    0    0    0    0    0    0    0    0    0    0    0    0    0   29    0    0    0    0    0]
 [   1    0    0    0    0    0    0    0    0    0    0    0    0    0    0 1236    0    0    0    0]
 [   0    0    0    0    0    0    0    0    0    0    0    0    0    0    0    0  270    0    0    0]
 [   0    0    0    0    0    0    0    0    0    0    0    0    0    0    0    0    0 2619    0    0]
 [   0    0    0    0    0    0    0    0    0    0    0    0    0    0    0    0    0    0   75    0]
 [   0    0    0    0    0    0    0    0    0    0    0    0    0    0    0    0    0    0    0  231]]

Accuracy: 0.5743321912112039

Precision: [0.6089 0.4194 0.0014 0.0000 1.0000 0.0000 1.0000 0.0613 1.0000 1.0000 1.0000 0.0000 0.0000 0.0000 0.3351 1.0000 1.0000 0.1306 0.5652 0.4507 0.6111 0.0964 0.0000 0.0000 1.0000]
Mean: 0.45120755383208744
Std: 0.4240458540834688

Recall: [0.9618 0.1048 1.0000 0.0000 1.0000 0.0000 1.0000 1.0000 1.0000 0.0001 0.3804 0.0000 0.0000 0.0000 0.4348 1.0000 0.1099 0.2755 0.0942 0.1465 1.0000 1.0000 0.0000 0.0000 1.0000]
Mean: 0.46031792879108996
Std: 0.451251591442898

F1 score: [0.7457 0.1677 0.0028 0.0000 1.0000 0.0000 1.0000 0.1156 1.0000 0.0002 0.5511 0.0000 0.0000 0.0000 0.3785 1.0000 0.1980 0.1772 0.1615 0.2211 0.7586 0.1759 0.0000 0.0000 1.0000]
Mean: 0.3461620902499913
Std: 0.38991671471379385

Cohen Kappa score: 0.0929918254031642
Confusion matrix:
[[16751    15    84     0     0     0     0    21     0     0     0     0     0     0    28     0     0   287     0    29     5   197     0     0     0]
 [   31    26   190     0     0     0     0     1     0     0     0     0     0     0     0     0     0     0     0     0     0     0     0     0     0]
 [    0     0     1     0     0     0     0     0     0     0     0     0     0     0     0     0     0     0     0     0     0     0     0     0     0]
 [   84    15     5     0     0     0     0    90     0     0     0     0     0     0    16     0     0     0     0     0     0    34     0     0     0]
 [    0     0     0     0    21     0     0     0     0     0     0     0     0     0     0     0     0     0     0     0     0     0     0     0     0]
 [  111     0    14     0     0     0     0     0     0     0     0     0     0     0    15     0     0    28     5    18     0     1     0     0     0]
 [    0     0     0     0     0     0     4     0     0     0     0     0     0     0     0     0     0     0     0     0     0     0     0     0     0]
 [    0     0     0     0     0     0     0    10     0     0     0     0     0     0     0     0     0     0     0     0     0     0     0     0     0]
 [    0     0     0     0     0     0     0     0    13     0     0     0     0     0     0     0     0     0     0     0     0     0     0     0     0]
 [ 8322     0     0     0     0     0     0     1     0     1     0     0     0     0   113     0     0    95     0     0     2    17     0     0     0]
 [   63     0    95     0     0     0     0     0     0     0    97     0     0     0     0     0     0     0     0     0     0     0     0     0     0]
 [ 1448     0     0     0     0     0     0     0     0     0     0     0     0     0     0     0     0    25     0     4     0     0     0     0     0]
 [   65     0    12     0     0     0     0     2     0     0     0     0     0     0    16     0     0    22     4    14     0     0     0     0     0]
 [   66     0    11     0     0     0     0     0     0     0     0     0     0     0    14     0     0    12     1     4     0     0     0     0     0]
 [   39     3   124     0     0     0     0     3     0     0     0     0     0     0   130     0     0     0     0     0     0     0     0     0     0]
 [    0     0     0     0     0     0     0     0     0     0     0     0     0     0     0     4     0     0     0     0     0     0     0     0     0]
 [   76     0     0     0     0     0     0     1     0     0     0     0     0     0     0     0    10     0     0     0     0     4     0     0     0]
 [  142     0    56     0     0     0     0     3     0     0     0     0     0     0    12     0     0    81     0     0     0     0     0     0     0]
 [   23     0    42     0     0     0     0     5     0     0     0     0     0     0    22     0     0    24    13     9     0     0     0     0     0]
 [  233     0    65     0     0     0     0    11     0     0     0     0     0     0    22     0     0    42     0    64     0     0     0     0     0]
 [    0     0     0     0     0     0     0     0     0     0     0     0     0     0     0     0     0     0     0     0    11     0     0     0     0]
 [    0     0     0     0     0     0     0     0     0     0     0     0     0     0     0     0     0     0     0     0     0    27     0     0     0]
 [   19     2     5     0     0     0     0    15     0     0     0     0     0     0     0     0     0     4     0     0     0     0     0     0     0]
 [   37     1     0     0     0     0     0     0     0     0     0     0     0     0     0     0     0     0     0     0     0     0     0     0     0]
 [    0     0     0     0     0     0     0     0     0     0     0     0     0     0     0     0     0     0     0     0     0     0     0     0     1]]

