Classifier: GradientBoostingClassifier
Params: {'criterion': 'friedman_mse', 'init': None, 'learning_rate': 0.1, 'loss': 'deviance', 'max_depth': 3, 'max_features': None, 'max_leaf_nodes': None, 'min_impurity_decrease': 0.0, 'min_impurity_split': None, 'min_samples_leaf': 1, 'min_samples_split': 2, 'min_weight_fraction_leaf': 0.0, 'n_estimators': 100, 'presort': 'auto', 'random_state': None, 'subsample': 1.0, 'verbose': 0, 'warm_start': False}

Labels: None

Training accuracy: 0.9923442793849362
Training confusion matrix:
[[14705     0     0     0     0     0     0     3     0     0     0     0     0     0     1     0     2     0     0     0     0     0     1     0     0     0     0]
 [    2   235     0     0     0     0     0     0     0     0     0     0     0     0     0     0     0     0     0     0     0     0     0     0     0     0     0]
 [    0     0   291     0     0     0     0     0     0     0     0     0     0     0     0     0     0     0     0     0     0     0     0     0     0     0     0]
 [    8     0     0   182     0     0     0     0     0     0     0     0     0     0     0     0     0     0     0     0     0     0     0     0     0     0     0]
 [    0     0     0     0   199     0     0     0     0     0     0     0     0     0     0     0     0     0     0     0     0     0     0     0     0     0     0]
 [    0     0     0     0     0   136     0     0     0     0     0     0     3     1     1     0     0     0     2    17     0     0     0     0     0     0     0]
 [    0     0     0     0     0     0   110     0     0     0     0     0     0     0     0     0     0     0     0     0     0     0     0     0     0     0     0]
 [    0     0     0     0     0     0     0  1011     0     0     0     0     0     0     0     0     0     0     0     0     0     0     0     0     0     0     0]
 [    0     0     0     0     0     0     0     0   178     0     0     0     0     0     0     0     0     0     0     0     0     0     0     0     0     0     0]
 [    8     0     0     0     0     0     0     0     0  6796     0     0     0     0     0     0     0     0     0     0     0     0     0     0     0     0     0]
 [    0     0     0     0     0     0     0     0     0     0   216     0     0     0     0     0     0     0     0     0     0     0     0     0     0     0     0]
 [    0     0     0     0     0     0     0     0     0     0     0  1181     0     0     0     0     0     0     0     0     0     0     0     0     0     0     0]
 [    0     0     0     0     0     3     0     0     0     0     0     0    79     1     0     0     0     7     0    13     0     0     0     0     0     0     0]
 [    0     0     0     0     0     3     0     0     0     0     0     0     0    83     0     0     0     0     0     2     0     0     0     0     0     0     0]
 [    1     0     0     0     0     3     0     0     0     0     0     0     2     1   286     0     0     0     9     2     0     0     0     0     0     0     0]
 [    0     0     0     0     0     0     0     0     0     0     0     0     0     0     0    53     0     0     0     0     0     0     0     0     0     0     0]
 [    5     0     0     0     0     0     0     0     0     0     0     0     0     0     0     0   401     0     0     0     0     0     0     0     0     0     0]
 [    0     0     0     0     0     3     0     0     0     0     0     0     2     6     0     0     0   239     1    39     0     0     0     0     0     0     0]
 [    1     0     0     0     0     0     0     0     0     0     0     0     2     1    13     0     0     2    90     8     0     0     0     0     0     0     0]
 [    1     0     0     0     0     7     0     0     0     0     0     0    15     5     1     0     0    24     1   315     0     0     0     0     0     0     0]
 [    1     0     0     0     0     0     0     1     0     0     0     0     0     0     0     0     0     0     0     0  1008     0     0     0     0     0     0]
 [    0     0     0     0     0     0     0     0     0     0     0     0     0     0     0     0     0     0     0     0     0   221     0     0     0     0     0]
 [    0     0     0     0     0     0     0     0     0     0     0     0     0     0     0     0     0     0     0     0     0     0  2135     0     0     0     0]
 [    0     0     0     0     0     0     0     0     0     0     0     0     0     0     0     0     0     0     0     0     0     0     0    37     0     0     0]
 [    0     0     0     0     0     0     0     0     0     0     0     0     0     0     0     0     0     0     0     0     0     0     0     0    29     0     0]
 [    0     0     0     0     0     0     0     0     0     0     0     0     0     0     0     0     0     0     0     0     0     0     0     0     0    63     0]
 [    0     0     0     0     0     0     0     0     0     0     0     0     0     0     0     0     0     0     0     0     0     0     0     0     0     0   182]]

Accuracy: 0.9813656502475893

Precision: [0.9910 1.0000 0.9853 1.0000 1.0000 0.6786 1.0000 0.9830 1.0000 0.9994 0.9815 0.9966 0.5758 0.6000 0.9022 1.0000 1.0000 0.7121 0.8108 0.7041 0.9957 0.9796 0.9922 0.8889 1.0000 1.0000 1.0000]
Mean: 0.9176573882205118
Std: 0.13468988130217263

Recall: [0.9962 0.9016 0.9710 0.8889 1.0000 0.5938 1.0000 0.9872 0.9783 0.9989 1.0000 0.9966 0.5938 0.6000 0.8830 0.9333 0.9907 0.7581 0.7317 0.7113 0.9832 0.9796 0.9980 1.0000 0.8889 1.0000 1.0000]
Mean: 0.9023671057511486
Std: 0.13626591318060127

F1 score: [0.9936 0.9483 0.9781 0.9412 1.0000 0.6333 1.0000 0.9851 0.9890 0.9991 0.9907 0.9966 0.5846 0.6000 0.8925 0.9655 0.9953 0.7344 0.7692 0.7077 0.9894 0.9796 0.9951 0.9412 0.9412 1.0000 1.0000]
Mean: 0.9092837077240762
Std: 0.1335267734799455

Cohen Kappa score: 0.9738588182948681
Confusion matrix:
[[3628    0    1    0    0    1    0    4    0    0    1    1    0    0    1    0    0    0    0    0    1    0    3    1    0    0    0]
 [   6   55    0    0    0    0    0    0    0    0    0    0    0    0    0    0    0    0    0    0    0    0    0    0    0    0    0]
 [   1    0   67    0    0    0    0    0    0    0    0    0    0    0    0    0    0    0    0    0    0    1    0    0    0    0    0]
 [   6    0    0   48    0    0    0    0    0    0    0    0    0    0    0    0    0    0    0    0    0    0    0    0    0    0    0]
 [   0    0    0    0   53    0    0    0    0    0    0    0    0    0    0    0    0    0    0    0    0    0    0    0    0    0    0]
 [   0    0    0    0    0   19    0    0    0    0    0    0    2    0    1    0    0    1    2    7    0    0    0    0    0    0    0]
 [   0    0    0    0    0    0   41    0    0    0    0    0    0    0    0    0    0    0    0    0    0    0    0    0    0    0    0]
 [   3    0    0    0    0    0    0  231    0    0    0    0    0    0    0    0    0    0    0    0    0    0    0    0    0    0    0]
 [   0    0    0    0    0    0    0    0   45    0    0    0    0    0    0    0    0    0    0    0    0    0    1    0    0    0    0]
 [   2    0    0    0    0    0    0    0    0 1746    0    0    0    0    0    0    0    0    0    0    0    0    0    0    0    0    0]
 [   0    0    0    0    0    0    0    0    0    0   53    0    0    0    0    0    0    0    0    0    0    0    0    0    0    0    0]
 [   1    0    0    0    0    0    0    0    0    0    0  295    0    0    0    0    0    0    0    0    0    0    0    0    0    0    0]
 [   0    0    0    0    0    0    0    0    0    0    0    0   19    3    0    0    0    4    0    6    0    0    0    0    0    0    0]
 [   0    0    0    0    0    4    0    0    0    0    0    0    1   12    1    0    0    2    0    0    0    0    0    0    0    0    0]
 [   4    0    0    0    0    1    0    0    0    0    0    0    0    0   83    0    0    1    3    2    0    0    0    0    0    0    0]
 [   1    0    0    0    0    0    0    0    0    0    0    0    0    0    0   14    0    0    0    0    0    0    0    0    0    0    0]
 [   0    0    0    0    0    0    0    0    0    1    0    0    0    0    0    0  106    0    0    0    0    0    0    0    0    0    0]
 [   0    0    0    0    0    1    0    0    0    0    0    0    2    1    0    0    0   47    0   11    0    0    0    0    0    0    0]
 [   2    0    0    0    0    0    0    0    0    0    0    0    2    1    2    0    0    1   30    3    0    0    0    0    0    0    0]
 [   0    0    0    0    0    2    0    0    0    0    0    0    7    3    4    0    0   10    2   69    0    0    0    0    0    0    0]
 [   4    0    0    0    0    0    0    0    0    0    0    0    0    0    0    0    0    0    0    0  234    0    0    0    0    0    0]
 [   1    0    0    0    0    0    0    0    0    0    0    0    0    0    0    0    0    0    0    0    0   48    0    0    0    0    0]
 [   1    0    0    0    0    0    0    0    0    0    0    0    0    0    0    0    0    0    0    0    0    0  510    0    0    0    0]
 [   0    0    0    0    0    0    0    0    0    0    0    0    0    0    0    0    0    0    0    0    0    0    0    8    0    0    0]
 [   1    0    0    0    0    0    0    0    0    0    0    0    0    0    0    0    0    0    0    0    0    0    0    0    8    0    0]
 [   0    0    0    0    0    0    0    0    0    0    0    0    0    0    0    0    0    0    0    0    0    0    0    0    0   12    0]
 [   0    0    0    0    0    0    0    0    0    0    0    0    0    0    0    0    0    0    0    0    0    0    0    0    0    0   50]]

