Classifier: LinearSVC
Params: {'C': 1.0, 'class_weight': None, 'dual': True, 'fit_intercept': True, 'intercept_scaling': 1, 'loss': 'squared_hinge', 'max_iter': 1000, 'multi_class': 'ovr', 'penalty': 'l2', 'random_state': None, 'tol': 0.0001, 'verbose': 0}

Labels: None

Training accuracy: 0.9898683867604899
Training confusion matrix:
[[14701     0     1     0     0     0     0     1     0     0     0     0     0     0     1     0     5     0     0     0     0     0     1     0     2     0     0]
 [    0   237     0     0     0     0     0     0     0     0     0     0     0     0     0     0     0     0     0     0     0     0     0     0     0     0     0]
 [    1     0   290     0     0     0     0     0     0     0     0     0     0     0     0     0     0     0     0     0     0     0     0     0     0     0     0]
 [    5     0     0   185     0     0     0     0     0     0     0     0     0     0     0     0     0     0     0     0     0     0     0     0     0     0     0]
 [    0     0     0     0   199     0     0     0     0     0     0     0     0     0     0     0     0     0     0     0     0     0     0     0     0     0     0]
 [    0     0     0     0     0   119     0     0     0     0     0     0     4     0     1     0     0     3     4    29     0     0     0     0     0     0     0]
 [    0     0     0     0     0     0   110     0     0     0     0     0     0     0     0     0     0     0     0     0     0     0     0     0     0     0     0]
 [    0     0     0     0     0     0     0  1011     0     0     0     0     0     0     0     0     0     0     0     0     0     0     0     0     0     0     0]
 [    0     0     0     0     0     0     0     0   178     0     0     0     0     0     0     0     0     0     0     0     0     0     0     0     0     0     0]
 [    1     0     0     0     0     0     0     0     0  6803     0     0     0     0     0     0     0     0     0     0     0     0     0     0     0     0     0]
 [    0     0     0     0     0     0     0     0     0     0   216     0     0     0     0     0     0     0     0     0     0     0     0     0     0     0     0]
 [    0     0     0     0     0     0     0     0     0     0     0  1181     0     0     0     0     0     0     0     0     0     0     0     0     0     0     0]
 [    0     0     0     0     0     2     0     0     0     0     0     0    81     7     0     0     0     6     0     7     0     0     0     0     0     0     0]
 [    0     0     0     0     0     5     0     0     0     0     0     0     0    76     2     0     0     2     0     3     0     0     0     0     0     0     0]
 [    0     0     0     0     0     3     0     0     0     0     0     0     2     0   291     0     0     0     5     3     0     0     0     0     0     0     0]
 [    0     0     0     0     0     0     0     0     0     0     0     0     0     0     0    53     0     0     0     0     0     0     0     0     0     0     0]
 [    3     0     0     0     0     0     0     0     0     0     0     0     0     0     0     0   403     0     0     0     0     0     0     0     0     0     0]
 [    0     0     0     0     0     8     0     0     0     0     0     0     9     9     1     0     0   238     0    25     0     0     0     0     0     0     0]
 [    0     0     0     0     0     0     0     0     0     0     0     0     1     1    16     0     0     3    85    11     0     0     0     0     0     0     0]
 [    0     0     0     0     0    11     0     0     0     0     0     0    30    14     2     0     0    54     2   256     0     0     0     0     0     0     0]
 [    1     0     0     0     0     0     0     1     0     0     0     0     0     0     0     0     0     0     0     0  1008     0     0     0     0     0     0]
 [    1     0     0     0     0     0     0     0     0     0     0     0     0     0     0     0     0     0     0     0     0   220     0     0     0     0     0]
 [    0     0     0     0     0     0     0     0     1     0     0     0     0     0     0     0     0     0     0     0     0     0  2134     0     0     0     0]
 [    0     0     0     0     0     0     0     0     0     0     0     0     0     0     0     0     0     0     0     0     0     0     0    37     0     0     0]
 [    1     0     0     0     0     0     0     0     0     0     0     0     0     0     0     0     0     0     0     0     0     0     0     0    28     0     0]
 [    0     0     0     0     0     0     0     0     0     0     0     0     0     0     0     0     0     0     0     0     0     0     0     0     0    63     0]
 [    0     0     0     0     0     0     0     0     0     0     0     0     0     0     0     0     0     0     0     0     0     0     0     0     0     0   182]]

Accuracy: 0.9816262705238468

Precision: [0.9923 1.0000 0.9853 1.0000 1.0000 0.5517 1.0000 0.9871 1.0000 0.9989 0.9811 1.0000 0.5676 0.4800 0.8776 1.0000 0.9907 0.7246 0.8529 0.7349 0.9958 0.9792 0.9961 0.8889 1.0000 1.0000 1.0000]
Mean: 0.9105447106229676
Std: 0.15380214442152784

Recall: [0.9970 0.9672 0.9710 0.8889 1.0000 0.5000 1.0000 0.9829 0.9783 0.9989 0.9811 1.0000 0.6562 0.6000 0.9149 0.9333 0.9907 0.8065 0.7073 0.6289 0.9916 0.9592 1.0000 1.0000 0.7778 1.0000 0.9800]
Mean: 0.8967249945330957
Std: 0.14653281881144778

F1 score: [0.9947 0.9833 0.9781 0.9412 1.0000 0.5246 1.0000 0.9850 0.9890 0.9989 0.9811 1.0000 0.6087 0.5333 0.8958 0.9655 0.9907 0.7634 0.7733 0.6778 0.9937 0.9691 0.9980 0.9412 0.8750 1.0000 0.9899]
Mean: 0.9018982369079809
Std: 0.1472629204662013

Cohen Kappa score: 0.9742283687298663
Confusion matrix:
[[3631    0    1    0    0    0    0    3    0    2    1    0    0    0    0    0    1    0    0    0    1    0    1    1    0    0    0]
 [   2   59    0    0    0    0    0    0    0    0    0    0    0    0    0    0    0    0    0    0    0    0    0    0    0    0    0]
 [   1    0   67    0    0    0    0    0    0    0    0    0    0    0    0    0    0    0    0    0    0    1    0    0    0    0    0]
 [   6    0    0   48    0    0    0    0    0    0    0    0    0    0    0    0    0    0    0    0    0    0    0    0    0    0    0]
 [   0    0    0    0   53    0    0    0    0    0    0    0    0    0    0    0    0    0    0    0    0    0    0    0    0    0    0]
 [   0    0    0    0    0   16    0    0    0    0    0    0    3    1    0    0    0    1    3    8    0    0    0    0    0    0    0]
 [   0    0    0    0    0    0   41    0    0    0    0    0    0    0    0    0    0    0    0    0    0    0    0    0    0    0    0]
 [   4    0    0    0    0    0    0  230    0    0    0    0    0    0    0    0    0    0    0    0    0    0    0    0    0    0    0]
 [   0    0    0    0    0    0    0    0   45    0    0    0    0    0    0    0    0    0    0    0    0    0    1    0    0    0    0]
 [   2    0    0    0    0    0    0    0    0 1746    0    0    0    0    0    0    0    0    0    0    0    0    0    0    0    0    0]
 [   1    0    0    0    0    0    0    0    0    0   52    0    0    0    0    0    0    0    0    0    0    0    0    0    0    0    0]
 [   0    0    0    0    0    0    0    0    0    0    0  296    0    0    0    0    0    0    0    0    0    0    0    0    0    0    0]
 [   1    0    0    0    0    1    0    0    0    0    0    0   21    4    0    0    0    1    0    4    0    0    0    0    0    0    0]
 [   0    0    0    0    0    5    0    0    0    0    0    0    0   12    2    0    0    1    0    0    0    0    0    0    0    0    0]
 [   2    0    0    0    0    1    0    0    0    0    0    0    0    0   86    0    0    2    1    2    0    0    0    0    0    0    0]
 [   1    0    0    0    0    0    0    0    0    0    0    0    0    0    0   14    0    0    0    0    0    0    0    0    0    0    0]
 [   1    0    0    0    0    0    0    0    0    0    0    0    0    0    0    0  106    0    0    0    0    0    0    0    0    0    0]
 [   0    0    0    0    0    2    0    0    0    0    0    0    3    2    0    0    0   50    0    5    0    0    0    0    0    0    0]
 [   0    0    0    0    0    0    0    0    0    0    0    0    1    1    6    0    0    1   29    3    0    0    0    0    0    0    0]
 [   0    0    0    0    0    4    0    0    0    0    0    0    9    5    4    0    0   13    1   61    0    0    0    0    0    0    0]
 [   2    0    0    0    0    0    0    0    0    0    0    0    0    0    0    0    0    0    0    0  236    0    0    0    0    0    0]
 [   2    0    0    0    0    0    0    0    0    0    0    0    0    0    0    0    0    0    0    0    0   47    0    0    0    0    0]
 [   0    0    0    0    0    0    0    0    0    0    0    0    0    0    0    0    0    0    0    0    0    0  511    0    0    0    0]
 [   0    0    0    0    0    0    0    0    0    0    0    0    0    0    0    0    0    0    0    0    0    0    0    8    0    0    0]
 [   2    0    0    0    0    0    0    0    0    0    0    0    0    0    0    0    0    0    0    0    0    0    0    0    7    0    0]
 [   0    0    0    0    0    0    0    0    0    0    0    0    0    0    0    0    0    0    0    0    0    0    0    0    0   12    0]
 [   1    0    0    0    0    0    0    0    0    0    0    0    0    0    0    0    0    0    0    0    0    0    0    0    0    0   49]]

