Classifier: LogisticRegression
Params: {'C': 1.0, 'class_weight': None, 'dual': False, 'fit_intercept': True, 'intercept_scaling': 1, 'max_iter': 100, 'multi_class': 'ovr', 'n_jobs': 1, 'penalty': 'l2', 'random_state': None, 'solver': 'liblinear', 'tol': 0.0001, 'verbose': 0, 'warm_start': False}

Labels: None

Training accuracy: 0.9875228042741725
Training confusion matrix:
[[14678     4     3     0     0     0     0     5     0     0     1     0     0     0     1     0     5     0     0     0     5     2     4     1     2     0     1]
 [    1   236     0     0     0     0     0     0     0     0     0     0     0     0     0     0     0     0     0     0     0     0     0     0     0     0     0]
 [    2     0   289     0     0     0     0     0     0     0     0     0     0     0     0     0     0     0     0     0     0     0     0     0     0     0     0]
 [    9     0     0   181     0     0     0     0     0     0     0     0     0     0     0     0     0     0     0     0     0     0     0     0     0     0     0]
 [    0     0     0     0   199     0     0     0     0     0     0     0     0     0     0     0     0     0     0     0     0     0     0     0     0     0     0]
 [    0     0     0     0     0   114     0     0     0     0     0     0     8     0     5     0     0     2     4    27     0     0     0     0     0     0     0]
 [    0     0     0     0     0     0   110     0     0     0     0     0     0     0     0     0     0     0     0     0     0     0     0     0     0     0     0]
 [    1     0     1     0     0     0     0  1005     0     0     0     0     0     0     0     0     0     0     0     0     4     0     0     0     0     0     0]
 [    0     0     0     0     0     0     0     0   178     0     0     0     0     0     0     0     0     0     0     0     0     0     0     0     0     0     0]
 [    4     0     0     0     0     0     0     0     0  6800     0     0     0     0     0     0     0     0     0     0     0     0     0     0     0     0     0]
 [    3     0     0     0     0     0     0     0     0     0   213     0     0     0     0     0     0     0     0     0     0     0     0     0     0     0     0]
 [    0     0     0     0     0     0     0     0     0     0     0  1181     0     0     0     0     0     0     0     0     0     0     0     0     0     0     0]
 [    0     0     0     0     0     2     0     0     0     0     0     0    69     7     0     0     0     6     0    19     0     0     0     0     0     0     0]
 [    0     0     0     0     0     7     0     0     0     0     0     0     0    72     2     0     0     2     0     5     0     0     0     0     0     0     0]
 [    2     0     0     0     0     2     0     0     0     0     0     0     2     0   290     0     0     0     5     3     0     0     0     0     0     0     0]
 [    0     0     0     0     0     0     0     0     0     0     0     0     0     0     0    53     0     0     0     0     0     0     0     0     0     0     0]
 [    4     0     0     0     0     0     0     0     0     0     0     0     0     0     0     0   401     0     0     0     0     0     0     0     1     0     0]
 [    0     0     0     0     0     9     0     0     0     0     0     0    10     8     1     0     0   227     1    34     0     0     0     0     0     0     0]
 [    0     0     0     0     0     0     0     0     0     0     0     0     2     1    19     0     0     3    80    12     0     0     0     0     0     0     0]
 [    1     0     0     0     0    11     0     0     0     0     0     0    21    12     4     0     0    45     2   273     0     0     0     0     0     0     0]
 [    4     0     0     0     0     0     0     1     0     0     0     0     0     0     0     0     0     0     0     0  1005     0     0     0     0     0     0]
 [    1     0     0     0     0     0     0     0     0     0     0     0     0     0     0     0     0     0     0     0     0   220     0     0     0     0     0]
 [    1     0     0     0     0     0     0     0     1     0     0     0     0     0     0     0     0     0     0     0     0     0  2133     0     0     0     0]
 [    1     0     0     0     0     0     0     0     0     1     0     0     0     0     0     0     0     0     0     0     0     0     0    35     0     0     0]
 [    1     0     0     1     0     0     0     0     0     0     0     0     0     0     0     0     0     0     0     0     0     0     0     0    27     0     0]
 [    0     0     0     0     0     0     0     1     0     0     0     0     0     0     0     0     0     0     0     0     0     0     0     0     0    62     0]
 [    0     0     0     0     0     0     0     0     0     0     0     0     0     0     0     0     0     0     0     0     0     0     0     0     0     0   182]]

Accuracy: 0.9803231691425592

Precision: [0.9905 1.0000 0.9714 1.0000 1.0000 0.5172 1.0000 0.9871 1.0000 0.9989 1.0000 1.0000 0.5938 0.4286 0.8431 1.0000 0.9907 0.7679 0.8065 0.7030 0.9958 1.0000 0.9942 1.0000 1.0000 1.0000 1.0000]
Mean: 0.9106836310130886
Std: 0.1626895269890703

Recall: [0.9973 0.9836 0.9855 0.8704 1.0000 0.4688 1.0000 0.9829 0.9783 0.9977 0.9434 1.0000 0.5938 0.4500 0.9149 0.9333 0.9907 0.6935 0.6098 0.7320 0.9958 0.9388 1.0000 1.0000 0.7778 1.0000 0.9600]
Mean: 0.8814077477855723
Std: 0.1695168733325051

F1 score: [0.9938 0.9917 0.9784 0.9307 1.0000 0.4918 1.0000 0.9850 0.9890 0.9983 0.9709 1.0000 0.5938 0.4390 0.8776 0.9655 0.9907 0.7288 0.6944 0.7172 0.9958 0.9684 0.9971 1.0000 0.8750 1.0000 0.9796]
Mean: 0.8945363544037384
Std: 0.16380796643512602

Cohen Kappa score: 0.9723827202134233
Confusion matrix:
[[3632    0    1    0    0    0    0    3    0    2    0    0    0    0    0    0    1    0    0    0    1    0    2    0    0    0    0]
 [   1   60    0    0    0    0    0    0    0    0    0    0    0    0    0    0    0    0    0    0    0    0    0    0    0    0    0]
 [   1    0   68    0    0    0    0    0    0    0    0    0    0    0    0    0    0    0    0    0    0    0    0    0    0    0    0]
 [   7    0    0   47    0    0    0    0    0    0    0    0    0    0    0    0    0    0    0    0    0    0    0    0    0    0    0]
 [   0    0    0    0   53    0    0    0    0    0    0    0    0    0    0    0    0    0    0    0    0    0    0    0    0    0    0]
 [   0    0    0    0    0   15    0    0    0    0    0    0    3    1    1    0    0    1    3    8    0    0    0    0    0    0    0]
 [   0    0    0    0    0    0   41    0    0    0    0    0    0    0    0    0    0    0    0    0    0    0    0    0    0    0    0]
 [   4    0    0    0    0    0    0  230    0    0    0    0    0    0    0    0    0    0    0    0    0    0    0    0    0    0    0]
 [   0    0    0    0    0    0    0    0   45    0    0    0    0    0    0    0    0    0    0    0    0    0    1    0    0    0    0]
 [   4    0    0    0    0    0    0    0    0 1744    0    0    0    0    0    0    0    0    0    0    0    0    0    0    0    0    0]
 [   3    0    0    0    0    0    0    0    0    0   50    0    0    0    0    0    0    0    0    0    0    0    0    0    0    0    0]
 [   0    0    0    0    0    0    0    0    0    0    0  296    0    0    0    0    0    0    0    0    0    0    0    0    0    0    0]
 [   1    0    0    0    0    1    0    0    0    0    0    0   19    4    0    0    0    1    1    5    0    0    0    0    0    0    0]
 [   0    0    0    0    0    7    0    0    0    0    0    0    0    9    2    0    0    1    0    1    0    0    0    0    0    0    0]
 [   3    0    0    0    0    1    0    0    0    0    0    0    0    0   86    0    0    1    1    2    0    0    0    0    0    0    0]
 [   1    0    0    0    0    0    0    0    0    0    0    0    0    0    0   14    0    0    0    0    0    0    0    0    0    0    0]
 [   1    0    0    0    0    0    0    0    0    0    0    0    0    0    0    0  106    0    0    0    0    0    0    0    0    0    0]
 [   1    0    0    0    0    2    0    0    0    0    0    0    3    2    0    0    0   43    0   11    0    0    0    0    0    0    0]
 [   1    0    0    0    0    0    0    0    0    0    0    0    2    1    9    0    0    0   25    3    0    0    0    0    0    0    0]
 [   0    0    0    0    0    3    0    0    0    0    0    0    5    4    4    0    0    9    1   71    0    0    0    0    0    0    0]
 [   1    0    0    0    0    0    0    0    0    0    0    0    0    0    0    0    0    0    0    0  237    0    0    0    0    0    0]
 [   3    0    0    0    0    0    0    0    0    0    0    0    0    0    0    0    0    0    0    0    0   46    0    0    0    0    0]
 [   0    0    0    0    0    0    0    0    0    0    0    0    0    0    0    0    0    0    0    0    0    0  511    0    0    0    0]
 [   0    0    0    0    0    0    0    0    0    0    0    0    0    0    0    0    0    0    0    0    0    0    0    8    0    0    0]
 [   2    0    0    0    0    0    0    0    0    0    0    0    0    0    0    0    0    0    0    0    0    0    0    0    7    0    0]
 [   0    0    0    0    0    0    0    0    0    0    0    0    0    0    0    0    0    0    0    0    0    0    0    0    0   12    0]
 [   1    0    1    0    0    0    0    0    0    0    0    0    0    0    0    0    0    0    0    0    0    0    0    0    0    0   48]]

