Classifier: MultinomialNB
Params: {'alpha': 1.0, 'class_prior': None, 'fit_prior': True}

Labels: None

Training accuracy: 0.8992702632264791
Training confusion matrix:
[[12936   128    21   333     8     2     0    91     1    33   327    13     0     0   158     0    36    77    14    74    23    14     8    24   166     0   225]
 [    3   234     0     0     0     0     0     0     0     0     0     0     0     0     0     0     0     0     0     0     0     0     0     0     0     0     0]
 [    2     0   263     1     8     0    10     4     0     0     0     0     0     0     0     0     0     0     0     0     2     1     0     0     0     0     0]
 [   16     0     0   172     0     0     0     0     0     0     0     0     0     0     0     0     2     0     0     0     0     0     0     0     0     0     0]
 [    0     0     0     0   198     0     0     0     0     0     0     0     0     0     0     0     0     0     0     0     0     0     1     0     0     0     0]
 [    0     0     0     0     0    48     0     0     0     0     0     0     0     0     6     0     0     3     0   103     0     0     0     0     0     0     0]
 [    0     0     0     0     0     0   110     0     0     0     0     0     0     0     0     0     0     0     0     0     0     0     0     0     0     0     0]
 [    1     0    16     3    25     0    11   925     2     0     0     0     0     0     0     0     0     0     0     0    15     5     0     0     0     0     8]
 [    1     0     0     0     0     0     2     0   175     0     0     0     0     0     0     0     0     0     0     0     0     0     0     0     0     0     0]
 [  243     0     0    13     0     0     0     0     0  6498    12     3     0     0    11     1     4     0     0     0     0     3    14     1     0     0     1]
 [   10     0     0     0     0     0     0     0     0     0   206     0     0     0     0     0     0     0     0     0     0     0     0     0     0     0     0]
 [   18     0     0     0     0     0     0     0     0     2     0  1161     0     0     0     0     0     0     0     0     0     0     0     0     0     0     0]
 [    0     0     0     0     0     6     0     0     0     0     0     0    10     0     0     0     0    13     0    74     0     0     0     0     0     0     0]
 [    0     0     0     0     0     4     0     0     0     0     0     0     3     6     1     0     0     5     0    69     0     0     0     0     0     0     0]
 [    1     0     0     0     0    12     0     1     0     0     0     0     1     1   244     0     0    20     0    22     0     0     2     0     0     0     0]
 [    0     0     1     0     3     0     2     0     1     0     0     0     0     0     0    36     3     0     0     0     0     0     7     0     0     0     0]
 [   11     0     0    40     3     0     2     0     0     0     0     0     0     0     0     0   348     0     0     0     0     0     0     0     2     0     0]
 [    6     0     0     0     0     8     0     0     0     0     0     0     0     0     4     0     0   116     1   155     0     0     0     0     0     0     0]
 [    0     0     0     0     0     6     0     0     0     0     0     0     0     0    43     0     0    33    11    24     0     0     0     0     0     0     0]
 [    0     0     0     0     0     2     0     0     0     0     3     0     0     0     4     0     0    24     0   332     1     0     3     0     0     0     0]
 [    2     0    14     0     0     0     0     0     0     0     0     0     0     0     0     0     0     0     0     0   991     0     0     0     0     0     3]
 [    0     0    10     0     0     0     0     4     0     0     0     0     0     0     0     0     0     0     0     0     2   205     0     0     0     0     0]
 [    4     0     1     1    12     0     7     0     2     0     0     0     0     0     0     1     0     0     0     0     0     0  2106     0     0     0     1]
 [    4    10     0     0     0     0     0     0     0     0     0     0     0     0     0     0     0     0     0     0     0     0     0    23     0     0     0]
 [    2     0     0     0     0     0     0     0     0     0     0     0     0     0     0     0     0     0     0     0     0     0     0     0    27     0     0]
 [    0     0     0     0     4     0     1     4     0     0     0     0     0     0     0     0     1     0     0     0     2     1     0     0     0    50     0]
 [    0     0     4     0     1     0     2     1     0     0     0     0     0     0     0     0     0     0     0     0     1     0     0     0     0     0   173]]

Accuracy: 0.8995308835027365

Precision: [0.9737 0.6977 0.7500 0.3650 0.7391 0.4167 0.8864 0.8926 0.9348 0.9935 0.3937 0.9965 0.2500 0.0000 0.4488 1.0000 0.9065 0.3506 0.6250 0.4065 0.9458 0.9783 0.9750 0.4167 0.1538 1.0000 0.4608]
Mean: 0.6650929818235513
Std: 0.3027474026143051

Recall: [0.8861 0.9836 0.8696 0.9259 0.9623 0.3125 0.9512 0.9231 0.9348 0.9594 0.9434 0.9730 0.0312 0.0000 0.6064 0.6000 0.9065 0.4355 0.1220 0.8969 0.9538 0.9184 0.9902 0.6250 0.8889 0.9167 0.9400]
Mean: 0.7576363291508298
Std: 0.30287609727325987

F1 score: [0.9278 0.8163 0.8054 0.5236 0.8361 0.3571 0.9176 0.9076 0.9348 0.9761 0.5556 0.9846 0.0556 0.0000 0.5158 0.7500 0.9065 0.3885 0.2041 0.5595 0.9498 0.9474 0.9825 0.5000 0.2623 0.9565 0.6184]
Mean: 0.6718336114318284
Std: 0.29817760826441664

Cohen Kappa score: 0.8634032927757218
Confusion matrix:
[[3227   23    5   79    2    1    0   25    0   11   74    1    0    0   43    0    6   16    2   20    8    0    4    7   44    0   44]
 [   1   60    0    0    0    0    0    0    0    0    0    0    0    0    0    0    0    0    0    0    0    0    0    0    0    0    0]
 [   1    1   60    0    5    0    1    0    0    0    0    0    0    0    0    0    0    0    0    0    0    1    0    0    0    0    0]
 [   4    0    0   50    0    0    0    0    0    0    0    0    0    0    0    0    0    0    0    0    0    0    0    0    0    0    0]
 [   0    0    0    0   51    0    0    0    0    0    0    0    0    0    0    0    0    0    0    0    1    0    1    0    0    0    0]
 [   0    0    0    0    0   10    0    0    0    0    0    0    0    0    0    0    0    0    0   22    0    0    0    0    0    0    0]
 [   0    0    0    0    0    0   39    0    1    0    0    0    0    0    0    0    1    0    0    0    0    0    0    0    0    0    0]
 [   1    0    7    0    5    0    0  216    0    0    0    0    0    0    0    0    0    0    0    0    1    0    0    0    0    0    4]
 [   0    0    0    0    0    0    2    0   43    0    0    0    0    0    0    0    0    0    0    0    0    0    1    0    0    0    0]
 [  60    0    0    0    0    0    0    0    0 1677    1    0    0    0    3    0    1    0    1    0    0    0    4    0    0    0    1]
 [   3    0    0    0    0    0    0    0    0    0   50    0    0    0    0    0    0    0    0    0    0    0    0    0    0    0    0]
 [   8    0    0    0    0    0    0    0    0    0    0  288    0    0    0    0    0    0    0    0    0    0    0    0    0    0    0]
 [   0    0    0    0    0    3    0    0    0    0    0    0    1    0    3    0    0    4    0   21    0    0    0    0    0    0    0]
 [   0    0    0    0    0    4    0    0    0    0    0    0    2    0    1    0    0    1    0   12    0    0    0    0    0    0    0]
 [   1    0    0    0    0    3    0    0    0    0    0    0    0    0   57    0    0   14    0   17    1    0    1    0    0    0    0]
 [   0    0    0    0    1    0    1    0    0    0    0    0    0    0    0    9    2    0    0    0    0    0    1    0    0    0    1]
 [   2    0    0    7    1    0    0    0    0    0    0    0    0    0    0    0   97    0    0    0    0    0    0    0    0    0    0]
 [   1    0    0    0    0    1    0    0    0    0    0    0    0    0    4    0    0   27    0   29    0    0    0    0    0    0    0]
 [   1    0    0    0    0    2    0    0    0    0    0    0    1    0   15    0    0   11    5    6    0    0    0    0    0    0    0]
 [   1    0    0    0    0    0    0    0    0    0    2    0    0    0    1    0    0    4    0   87    1    0    1    0    0    0    0]
 [   1    0    6    0    0    0    0    0    0    0    0    0    0    0    0    0    0    0    0    0  227    0    0    0    0    0    4]
 [   1    0    0    0    0    0    0    1    0    0    0    0    0    0    0    0    0    0    0    0    1   45    0    0    0    0    1]
 [   0    0    0    0    2    0    1    0    2    0    0    0    0    0    0    0    0    0    0    0    0    0  506    0    0    0    0]
 [   1    2    0    0    0    0    0    0    0    0    0    0    0    0    0    0    0    0    0    0    0    0    0    5    0    0    0]
 [   0    0    0    1    0    0    0    0    0    0    0    0    0    0    0    0    0    0    0    0    0    0    0    0    8    0    0]
 [   0    0    0    0    1    0    0    0    0    0    0    0    0    0    0    0    0    0    0    0    0    0    0    0    0   11    0]
 [   0    0    2    0    1    0    0    0    0    0    0    0    0    0    0    0    0    0    0    0    0    0    0    0    0    0   47]]

