Classifier: RandomForestClassifier
Params: {'bootstrap': True, 'class_weight': None, 'criterion': 'gini', 'max_depth': None, 'max_features': 'auto', 'max_leaf_nodes': None, 'min_impurity_decrease': 0.0, 'min_impurity_split': None, 'min_samples_leaf': 1, 'min_samples_split': 2, 'min_weight_fraction_leaf': 0.0, 'n_estimators': 100, 'n_jobs': 1, 'oob_score': False, 'random_state': None, 'verbose': 0, 'warm_start': False}

Labels: None

Training accuracy: 0.9952111024237685
Training confusion matrix:
[[14708     0     0     0     0     0     0     0     0     0     0     0     0     0     0     0     4     0     0     0     0     0     0     0     0     0     0]
 [    0   237     0     0     0     0     0     0     0     0     0     0     0     0     0     0     0     0     0     0     0     0     0     0     0     0     0]
 [    0     0   291     0     0     0     0     0     0     0     0     0     0     0     0     0     0     0     0     0     0     0     0     0     0     0     0]
 [    4     0     0   186     0     0     0     0     0     0     0     0     0     0     0     0     0     0     0     0     0     0     0     0     0     0     0]
 [    0     0     0     0   199     0     0     0     0     0     0     0     0     0     0     0     0     0     0     0     0     0     0     0     0     0     0]
 [    0     0     0     0     0   149     0     0     0     0     0     0     0     1     1     0     0     1     0     8     0     0     0     0     0     0     0]
 [    0     0     0     0     0     0   110     0     0     0     0     0     0     0     0     0     0     0     0     0     0     0     0     0     0     0     0]
 [    0     0     0     0     0     0     0  1011     0     0     0     0     0     0     0     0     0     0     0     0     0     0     0     0     0     0     0]
 [    0     0     0     0     0     0     0     0   178     0     0     0     0     0     0     0     0     0     0     0     0     0     0     0     0     0     0]
 [    1     0     0     0     0     0     0     0     0  6803     0     0     0     0     0     0     0     0     0     0     0     0     0     0     0     0     0]
 [    0     0     0     0     0     0     0     0     0     0   216     0     0     0     0     0     0     0     0     0     0     0     0     0     0     0     0]
 [    0     0     0     0     0     0     0     0     0     0     0  1181     0     0     0     0     0     0     0     0     0     0     0     0     0     0     0]
 [    0     0     0     0     0     0     0     0     0     0     0     0    93     1     0     0     0     4     0     5     0     0     0     0     0     0     0]
 [    0     0     0     0     0     2     0     0     0     0     0     0     0    80     0     0     0     3     0     3     0     0     0     0     0     0     0]
 [    0     0     0     0     0     2     0     0     0     0     0     0     0     1   295     0     0     0     4     2     0     0     0     0     0     0     0]
 [    0     0     0     0     0     0     0     0     0     0     0     0     0     0     0    53     0     0     0     0     0     0     0     0     0     0     0]
 [    2     0     0     0     0     0     0     0     0     0     0     0     0     0     0     0   404     0     0     0     0     0     0     0     0     0     0]
 [    0     0     0     0     0     1     0     0     0     0     0     0     2     3     0     0     0   256     1    27     0     0     0     0     0     0     0]
 [    0     0     0     0     0     1     0     0     0     0     0     0     0     1     7     0     0     2   103     3     0     0     0     0     0     0     0]
 [    0     0     0     0     0     7     0     0     0     0     0     0    13     3     0     0     0    23     2   321     0     0     0     0     0     0     0]
 [    1     0     0     0     0     0     0     1     0     0     0     0     0     0     0     0     0     0     0     0  1008     0     0     0     0     0     0]
 [    0     0     0     0     0     0     0     0     0     0     0     0     0     0     0     0     0     0     0     0     0   221     0     0     0     0     0]
 [    0     0     0     0     0     0     0     0     0     0     0     0     0     0     0     0     0     0     0     0     0     0  2135     0     0     0     0]
 [    0     0     0     0     0     0     0     0     0     0     0     0     0     0     0     0     0     0     0     0     0     0     0    37     0     0     0]
 [    0     0     0     0     0     0     0     0     0     0     0     0     0     0     0     0     0     0     0     0     0     0     0     0    29     0     0]
 [    0     0     0     0     0     0     0     0     0     0     0     0     0     0     0     0     0     0     0     0     0     0     0     0     0    63     0]
 [    0     0     0     0     0     0     0     0     0     0     0     0     0     0     0     0     0     0     0     0     0     0     0     0     0     0   182]]

Accuracy: 0.9749804534792806

Precision: [0.9872 1.0000 0.9577 0.9778 0.9804 0.5862 0.9762 0.9787 1.0000 0.9994 1.0000 1.0000 0.5000 0.4737 0.8621 1.0000 0.9811 0.6923 0.6579 0.6602 0.9710 0.9787 0.9903 0.8000 1.0000 1.0000 1.0000]
Mean: 0.8892936029312102
Std: 0.16767703980060053

Recall: [0.9948 0.9344 0.9855 0.8148 0.9434 0.5312 1.0000 0.9829 0.9565 0.9977 0.9811 0.9932 0.4375 0.4500 0.7979 0.9333 0.9720 0.7258 0.6098 0.7010 0.9832 0.9388 1.0000 1.0000 0.8889 1.0000 0.9000]
Mean: 0.8686596947613819
Std: 0.17286444699245548

F1 score: [0.9910 0.9661 0.9714 0.8889 0.9615 0.5574 0.9880 0.9808 0.9778 0.9986 0.9905 0.9966 0.4667 0.4615 0.8287 0.9655 0.9765 0.7087 0.6329 0.6800 0.9770 0.9583 0.9951 0.8889 0.9412 1.0000 0.9474]
Mean: 0.8776662033680497
Std: 0.16746284866081712

Cohen Kappa score: 0.9648757504894996
Confusion matrix:
[[3623    0    1    1    0    0    0    3    0    1    0    0    0    0    0    0    2    0    1    2    1    1    4    2    0    0    0]
 [   4   57    0    0    0    0    0    0    0    0    0    0    0    0    0    0    0    0    0    0    0    0    0    0    0    0    0]
 [   0    0   68    0    0    0    0    0    0    0    0    0    0    0    0    0    0    0    0    0    1    0    0    0    0    0    0]
 [  10    0    0   44    0    0    0    0    0    0    0    0    0    0    0    0    0    0    0    0    0    0    0    0    0    0    0]
 [   0    0    0    0   50    0    0    0    0    0    0    0    0    0    0    0    0    0    0    0    3    0    0    0    0    0    0]
 [   0    0    0    0    0   17    0    0    0    0    0    0    2    0    1    0    0    2    2    8    0    0    0    0    0    0    0]
 [   0    0    0    0    0    0   41    0    0    0    0    0    0    0    0    0    0    0    0    0    0    0    0    0    0    0    0]
 [   3    0    1    0    0    0    0  230    0    0    0    0    0    0    0    0    0    0    0    0    0    0    0    0    0    0    0]
 [   0    0    0    0    0    0    1    0   44    0    0    0    0    0    0    0    0    0    0    0    0    0    1    0    0    0    0]
 [   4    0    0    0    0    0    0    0    0 1744    0    0    0    0    0    0    0    0    0    0    0    0    0    0    0    0    0]
 [   1    0    0    0    0    0    0    0    0    0   52    0    0    0    0    0    0    0    0    0    0    0    0    0    0    0    0]
 [   2    0    0    0    0    0    0    0    0    0    0  294    0    0    0    0    0    0    0    0    0    0    0    0    0    0    0]
 [   0    0    0    0    0    2    0    0    0    0    0    0   14    5    1    0    0    3    1    6    0    0    0    0    0    0    0]
 [   1    0    0    0    0    4    0    0    0    0    0    0    1    9    3    0    0    1    0    1    0    0    0    0    0    0    0]
 [   7    0    0    0    0    1    0    0    0    0    0    0    0    0   75    0    0    1    6    4    0    0    0    0    0    0    0]
 [   1    0    0    0    0    0    0    0    0    0    0    0    0    0    0   14    0    0    0    0    0    0    0    0    0    0    0]
 [   2    0    1    0    0    0    0    0    0    0    0    0    0    0    0    0  104    0    0    0    0    0    0    0    0    0    0]
 [   0    0    0    0    0    2    0    0    0    0    0    0    0    1    2    0    0   45    0   12    0    0    0    0    0    0    0]
 [   3    0    0    0    0    1    0    0    0    0    0    0    2    1    3    0    0    4   25    2    0    0    0    0    0    0    0]
 [   1    0    0    0    0    2    0    0    0    0    0    0    9    3    2    0    0    9    3   68    0    0    0    0    0    0    0]
 [   3    0    0    0    0    0    0    1    0    0    0    0    0    0    0    0    0    0    0    0  234    0    0    0    0    0    0]
 [   2    0    0    0    0    0    0    0    0    0    0    0    0    0    0    0    0    0    0    0    1   46    0    0    0    0    0]
 [   0    0    0    0    0    0    0    0    0    0    0    0    0    0    0    0    0    0    0    0    0    0  511    0    0    0    0]
 [   0    0    0    0    0    0    0    0    0    0    0    0    0    0    0    0    0    0    0    0    0    0    0    8    0    0    0]
 [   1    0    0    0    0    0    0    0    0    0    0    0    0    0    0    0    0    0    0    0    0    0    0    0    8    0    0]
 [   0    0    0    0    0    0    0    0    0    0    0    0    0    0    0    0    0    0    0    0    0    0    0    0    0   12    0]
 [   2    0    0    0    1    0    0    1    0    0    0    0    0    0    0    0    0    0    0    0    1    0    0    0    0    0   45]]

