Classifier: GradientBoostingClassifier
Params: {'criterion': 'friedman_mse', 'init': None, 'learning_rate': 0.1, 'loss': 'deviance', 'max_depth': 3, 'max_features': None, 'max_leaf_nodes': None, 'min_impurity_decrease': 0.0, 'min_impurity_split': None, 'min_samples_leaf': 1, 'min_samples_split': 2, 'min_weight_fraction_leaf': 0.0, 'n_estimators': 100, 'presort': 'auto', 'random_state': None, 'subsample': 1.0, 'verbose': 0, 'warm_start': False}

Labels: None

Training accuracy: 0.9933216054209018
Training confusion matrix:
[[14663     0     1     0     0     0     0     2     0     3     1     0     0     0     1     0     4     0     0     0     0     0     0     1     0     0     0]
 [    3   223     0     0     0     0     0     0     0     0     0     0     0     0     0     0     0     0     0     0     0     0     0     0     0     0     0]
 [    0     0   272     0     0     0     0     0     0     0     0     0     0     0     0     0     0     0     0     0     0     0     0     0     0     0     0]
 [    5     0     0   191     0     0     0     0     0     0     0     0     0     0     0     0     0     0     0     0     0     0     0     0     0     0     0]
 [    0     0     0     0   192     0     0     0     0     0     0     0     0     0     0     0     0     0     0     0     0     0     0     0     0     0     0]
 [    0     0     0     0     0   108     0     0     0     0     0     0     3     4     0     0     0     0     2    22     0     0     0     0     0     0     0]
 [    0     0     0     0     0     0   120     0     0     0     0     0     0     0     0     0     0     0     0     0     0     0     0     0     0     0     0]
 [    2     0     0     0     0     0     0  1006     0     0     0     0     0     0     0     0     0     0     0     0     0     0     0     0     0     0     0]
 [    0     0     0     0     0     0     0     0   187     0     0     0     0     0     0     0     0     0     0     0     0     0     0     0     0     0     0]
 [    5     0     0     0     0     0     0     0     0  6840     0     0     0     0     0     0     0     0     0     0     0     0     0     0     0     0     0]
 [    0     0     0     0     0     0     0     0     0     0   221     0     0     0     0     0     0     0     0     0     0     0     0     0     0     0     0]
 [    1     0     0     0     0     0     0     0     0     0     0  1174     0     0     0     0     0     0     0     0     0     0     0     0     0     0     0]
 [    0     0     0     0     0     1     0     0     0     0     0     0    98     1     0     0     0     6     0     3     0     0     0     0     0     0     0]
 [    0     0     0     0     0     0     0     0     0     0     0     0     1    89     0     0     0     1     0     1     0     0     0     0     0     0     0]
 [    3     0     0     0     0     1     0     0     0     0     0     0     2     1   289     0     0     1     4     5     0     0     0     0     0     0     0]
 [    0     0     0     0     0     0     0     0     0     0     0     0     0     0     0    55     0     0     0     0     0     0     0     0     0     0     0]
 [    0     0     0     0     0     0     0     0     0     0     0     0     0     0     0     0   410     0     0     0     0     0     0     0     0     0     0]
 [    0     0     0     0     0     2     0     0     0     0     0     0     6     3     0     0     0   250     0    22     0     0     0     0     0     0     0]
 [    0     0     0     0     0     2     0     0     0     0     0     0     1     1     8     0     0     1   104     6     0     0     0     0     0     0     0]
 [    0     0     0     0     0     3     0     0     0     0     0     0    21     5     1     0     0    30     1   312     0     0     0     0     0     0     0]
 [    1     0     0     0     0     0     0     0     0     0     0     0     0     0     0     0     0     0     0     0  1002     0     0     0     0     0     0]
 [    0     0     0     0     0     0     0     0     0     0     0     0     0     0     0     0     0     0     0     0     0   216     0     0     0     0     0]
 [    0     0     0     0     0     0     0     0     0     0     0     0     0     0     0     0     0     0     0     0     0     0  2155     0     0     0     0]
 [    0     0     0     0     0     0     0     0     0     0     0     0     0     0     0     0     0     0     0     0     0     0     0    35     0     0     0]
 [    0     0     0     0     0     0     0     0     0     0     0     0     0     0     0     0     0     0     0     0     0     0     0     0    28     0     0]
 [    0     0     0     0     0     0     0     0     0     0     0     0     0     0     0     0     0     0     0     0     0     0     0     0     0    66     0]
 [    0     0     0     0     0     0     0     0     0     0     0     0     0     0     0     0     0     0     0     0     0     0     0     0     0     0   185]]

Accuracy: 0.9756320041699245

Precision: [0.9878 0.9722 1.0000 1.0000 0.9836 0.6875 1.0000 0.9831 0.9737 0.9953 0.9796 1.0000 0.5600 0.4615 0.9103 1.0000 0.9528 0.7237 0.6154 0.6333 0.9837 0.9630 0.9959 1.0000 0.9000 1.0000 1.0000]
Mean: 0.8986101108919584
Std: 0.15950172329966886

Recall: [0.9929 0.9722 0.9432 0.8750 1.0000 0.6226 1.0000 0.9789 1.0000 0.9977 1.0000 0.9967 0.5385 0.7500 0.7717 0.9231 0.9806 0.7971 0.4571 0.6129 0.9878 0.9630 0.9980 1.0000 0.9000 1.0000 0.9574]
Mean: 0.8894948428020618
Std: 0.1570309615332085

F1 score: [0.9904 0.9722 0.9708 0.9333 0.9917 0.6535 1.0000 0.9810 0.9867 0.9965 0.9897 0.9983 0.5490 0.5714 0.8353 0.9600 0.9665 0.7586 0.5246 0.6230 0.9857 0.9630 0.9969 1.0000 0.9000 1.0000 0.9783]
Mean: 0.8917176569442157
Std: 0.15703393249865572

Cohen Kappa score: 0.9657171549537351
Confusion matrix:
[[3652    2    0    0    1    0    0    3    0    8    1    0    0    0    0    0    5    0    0    0    2    1    2    0    1    0    0]
 [   2   70    0    0    0    0    0    0    0    0    0    0    0    0    0    0    0    0    0    0    0    0    0    0    0    0    0]
 [   3    0   83    0    0    0    0    1    0    0    0    0    0    0    0    0    0    0    0    0    1    0    0    0    0    0    0]
 [   6    0    0   42    0    0    0    0    0    0    0    0    0    0    0    0    0    0    0    0    0    0    0    0    0    0    0]
 [   0    0    0    0   60    0    0    0    0    0    0    0    0    0    0    0    0    0    0    0    0    0    0    0    0    0    0]
 [   0    0    0    0    0   33    0    0    0    0    0    0    1    2    2    0    0    3    0   12    0    0    0    0    0    0    0]
 [   0    0    0    0    0    0   31    0    0    0    0    0    0    0    0    0    0    0    0    0    0    0    0    0    0    0    0]
 [   2    0    0    0    0    0    0  232    1    0    0    0    0    0    0    0    0    0    0    0    1    1    0    0    0    0    0]
 [   0    0    0    0    0    0    0    0   37    0    0    0    0    0    0    0    0    0    0    0    0    0    0    0    0    0    0]
 [   4    0    0    0    0    0    0    0    0 1703    0    0    0    0    0    0    0    0    0    0    0    0    0    0    0    0    0]
 [   0    0    0    0    0    0    0    0    0    0   48    0    0    0    0    0    0    0    0    0    0    0    0    0    0    0    0]
 [   1    0    0    0    0    0    0    0    0    0    0  301    0    0    0    0    0    0    0    0    0    0    0    0    0    0    0]
 [   0    0    0    0    0    2    0    0    0    0    0    0   14    2    0    0    0    1    0    7    0    0    0    0    0    0    0]
 [   0    0    0    0    0    1    0    0    0    0    0    0    1   12    0    0    0    0    1    1    0    0    0    0    0    0    0]
 [   8    0    0    0    0    2    0    0    0    0    0    0    0    1   71    0    0    1    6    3    0    0    0    0    0    0    0]
 [   1    0    0    0    0    0    0    0    0    0    0    0    0    0    0   12    0    0    0    0    0    0    0    0    0    0    0]
 [   2    0    0    0    0    0    0    0    0    0    0    0    0    0    0    0  101    0    0    0    0    0    0    0    0    0    0]
 [   1    0    0    0    0    3    0    0    0    0    0    0    3    1    0    0    0   55    0    6    0    0    0    0    0    0    0]
 [   4    0    0    0    0    4    0    0    0    0    0    0    1    1    4    0    0    1   16    4    0    0    0    0    0    0    0]
 [   2    0    0    0    0    3    0    0    0    0    0    0    5    7    1    0    0   15    3   57    0    0    0    0    0    0    0]
 [   3    0    0    0    0    0    0    0    0    0    0    0    0    0    0    0    0    0    0    0  242    0    0    0    0    0    0]
 [   2    0    0    0    0    0    0    0    0    0    0    0    0    0    0    0    0    0    0    0    0   52    0    0    0    0    0]
 [   1    0    0    0    0    0    0    0    0    0    0    0    0    0    0    0    0    0    0    0    0    0  490    0    0    0    0]
 [   0    0    0    0    0    0    0    0    0    0    0    0    0    0    0    0    0    0    0    0    0    0    0   10    0    0    0]
 [   1    0    0    0    0    0    0    0    0    0    0    0    0    0    0    0    0    0    0    0    0    0    0    0    9    0    0]
 [   0    0    0    0    0    0    0    0    0    0    0    0    0    0    0    0    0    0    0    0    0    0    0    0    0    9    0]
 [   2    0    0    0    0    0    0    0    0    0    0    0    0    0    0    0    0    0    0    0    0    0    0    0    0    0   45]]

