Classifier: LinearSVC
Params: {'C': 1.0, 'class_weight': None, 'dual': True, 'fit_intercept': True, 'intercept_scaling': 1, 'loss': 'squared_hinge', 'max_iter': 1000, 'multi_class': 'ovr', 'penalty': 'l2', 'random_state': None, 'tol': 0.0001, 'verbose': 0}

Labels: None

Training accuracy: 0.9902918947094084
Training confusion matrix:
[[14669     0     0     0     0     0     0     0     0     0     0     0     0     0     0     0     5     0     0     0     0     0     1     0     1     0     0]
 [    0   226     0     0     0     0     0     0     0     0     0     0     0     0     0     0     0     0     0     0     0     0     0     0     0     0     0]
 [    1     0   271     0     0     0     0     0     0     0     0     0     0     0     0     0     0     0     0     0     0     0     0     0     0     0     0]
 [    3     0     0   193     0     0     0     0     0     0     0     0     0     0     0     0     0     0     0     0     0     0     0     0     0     0     0]
 [    0     0     0     0   192     0     0     0     0     0     0     0     0     0     0     0     0     0     0     0     0     0     0     0     0     0     0]
 [    0     0     0     0     0   105     0     0     0     0     0     0     3     1     1     0     0     2     2    25     0     0     0     0     0     0     0]
 [    0     0     0     0     0     0   120     0     0     0     0     0     0     0     0     0     0     0     0     0     0     0     0     0     0     0     0]
 [    0     0     0     0     0     0     0  1008     0     0     0     0     0     0     0     0     0     0     0     0     0     0     0     0     0     0     0]
 [    0     0     0     0     0     0     0     0   187     0     0     0     0     0     0     0     0     0     0     0     0     0     0     0     0     0     0]
 [    0     0     0     0     0     0     0     0     0  6845     0     0     0     0     0     0     0     0     0     0     0     0     0     0     0     0     0]
 [    0     0     0     0     0     0     0     0     0     0   221     0     0     0     0     0     0     0     0     0     0     0     0     0     0     0     0]
 [    0     0     0     0     0     0     0     0     0     0     0  1175     0     0     0     0     0     0     0     0     0     0     0     0     0     0     0]
 [    0     0     0     0     0     8     0     0     0     0     0     0    75     8     0     0     0     7     0    11     0     0     0     0     0     0     0]
 [    0     0     0     0     0     7     0     0     0     0     0     0     1    77     1     0     0     4     1     1     0     0     0     0     0     0     0]
 [    0     0     0     0     0     0     0     0     0     0     0     0     1     0   293     0     0     1     5     6     0     0     0     0     0     0     0]
 [    0     0     0     0     0     0     0     0     0     0     0     0     0     0     0    55     0     0     0     0     0     0     0     0     0     0     0]
 [    2     0     0     0     0     0     0     0     0     0     0     0     0     0     0     0   408     0     0     0     0     0     0     0     0     0     0]
 [    0     0     0     0     0     7     0     0     0     0     0     0     8     7     0     0     0   236     1    24     0     0     0     0     0     0     0]
 [    0     0     0     0     0     3     0     0     0     0     0     0     1     0     9     0     0     1   103     6     0     0     0     0     0     0     0]
 [    0     0     0     0     0    18     0     0     0     0     0     0    20    11     2     0     0    66     3   253     0     0     0     0     0     0     0]
 [    1     0     0     0     0     0     0     0     0     0     0     0     0     0     0     0     0     0     0     0  1002     0     0     0     0     0     0]
 [    0     0     0     0     0     0     0     0     0     0     0     0     0     0     0     0     0     0     0     0     0   216     0     0     0     0     0]
 [    0     0     0     0     0     0     0     0     0     0     0     0     0     0     0     0     0     0     0     0     0     0  2155     0     0     0     0]
 [    1     0     0     0     0     0     0     0     0     0     0     0     0     0     0     0     0     0     0     0     0     0     0    34     0     0     0]
 [    0     0     0     0     0     0     0     0     0     0     0     0     0     0     0     0     0     0     0     0     0     0     0     0    28     0     0]
 [    0     0     0     0     0     0     0     0     0     0     0     0     0     0     0     0     0     0     0     0     0     0     0     0     0    66     0]
 [    0     0     0     0     0     0     0     0     0     0     0     0     0     0     0     0     0     0     0     0     0     0     0     0     0     0   185]]

Accuracy: 0.9782382069324993

Precision: [0.9932 0.9726 0.9885 0.9130 1.0000 0.6863 1.0000 0.9833 1.0000 1.0000 0.9787 1.0000 0.4400 0.4091 0.8617 1.0000 0.9615 0.7297 0.6207 0.6207 0.9918 0.9811 0.9959 1.0000 0.8889 1.0000 1.0000]
Mean: 0.8895136271259625
Std: 0.17585914378477813

Recall: [0.9959 0.9861 0.9773 0.8750 0.9667 0.6604 1.0000 0.9916 1.0000 0.9977 0.9583 1.0000 0.4231 0.5625 0.8804 0.9231 0.9709 0.7826 0.5143 0.5806 0.9918 0.9630 0.9980 1.0000 0.8000 1.0000 1.0000]
Mean: 0.8814505854346323
Std: 0.1722345180688221

F1 score: [0.9946 0.9793 0.9829 0.8936 0.9831 0.6731 1.0000 0.9874 1.0000 0.9988 0.9684 1.0000 0.4314 0.4737 0.8710 0.9600 0.9662 0.7552 0.5625 0.6000 0.9918 0.9720 0.9969 1.0000 0.8421 1.0000 1.0000]
Mean: 0.8845900177103772
Std: 0.17401673407611082

Cohen Kappa score: 0.9694163617231314
Confusion matrix:
[[3663    1    1    2    0    0    0    2    0    0    1    0    0    0    1    0    2    0    0    0    1    1    2    0    1    0    0]
 [   1   71    0    0    0    0    0    0    0    0    0    0    0    0    0    0    0    0    0    0    0    0    0    0    0    0    0]
 [   2    0   86    0    0    0    0    0    0    0    0    0    0    0    0    0    0    0    0    0    0    0    0    0    0    0    0]
 [   6    0    0   42    0    0    0    0    0    0    0    0    0    0    0    0    0    0    0    0    0    0    0    0    0    0    0]
 [   1    1    0    0   58    0    0    0    0    0    0    0    0    0    0    0    0    0    0    0    0    0    0    0    0    0    0]
 [   0    0    0    0    0   35    0    0    0    0    0    0    1    2    3    0    0    0    1   11    0    0    0    0    0    0    0]
 [   0    0    0    0    0    0   31    0    0    0    0    0    0    0    0    0    0    0    0    0    0    0    0    0    0    0    0]
 [   1    0    0    0    0    0    0  235    0    0    0    0    0    0    0    0    0    0    0    0    1    0    0    0    0    0    0]
 [   0    0    0    0    0    0    0    0   37    0    0    0    0    0    0    0    0    0    0    0    0    0    0    0    0    0    0]
 [   2    0    0    0    0    0    0    0    0 1703    0    0    0    0    0    0    2    0    0    0    0    0    0    0    0    0    0]
 [   1    0    0    0    0    0    0    0    0    0   46    0    0    0    1    0    0    0    0    0    0    0    0    0    0    0    0]
 [   0    0    0    0    0    0    0    0    0    0    0  302    0    0    0    0    0    0    0    0    0    0    0    0    0    0    0]
 [   0    0    0    0    0    3    0    0    0    0    0    0   11    3    0    0    0    1    0    8    0    0    0    0    0    0    0]
 [   0    0    0    0    0    2    0    0    0    0    0    0    0    9    1    0    0    1    1    2    0    0    0    0    0    0    0]
 [   1    0    0    0    0    1    0    0    0    0    0    0    0    1   81    0    0    1    4    3    0    0    0    0    0    0    0]
 [   1    0    0    0    0    0    0    0    0    0    0    0    0    0    0   12    0    0    0    0    0    0    0    0    0    0    0]
 [   3    0    0    0    0    0    0    0    0    0    0    0    0    0    0    0  100    0    0    0    0    0    0    0    0    0    0]
 [   0    0    0    0    0    3    0    0    0    0    0    0    4    0    2    0    0   54    0    6    0    0    0    0    0    0    0]
 [   2    0    0    1    0    3    0    0    0    0    0    0    2    1    3    0    0    2   18    3    0    0    0    0    0    0    0]
 [   0    0    0    0    0    4    0    0    0    0    0    0    7    6    2    0    0   15    5   54    0    0    0    0    0    0    0]
 [   1    0    0    0    0    0    0    1    0    0    0    0    0    0    0    0    0    0    0    0  243    0    0    0    0    0    0]
 [   1    0    0    0    0    0    0    1    0    0    0    0    0    0    0    0    0    0    0    0    0   52    0    0    0    0    0]
 [   1    0    0    0    0    0    0    0    0    0    0    0    0    0    0    0    0    0    0    0    0    0  490    0    0    0    0]
 [   0    0    0    0    0    0    0    0    0    0    0    0    0    0    0    0    0    0    0    0    0    0    0   10    0    0    0]
 [   1    0    0    1    0    0    0    0    0    0    0    0    0    0    0    0    0    0    0    0    0    0    0    0    8    0    0]
 [   0    0    0    0    0    0    0    0    0    0    0    0    0    0    0    0    0    0    0    0    0    0    0    0    0    9    0]
 [   0    0    0    0    0    0    0    0    0    0    0    0    0    0    0    0    0    0    0    0    0    0    0    0    0    0   47]]

