Classifier: LogisticRegression
Params: {'C': 1.0, 'class_weight': None, 'dual': False, 'fit_intercept': True, 'intercept_scaling': 1, 'max_iter': 100, 'multi_class': 'ovr', 'n_jobs': 1, 'penalty': 'l2', 'random_state': None, 'solver': 'liblinear', 'tol': 0.0001, 'verbose': 0, 'warm_start': False}

Labels: None

Training accuracy: 0.9883698201720094
Training confusion matrix:
[[14645     2     3     4     0     0     0     6     0     2     2     0     0     0     1     0     2     0     0     0     3     2     3     0     1     0     0]
 [    0   226     0     0     0     0     0     0     0     0     0     0     0     0     0     0     0     0     0     0     0     0     0     0     0     0     0]
 [    2     0   270     0     0     0     0     0     0     0     0     0     0     0     0     0     0     0     0     0     0     0     0     0     0     0     0]
 [    4     0     0   192     0     0     0     0     0     0     0     0     0     0     0     0     0     0     0     0     0     0     0     0     0     0     0]
 [    1     0     0     0   191     0     0     0     0     0     0     0     0     0     0     0     0     0     0     0     0     0     0     0     0     0     0]
 [    0     0     0     0     0    90     0     0     0     0     0     0     4     3     5     0     0     2     2    33     0     0     0     0     0     0     0]
 [    0     0     0     0     0     0   120     0     0     0     0     0     0     0     0     0     0     0     0     0     0     0     0     0     0     0     0]
 [    2     0     1     0     0     0     0  1002     0     0     0     0     0     0     0     0     0     0     0     0     3     0     0     0     0     0     0]
 [    0     0     0     0     0     0     0     0   187     0     0     0     0     0     0     0     0     0     0     0     0     0     0     0     0     0     0]
 [    1     0     0     0     0     0     0     0     0  6844     0     0     0     0     0     0     0     0     0     0     0     0     0     0     0     0     0]
 [    1     0     0     0     0     0     0     0     0     0   220     0     0     0     0     0     0     0     0     0     0     0     0     0     0     0     0]
 [    0     0     0     0     0     0     0     0     0     0     0  1175     0     0     0     0     0     0     0     0     0     0     0     0     0     0     0]
 [    0     0     0     0     0     4     0     0     0     0     0     0    76     9     0     0     0     5     0    15     0     0     0     0     0     0     0]
 [    0     0     0     0     0     4     0     0     0     0     0     0     2    80     1     0     0     3     0     2     0     0     0     0     0     0     0]
 [    1     0     0     0     0     0     0     0     0     0     0     0     2     0   290     0     0     1     6     6     0     0     0     0     0     0     0]
 [    0     0     0     0     0     0     0     0     0     0     0     0     0     0     0    55     0     0     0     0     0     0     0     0     0     0     0]
 [    5     0     0     0     0     0     0     0     0     0     0     0     0     0     0     0   404     0     0     0     0     0     0     0     1     0     0]
 [    0     0     0     0     0     7     0     0     0     0     0     0    12    10     0     0     0   229     0    25     0     0     0     0     0     0     0]
 [    1     0     0     0     0     2     0     0     0     0     0     0     1     0    12     0     0     2    98     7     0     0     0     0     0     0     0]
 [    1     0     0     0     0    11     0     0     0     0     0     0    25     8     4     0     0    54     2   268     0     0     0     0     0     0     0]
 [    4     0     0     0     0     0     0     0     0     0     0     0     0     0     0     0     0     0     0     0   999     0     0     0     0     0     0]
 [    1     0     0     0     0     0     0     0     0     0     0     0     0     0     0     0     0     0     0     0     0   215     0     0     0     0     0]
 [    0     0     0     0     0     0     0     0     1     0     0     0     0     0     0     0     0     0     0     0     0     0  2154     0     0     0     0]
 [    1     0     0     0     0     0     0     0     0     1     0     0     0     0     0     0     0     0     0     0     0     0     0    33     0     0     0]
 [    1     0     0     0     0     0     0     0     0     0     0     0     0     0     0     0     0     0     0     0     0     0     0     0    27     0     0]
 [    0     0     0     0     0     0     0     1     0     0     0     0     0     0     0     0     0     0     0     0     0     0     0     0     0    65     0]
 [    1     0     0     0     0     0     0     0     0     0     0     0     0     0     0     0     0     0     0     0     0     0     0     0     0     0   184]]

Accuracy: 0.9781078967943706

Precision: [0.9900 0.9859 0.9884 0.9130 1.0000 0.7045 1.0000 0.9832 1.0000 0.9977 1.0000 1.0000 0.4828 0.4783 0.8804 1.0000 0.9806 0.7500 0.6923 0.6633 0.9838 0.9808 0.9980 1.0000 0.8889 1.0000 1.0000]
Mean: 0.9015463912487783
Std: 0.15774245843526968

Recall: [0.9951 0.9722 0.9659 0.8750 0.9833 0.5849 1.0000 0.9873 1.0000 0.9965 0.9792 1.0000 0.5385 0.6875 0.8804 0.9231 0.9806 0.6957 0.5143 0.6989 0.9918 0.9444 0.9980 0.9000 0.8000 1.0000 1.0000]
Mean: 0.8849123240785979
Std: 0.15357038491112687

F1 score: [0.9925 0.9790 0.9770 0.8936 0.9916 0.6392 1.0000 0.9853 1.0000 0.9971 0.9895 1.0000 0.5091 0.5641 0.8804 0.9600 0.9806 0.7218 0.5902 0.6806 0.9878 0.9623 0.9980 0.9474 0.8421 1.0000 1.0000]
Mean: 0.8914475305526943
Std: 0.15500185137606554

Cohen Kappa score: 0.9692069682242048
Confusion matrix:
[[3660    1    1    3    0    0    0    2    0    4    0    0    0    0    0    0    2    0    0    0    2    1    1    0    1    0    0]
 [   2   70    0    0    0    0    0    0    0    0    0    0    0    0    0    0    0    0    0    0    0    0    0    0    0    0    0]
 [   3    0   85    0    0    0    0    0    0    0    0    0    0    0    0    0    0    0    0    0    0    0    0    0    0    0    0]
 [   6    0    0   42    0    0    0    0    0    0    0    0    0    0    0    0    0    0    0    0    0    0    0    0    0    0    0]
 [   1    0    0    0   59    0    0    0    0    0    0    0    0    0    0    0    0    0    0    0    0    0    0    0    0    0    0]
 [   1    0    0    0    0   31    0    0    0    0    0    0    2    2    4    0    0    0    1   12    0    0    0    0    0    0    0]
 [   0    0    0    0    0    0   31    0    0    0    0    0    0    0    0    0    0    0    0    0    0    0    0    0    0    0    0]
 [   2    0    0    0    0    0    0  234    0    0    0    0    0    0    0    0    0    0    0    0    1    0    0    0    0    0    0]
 [   0    0    0    0    0    0    0    0   37    0    0    0    0    0    0    0    0    0    0    0    0    0    0    0    0    0    0]
 [   6    0    0    0    0    0    0    0    0 1701    0    0    0    0    0    0    0    0    0    0    0    0    0    0    0    0    0]
 [   1    0    0    0    0    0    0    0    0    0   47    0    0    0    0    0    0    0    0    0    0    0    0    0    0    0    0]
 [   0    0    0    0    0    0    0    0    0    0    0  302    0    0    0    0    0    0    0    0    0    0    0    0    0    0    0]
 [   0    0    0    0    0    3    0    0    0    0    0    0   14    3    0    0    0    0    0    6    0    0    0    0    0    0    0]
 [   0    0    0    0    0    1    0    0    0    0    0    0    0   11    1    0    0    0    1    2    0    0    0    0    0    0    0]
 [   1    0    0    0    0    1    0    0    0    0    0    0    0    1   81    0    0    0    5    3    0    0    0    0    0    0    0]
 [   1    0    0    0    0    0    0    0    0    0    0    0    0    0    0   12    0    0    0    0    0    0    0    0    0    0    0]
 [   2    0    0    0    0    0    0    0    0    0    0    0    0    0    0    0  101    0    0    0    0    0    0    0    0    0    0]
 [   3    0    0    0    0    4    0    0    0    0    0    0    5    0    2    0    0   48    0    7    0    0    0    0    0    0    0]
 [   3    0    0    0    0    3    0    0    0    0    0    0    2    1    3    0    0    2   18    3    0    0    0    0    0    0    0]
 [   0    0    0    0    0    1    0    0    0    0    0    0    6    5    1    0    0   14    1   65    0    0    0    0    0    0    0]
 [   1    0    0    0    0    0    0    1    0    0    0    0    0    0    0    0    0    0    0    0  243    0    0    0    0    0    0]
 [   1    0    0    0    0    0    0    1    0    0    0    0    0    0    0    0    0    0    0    0    1   51    0    0    0    0    0]
 [   1    0    0    0    0    0    0    0    0    0    0    0    0    0    0    0    0    0    0    0    0    0  490    0    0    0    0]
 [   1    0    0    0    0    0    0    0    0    0    0    0    0    0    0    0    0    0    0    0    0    0    0    9    0    0    0]
 [   1    0    0    1    0    0    0    0    0    0    0    0    0    0    0    0    0    0    0    0    0    0    0    0    8    0    0]
 [   0    0    0    0    0    0    0    0    0    0    0    0    0    0    0    0    0    0    0    0    0    0    0    0    0    9    0]
 [   0    0    0    0    0    0    0    0    0    0    0    0    0    0    0    0    0    0    0    0    0    0    0    0    0    0   47]]

