Classifier: MLPClassifier
Params: {'activation': 'relu', 'alpha': 0.0001, 'batch_size': 'auto', 'beta_1': 0.9, 'beta_2': 0.999, 'early_stopping': False, 'epsilon': 1e-08, 'hidden_layer_sizes': (100,), 'learning_rate': 'constant', 'learning_rate_init': 0.001, 'max_iter': 200, 'momentum': 0.9, 'nesterovs_momentum': True, 'power_t': 0.5, 'random_state': None, 'shuffle': True, 'solver': 'adam', 'tol': 0.0001, 'validation_fraction': 0.1, 'verbose': False, 'warm_start': False}

Labels: None

Training accuracy: 0.9904222048475372
Training confusion matrix:
[[14670     0     0     0     0     0     0     0     0     0     0     0     0     0     0     0     5     0     0     0     0     0     0     1     0     0     0]
 [    2   224     0     0     0     0     0     0     0     0     0     0     0     0     0     0     0     0     0     0     0     0     0     0     0     0     0]
 [    1     0   271     0     0     0     0     0     0     0     0     0     0     0     0     0     0     0     0     0     0     0     0     0     0     0     0]
 [    4     0     0   192     0     0     0     0     0     0     0     0     0     0     0     0     0     0     0     0     0     0     0     0     0     0     0]
 [    0     0     0     0   192     0     0     0     0     0     0     0     0     0     0     0     0     0     0     0     0     0     0     0     0     0     0]
 [    0     0     0     0     0   128     0     0     0     0     0     0     0     1     0     0     0     1     1     8     0     0     0     0     0     0     0]
 [    0     0     0     0     0     0   120     0     0     0     0     0     0     0     0     0     0     0     0     0     0     0     0     0     0     0     0]
 [    0     0     0     0     0     0     0  1006     0     0     0     0     0     0     0     0     0     0     0     0     2     0     0     0     0     0     0]
 [    0     0     0     0     0     0     0     0   187     0     0     0     0     0     0     0     0     0     0     0     0     0     0     0     0     0     0]
 [    0     0     0     0     0     0     0     0     0  6845     0     0     0     0     0     0     0     0     0     0     0     0     0     0     0     0     0]
 [    0     0     0     0     0     0     0     0     0     0   221     0     0     0     0     0     0     0     0     0     0     0     0     0     0     0     0]
 [    0     0     0     0     0     0     0     0     0     0     0  1175     0     0     0     0     0     0     0     0     0     0     0     0     0     0     0]
 [    0     0     0     0     0     6     0     0     0     0     0     0    94     5     0     0     0     2     0     2     0     0     0     0     0     0     0]
 [    0     0     0     0     0     9     0     0     0     0     0     0     2    75     1     0     0     3     1     1     0     0     0     0     0     0     0]
 [    0     0     0     0     0     4     0     0     0     0     0     0     1     0   294     0     0     1     1     5     0     0     0     0     0     0     0]
 [    0     0     0     0     0     0     0     0     0     0     0     0     0     0     0    55     0     0     0     0     0     0     0     0     0     0     0]
 [    1     0     0     0     0     0     0     0     0     0     0     0     0     0     0     0   409     0     0     0     0     0     0     0     0     0     0]
 [    0     0     0     0     0    11     0     0     0     0     0     0    14    10     0     0     0   223     0    25     0     0     0     0     0     0     0]
 [    0     0     0     0     0     5     0     0     0     0     0     0     1     1    18     0     0     2    91     5     0     0     0     0     0     0     0]
 [    0     0     0     0     0    37     0     0     0     0     0     0    29    11     1     0     0    52     0   243     0     0     0     0     0     0     0]
 [    1     0     0     0     0     0     0     0     0     0     0     0     0     0     0     0     0     0     0     0  1002     0     0     0     0     0     0]
 [    0     0     0     0     0     0     0     0     0     0     0     0     0     0     0     0     0     0     0     0     0   216     0     0     0     0     0]
 [    0     0     0     0     0     0     0     0     0     0     0     0     0     0     0     0     0     0     0     0     0     0  2155     0     0     0     0]
 [    0     0     0     0     0     0     0     0     0     0     0     0     0     0     0     0     0     0     0     0     0     0     0    35     0     0     0]
 [    0     0     0     0     0     0     0     0     0     0     0     0     0     0     0     0     0     0     0     0     0     0     0     0    28     0     0]
 [    0     0     0     0     0     0     0     0     0     0     0     0     0     0     0     0     0     0     0     0     0     0     0     0     0    66     0]
 [    0     0     0     0     0     0     0     0     0     0     0     0     0     0     0     0     0     0     0     0     0     0     0     0     0     0   185]]

Accuracy: 0.9800625488663018

Precision: [0.9903 0.9859 0.9773 0.9756 1.0000 0.6901 1.0000 0.9873 1.0000 1.0000 1.0000 1.0000 0.4286 0.5263 0.9231 1.0000 0.9444 0.7778 0.8421 0.7000 0.9959 0.9630 0.9980 1.0000 0.8889 1.0000 1.0000]
Mean: 0.9109098964525876
Std: 0.15168677803787728

Recall: [0.9970 0.9722 0.9773 0.8333 0.9333 0.9245 1.0000 0.9873 1.0000 0.9971 0.9792 0.9967 0.5769 0.6250 0.9130 0.9231 0.9903 0.7101 0.4571 0.6022 0.9918 0.9630 0.9980 1.0000 0.8000 1.0000 0.9574]
Mean: 0.8928129680124474
Std: 0.15432814276482057

F1 score: [0.9936 0.9790 0.9773 0.8989 0.9655 0.7903 1.0000 0.9873 1.0000 0.9985 0.9895 0.9983 0.4918 0.5714 0.9180 0.9600 0.9668 0.7424 0.5926 0.6474 0.9939 0.9630 0.9980 1.0000 0.8421 1.0000 0.9783]
Mean: 0.8979257420271339
Std: 0.15032837446176456

Cohen Kappa score: 0.9719460197151202
Confusion matrix:
[[3667    1    1    1    0    0    0    2    0    0    0    0    0    0    0    0    3    0    0    0    0    1    1    0    1    0    0]
 [   2   70    0    0    0    0    0    0    0    0    0    0    0    0    0    0    0    0    0    0    0    0    0    0    0    0    0]
 [   2    0   86    0    0    0    0    0    0    0    0    0    0    0    0    0    0    0    0    0    0    0    0    0    0    0    0]
 [   8    0    0   40    0    0    0    0    0    0    0    0    0    0    0    0    0    0    0    0    0    0    0    0    0    0    0]
 [   4    0    0    0   56    0    0    0    0    0    0    0    0    0    0    0    0    0    0    0    0    0    0    0    0    0    0]
 [   0    0    0    0    0   49    0    0    0    0    0    0    1    0    0    0    0    0    0    3    0    0    0    0    0    0    0]
 [   0    0    0    0    0    0   31    0    0    0    0    0    0    0    0    0    0    0    0    0    0    0    0    0    0    0    0]
 [   1    0    0    0    0    0    0  234    0    0    0    0    0    0    0    0    0    0    0    0    1    1    0    0    0    0    0]
 [   0    0    0    0    0    0    0    0   37    0    0    0    0    0    0    0    0    0    0    0    0    0    0    0    0    0    0]
 [   3    0    0    0    0    0    0    0    0 1702    0    0    0    0    0    0    2    0    0    0    0    0    0    0    0    0    0]
 [   1    0    0    0    0    0    0    0    0    0   47    0    0    0    0    0    0    0    0    0    0    0    0    0    0    0    0]
 [   1    0    0    0    0    0    0    0    0    0    0  301    0    0    0    0    0    0    0    0    0    0    0    0    0    0    0]
 [   0    0    0    0    0    5    0    0    0    0    0    0   15    2    0    0    0    0    0    4    0    0    0    0    0    0    0]
 [   0    0    0    0    0    2    0    0    0    0    0    0    1   10    1    0    0    0    1    1    0    0    0    0    0    0    0]
 [   1    0    0    0    0    2    0    0    0    0    0    0    0    1   84    0    0    0    1    3    0    0    0    0    0    0    0]
 [   1    0    0    0    0    0    0    0    0    0    0    0    0    0    0   12    0    0    0    0    0    0    0    0    0    0    0]
 [   1    0    0    0    0    0    0    0    0    0    0    0    0    0    0    0  102    0    0    0    0    0    0    0    0    0    0]
 [   0    0    0    0    0    4    0    0    0    0    0    0    6    0    1    0    0   49    0    9    0    0    0    0    0    0    0]
 [   3    0    0    0    0    4    0    0    0    0    0    0    1    1    4    0    1    1   16    4    0    0    0    0    0    0    0]
 [   1    0    0    0    0    5    0    0    0    0    0    0   11    5    1    0    0   13    1   56    0    0    0    0    0    0    0]
 [   2    0    0    0    0    0    0    0    0    0    0    0    0    0    0    0    0    0    0    0  243    0    0    0    0    0    0]
 [   1    0    0    0    0    0    0    1    0    0    0    0    0    0    0    0    0    0    0    0    0   52    0    0    0    0    0]
 [   1    0    0    0    0    0    0    0    0    0    0    0    0    0    0    0    0    0    0    0    0    0  490    0    0    0    0]
 [   0    0    0    0    0    0    0    0    0    0    0    0    0    0    0    0    0    0    0    0    0    0    0   10    0    0    0]
 [   2    0    0    0    0    0    0    0    0    0    0    0    0    0    0    0    0    0    0    0    0    0    0    0    8    0    0]
 [   0    0    0    0    0    0    0    0    0    0    0    0    0    0    0    0    0    0    0    0    0    0    0    0    0    9    0]
 [   1    0    1    0    0    0    0    0    0    0    0    0    0    0    0    0    0    0    0    0    0    0    0    0    0    0   45]]

