Classifier: MultinomialNB
Params: {'alpha': 1.0, 'class_prior': None, 'fit_prior': True}

Labels: None

Training accuracy: 0.9171879072191816
Training confusion matrix:
[[14008    22     5    20     1     0     0   242     0    29    54    11     0     0    24     0     4    50     0   160    35     0    11     0     0     0     0]
 [   23   203     0     0     0     0     0     0     0     0     0     0     0     0     0     0     0     0     0     0     0     0     0     0     0     0     0]
 [    3     0   155     0     3     0     3    72     0     0     0     0     0     0     0     0     1     0     0     0    35     0     0     0     0     0     0]
 [   73     0     0   102     0     0     0     0     0     0     0     0     0     0     0     0    12     0     0     0     0     0     9     0     0     0     0]
 [    1     0     0     0   150     0     5    23     0     0     0     0     0     0     0     0     4     0     0     0     1     0     8     0     0     0     0]
 [    0     0     0     0     0     0     0     0     0     0     0     0     0     0     4     0     0     0     0   135     0     0     0     0     0     0     0]
 [    0     0     0     0     0     0   102     8     0     0     0     0     0     0     0     0     5     0     0     0     0     0     5     0     0     0     0]
 [    3     0     1     0     1     0     0   994     0     0     0     0     0     0     0     0     0     0     0     0     9     0     0     0     0     0     0]
 [    1     0     0     0     1     0     0     1   177     0     0     0     0     0     0     0     0     0     0     0     0     0     7     0     0     0     0]
 [  156     0     0     0     0     0     0     1     0  6666     0     0     0     0     1     0     5     0     0     0     0     0    16     0     0     0     0]
 [   62     0     0     0     0     0     0     0     0     0   156     0     0     0     0     0     0     0     0     3     0     0     0     0     0     0     0]
 [   27     0     0     0     0     0     0     0     0     2     0  1146     0     0     0     0     0     0     0     0     0     0     0     0     0     0     0]
 [    0     0     0     0     0     0     0     0     0     0     0     0     0     0     0     0     0     0     0   109     0     0     0     0     0     0     0]
 [    1     0     0     0     0     0     0     0     0     0     0     0     0     0     0     0     0     0     0    91     0     0     0     0     0     0     0]
 [   14     0     0     0     0     0     0     4     0     0     0     0     0     0   108     0     0     7     0   148     0     0    25     0     0     0     0]
 [    0     0     0     0     3     0     0     3     0     0     0     0     0     0     0    36     0     0     0     0     0     0    13     0     0     0     0]
 [   63     0     0     0     2     0     0     1     0     0     0     0     0     0     0     0   344     0     0     0     0     0     0     0     0     0     0]
 [   15     0     0     0     0     0     0     0     0     0     0     0     0     0     2     0     0    42     0   224     0     0     0     0     0     0     0]
 [    3     0     0     0     0     0     0     0     0     0     0     0     0     0    12     0     0     8     0   100     0     0     0     0     0     0     0]
 [    5     0     0     0     0     0     0     1     0     0     2     0     0     0     2     0     0     8     0   347     2     0     6     0     0     0     0]
 [    2     0     0     0     0     0     0     5     0     0     0     0     0     0     0     0     0     0     0     0   996     0     0     0     0     0     0]
 [    2     0     0     0     0     0     0    25     0     0     0     0     0     0     0     0     1     0     0     0    72   107     9     0     0     0     0]
 [    3     0     0     0     1     0     1     5     1     0     0     0     0     0     0     0     0     0     0     0     0     0  2144     0     0     0     0]
 [   21    13     0     0     0     0     0     0     0     0     0     1     0     0     0     0     0     0     0     0     0     0     0     0     0     0     0]
 [   24     0     0     0     0     0     0     0     0     0     0     0     0     0     0     0     0     0     0     0     0     0     0     0     4     0     0]
 [    0     0     1     0     3     0     0    24     0     0     0     0     0     0     0     0     2     0     0     0    17     0     7     0     0    12     0]
 [    2     0     3     0     1     0     0     9     0     0     0     0     0     0     0     0     0     0     0     0    15     0     0     0     0     0   155]]

Accuracy: 0.9091738337242637

Precision: [0.9604 0.8514 0.9412 0.7000 0.9130 0.0000 0.8929 0.6620 1.0000 0.9946 0.6275 0.9933 0.0000 0.0000 0.7111 1.0000 0.8878 0.4839 0.0000 0.2553 0.8316 1.0000 0.9209 0.0000 1.0000 0.0000 1.0000]
Mean: 0.6528425505089802
Std: 0.38905940020815954

Recall: [0.9570 0.8750 0.5455 0.2917 0.7000 0.0000 0.8065 0.9916 0.8919 0.9731 0.6667 0.9834 0.0000 0.0000 0.3478 0.0769 0.8447 0.2174 0.0000 0.9032 0.9673 0.5185 0.9959 0.0000 0.1000 0.0000 0.7021]
Mean: 0.5317102425344312
Std: 0.39021290866020547

F1 score: [0.9587 0.8630 0.6906 0.4118 0.7925 0.0000 0.8475 0.7939 0.9429 0.9837 0.6465 0.9884 0.0000 0.0000 0.4672 0.1429 0.8657 0.3000 0.0000 0.3981 0.8943 0.6829 0.9569 0.0000 0.1818 0.0000 0.8250]
Mean: 0.5420073146215918
Std: 0.37211856440836355

Cohen Kappa score: 0.8726075228558592
Confusion matrix:
[[3520    7    1    6    1    0    0   56    0    9   16    1    0    0    5    0    0    9    0   33   10    0    4    0    0    0    0]
 [   8   63    0    0    0    0    0    1    0    0    0    0    0    0    0    0    0    0    0    0    0    0    0    0    0    0    0]
 [   2    0   48    0    1    0    2   20    0    0    0    0    0    0    0    0    1    0    0    0   14    0    0    0    0    0    0]
 [  25    0    0   14    0    0    0    0    0    0    0    0    0    0    0    0    6    0    0    0    0    0    3    0    0    0    0]
 [   1    0    0    0   42    0    0   15    0    0    0    0    0    0    0    0    2    0    0    0    0    0    0    0    0    0    0]
 [   1    0    0    0    0    0    0    0    0    0    0    0    0    0    0    0    0    0    0   52    0    0    0    0    0    0    0]
 [   0    0    0    0    0    0   25    1    0    0    0    0    0    0    0    0    0    0    0    0    0    0    5    0    0    0    0]
 [   0    0    0    0    0    0    0  235    0    0    0    0    0    0    0    0    0    0    0    0    2    0    0    0    0    0    0]
 [   0    0    0    0    0    0    1    1   33    0    0    0    0    0    0    0    1    0    0    0    0    0    1    0    0    0    0]
 [  39    0    0    0    0    0    0    0    0 1661    0    1    0    0    0    0    0    0    0    0    0    0    6    0    0    0    0]
 [  14    0    0    0    0    0    0    0    0    0   32    0    0    0    0    0    0    0    0    2    0    0    0    0    0    0    0]
 [   5    0    0    0    0    0    0    0    0    0    0  297    0    0    0    0    0    0    0    0    0    0    0    0    0    0    0]
 [   0    0    0    0    0    0    0    0    0    0    0    0    0    0    0    0    0    0    0   26    0    0    0    0    0    0    0]
 [   0    0    0    0    0    0    0    0    0    0    0    0    0    0    0    0    0    0    0   16    0    0    0    0    0    0    0]
 [   6    0    0    0    0    0    0    0    0    0    0    0    0    0   32    0    0    4    0   42    0    0    8    0    0    0    0]
 [   1    0    0    0    0    0    0    1    0    0    0    0    0    0    0    1    1    0    0    0    1    0    8    0    0    0    0]
 [  15    0    0    0    0    0    0    1    0    0    0    0    0    0    0    0   87    0    0    0    0    0    0    0    0    0    0]
 [   5    0    0    0    0    0    0    0    0    0    0    0    0    0    3    0    0   15    0   46    0    0    0    0    0    0    0]
 [   2    0    0    0    0    0    0    0    0    0    0    0    0    0    4    0    0    1    0   28    0    0    0    0    0    0    0]
 [   1    0    0    0    0    0    0    0    0    0    3    0    0    0    1    0    0    2    0   84    1    0    1    0    0    0    0]
 [   3    0    0    0    0    0    0    4    0    0    0    0    0    0    0    0    0    0    0    0  237    0    1    0    0    0    0]
 [   0    0    0    0    0    0    0   10    0    0    0    0    0    0    0    0    0    0    0    0   13   28    3    0    0    0    0]
 [   1    0    0    0    1    0    0    0    0    0    0    0    0    0    0    0    0    0    0    0    0    0  489    0    0    0    0]
 [   6    4    0    0    0    0    0    0    0    0    0    0    0    0    0    0    0    0    0    0    0    0    0    0    0    0    0]
 [   9    0    0    0    0    0    0    0    0    0    0    0    0    0    0    0    0    0    0    0    0    0    0    0    1    0    0]
 [   0    0    1    0    1    0    0    3    0    0    0    0    0    0    0    0    0    0    0    0    2    0    2    0    0    0    0]
 [   1    0    1    0    0    0    0    7    0    0    0    0    0    0    0    0    0    0    0    0    5    0    0    0    0    0   33]]

