Classifier: RandomForestClassifier
Params: {'bootstrap': True, 'class_weight': None, 'criterion': 'gini', 'max_depth': None, 'max_features': 'auto', 'max_leaf_nodes': None, 'min_impurity_decrease': 0.0, 'min_impurity_split': None, 'min_samples_leaf': 1, 'min_samples_split': 2, 'min_weight_fraction_leaf': 0.0, 'n_estimators': 100, 'n_jobs': 1, 'oob_score': False, 'random_state': None, 'verbose': 0, 'warm_start': False}

Labels: None

Training accuracy: 0.9969377117539745
Training confusion matrix:
[[14675     0     0     0     0     0     0     0     0     0     0     0     0     0     0     0     1     0     0     0     0     0     0     0     0     0     0]
 [    0   226     0     0     0     0     0     0     0     0     0     0     0     0     0     0     0     0     0     0     0     0     0     0     0     0     0]
 [    0     0   272     0     0     0     0     0     0     0     0     0     0     0     0     0     0     0     0     0     0     0     0     0     0     0     0]
 [    3     0     0   193     0     0     0     0     0     0     0     0     0     0     0     0     0     0     0     0     0     0     0     0     0     0     0]
 [    0     0     0     0   192     0     0     0     0     0     0     0     0     0     0     0     0     0     0     0     0     0     0     0     0     0     0]
 [    0     0     0     0     0   128     0     0     0     0     0     0     0     1     0     0     0     0     0    10     0     0     0     0     0     0     0]
 [    0     0     0     0     0     0   120     0     0     0     0     0     0     0     0     0     0     0     0     0     0     0     0     0     0     0     0]
 [    0     0     0     0     0     0     0  1008     0     0     0     0     0     0     0     0     0     0     0     0     0     0     0     0     0     0     0]
 [    0     0     0     0     0     0     0     0   187     0     0     0     0     0     0     0     0     0     0     0     0     0     0     0     0     0     0]
 [    0     0     0     0     0     0     0     0     0  6845     0     0     0     0     0     0     0     0     0     0     0     0     0     0     0     0     0]
 [    0     0     0     0     0     0     0     0     0     0   221     0     0     0     0     0     0     0     0     0     0     0     0     0     0     0     0]
 [    0     0     0     0     0     0     0     0     0     0     0  1175     0     0     0     0     0     0     0     0     0     0     0     0     0     0     0]
 [    0     0     0     0     0     0     0     0     0     0     0     0    99     0     0     0     0     3     0     7     0     0     0     0     0     0     0]
 [    0     0     0     0     0     1     0     0     0     0     0     0     1    85     1     0     0     1     0     3     0     0     0     0     0     0     0]
 [    0     0     0     0     0     0     0     0     0     0     0     0     0     0   302     0     0     0     1     3     0     0     0     0     0     0     0]
 [    0     0     0     0     0     0     0     0     0     0     0     0     0     0     0    55     0     0     0     0     0     0     0     0     0     0     0]
 [    3     0     0     0     0     0     0     0     0     0     0     0     0     0     0     0   407     0     0     0     0     0     0     0     0     0     0]
 [    0     0     0     0     0     0     0     0     0     0     0     0     0     1     0     0     0   273     0     9     0     0     0     0     0     0     0]
 [    0     0     0     0     0     0     0     0     0     0     0     0     1     0     8     0     0     1   110     3     0     0     0     0     0     0     0]
 [    0     0     0     0     0     2     0     0     0     0     0     0     7     1     1     0     0    20     0   342     0     0     0     0     0     0     0]
 [    0     0     0     0     0     0     0     0     0     0     0     0     0     0     0     0     0     0     0     0  1003     0     0     0     0     0     0]
 [    0     0     0     0     0     0     0     0     0     0     0     0     0     0     0     0     0     0     0     0     0   216     0     0     0     0     0]
 [    0     0     0     0     0     0     0     0     0     0     0     0     0     0     0     0     0     0     0     0     0     0  2155     0     0     0     0]
 [    1     0     0     0     0     0     0     0     0     0     0     0     0     0     0     0     0     0     0     0     0     0     0    34     0     0     0]
 [    0     0     0     0     0     0     0     0     0     0     0     0     0     0     0     0     0     0     0     0     0     0     0     0    28     0     0]
 [    0     0     0     0     0     0     0     0     0     0     0     0     0     0     0     0     0     0     0     0     0     0     0     0     0    66     0]
 [    0     0     0     0     0     0     0     0     0     0     0     0     0     0     0     0     0     0     0     0     0     0     0     0     0     0   185]]

Accuracy: 0.9683346364347146

Precision: [0.9770 0.9394 1.0000 0.9706 0.8889 0.7200 0.9375 0.9553 1.0000 0.9988 1.0000 0.9967 0.3793 0.5714 0.8706 1.0000 0.9700 0.6957 0.7222 0.6186 0.9562 0.9792 0.9980 1.0000 0.8889 1.0000 1.0000]
Mean: 0.8901537082410104
Std: 0.16015148927520179

Recall: [0.9951 0.8611 0.8636 0.6875 0.9333 0.6792 0.9677 0.9916 0.9459 0.9936 0.9375 0.9934 0.4231 0.5000 0.8043 0.8462 0.9417 0.6957 0.3714 0.6452 0.9796 0.8704 0.9980 0.9000 0.8000 1.0000 0.8936]
Mean: 0.8340268663593505
Std: 0.17717029306394969

F1 score: [0.9860 0.8986 0.9268 0.8049 0.9106 0.6990 0.9524 0.9731 0.9722 0.9962 0.9677 0.9950 0.4000 0.5333 0.8362 0.9167 0.9557 0.6957 0.4906 0.6316 0.9677 0.9216 0.9980 0.9474 0.8421 1.0000 0.9438]
Mean: 0.8578767702835904
Std: 0.16682615153749736

Cohen Kappa score: 0.9552807852067755
Confusion matrix:
[[3660    4    0    0    0    0    0    3    0    2    0    0    0    0    2    0    2    0    0    1    2    0    1    0    1    0    0]
 [  10   62    0    0    0    0    0    0    0    0    0    0    0    0    0    0    0    0    0    0    0    0    0    0    0    0    0]
 [   2    0   76    0    4    0    0    2    0    0    0    0    0    0    0    0    0    0    0    0    4    0    0    0    0    0    0]
 [  15    0    0   33    0    0    0    0    0    0    0    0    0    0    0    0    0    0    0    0    0    0    0    0    0    0    0]
 [   2    0    0    0   56    0    0    2    0    0    0    0    0    0    0    0    0    0    0    0    0    0    0    0    0    0    0]
 [   2    0    0    0    0   36    0    0    0    0    0    0    2    1    0    0    0    4    0    8    0    0    0    0    0    0    0]
 [   0    0    0    0    0    0   30    0    0    0    0    0    0    0    0    0    0    0    0    0    0    1    0    0    0    0    0]
 [   0    0    0    0    0    0    0  235    0    0    0    0    0    0    0    0    0    0    0    0    2    0    0    0    0    0    0]
 [   0    0    0    0    0    0    1    1   35    0    0    0    0    0    0    0    0    0    0    0    0    0    0    0    0    0    0]
 [  10    0    0    0    0    0    0    0    0 1696    0    1    0    0    0    0    0    0    0    0    0    0    0    0    0    0    0]
 [   3    0    0    0    0    0    0    0    0    0   45    0    0    0    0    0    0    0    0    0    0    0    0    0    0    0    0]
 [   2    0    0    0    0    0    0    0    0    0    0  300    0    0    0    0    0    0    0    0    0    0    0    0    0    0    0]
 [   0    0    0    0    0    4    0    0    0    0    0    0   11    2    1    0    0    1    0    7    0    0    0    0    0    0    0]
 [   0    0    0    0    0    1    0    0    0    0    0    0    0    8    1    0    0    0    0    6    0    0    0    0    0    0    0]
 [   8    0    0    0    0    1    0    0    0    0    0    0    0    1   74    0    0    1    5    2    0    0    0    0    0    0    0]
 [   1    0    0    0    1    0    0    0    0    0    0    0    0    0    0   11    0    0    0    0    0    0    0    0    0    0    0]
 [   4    0    0    1    0    0    0    1    0    0    0    0    0    0    0    0   97    0    0    0    0    0    0    0    0    0    0]
 [   6    0    0    0    0    2    0    0    0    0    0    0    4    0    1    0    0   48    0    8    0    0    0    0    0    0    0]
 [   7    0    0    0    0    2    0    0    0    0    0    0    4    0    3    0    0    1   13    5    0    0    0    0    0    0    0]
 [   2    0    0    0    0    4    0    0    0    0    0    0    8    2    3    0    0   14    0   60    0    0    0    0    0    0    0]
 [   5    0    0    0    0    0    0    0    0    0    0    0    0    0    0    0    0    0    0    0  240    0    0    0    0    0    0]
 [   2    0    0    0    1    0    0    2    0    0    0    0    0    0    0    0    0    0    0    0    2   47    0    0    0    0    0]
 [   1    0    0    0    0    0    0    0    0    0    0    0    0    0    0    0    0    0    0    0    0    0  490    0    0    0    0]
 [   1    0    0    0    0    0    0    0    0    0    0    0    0    0    0    0    0    0    0    0    0    0    0    9    0    0    0]
 [   1    0    0    0    0    0    0    0    0    0    0    0    0    0    0    0    1    0    0    0    0    0    0    0    8    0    0]
 [   0    0    0    0    0    0    0    0    0    0    0    0    0    0    0    0    0    0    0    0    0    0    0    0    0    9    0]
 [   2    0    0    0    1    0    1    0    0    0    0    0    0    0    0    0    0    0    0    0    1    0    0    0    0    0   42]]

