Classifier: GradientBoostingClassifier
Params: {'criterion': 'friedman_mse', 'init': None, 'learning_rate': 0.1, 'loss': 'deviance', 'max_depth': 3, 'max_features': None, 'max_leaf_nodes': None, 'min_impurity_decrease': 0.0, 'min_impurity_split': None, 'min_samples_leaf': 1, 'min_samples_split': 2, 'min_weight_fraction_leaf': 0.0, 'n_estimators': 100, 'presort': 'auto', 'random_state': None, 'subsample': 1.0, 'verbose': 0, 'warm_start': False}

Labels: None

Training accuracy: 0.9932890278863695
Training confusion matrix:
[[14768     0     1     5     0     0     0     5     0     1     1     0     0     0     0     0     4     0     0     0     1     0     0     1     0     0     0]
 [    4   233     0     0     0     0     0     0     0     0     0     0     0     0     0     0     0     0     0     0     0     0     0     0     0     0     0]
 [    0     0   284     0     0     0     0     0     0     0     0     0     0     0     0     0     0     0     0     0     0     0     0     0     0     0     0]
 [    2     0     0   192     0     0     0     0     0     0     0     0     0     0     0     0     0     0     0     0     0     0     0     0     0     0     0]
 [    0     0     0     0   197     0     0     0     0     0     0     0     0     0     0     0     0     0     0     0     0     0     0     0     0     0     0]
 [    0     0     0     0     0   133     0     0     0     0     0     0     5     2     0     0     0     0     0    15     0     0     0     0     0     0     0]
 [    0     0     0     0     0     0   120     0     0     0     0     0     0     0     0     0     0     0     0     0     0     0     0     0     0     0     0]
 [    1     0     0     0     0     0     0  1003     0     0     0     0     0     0     0     0     0     0     0     0     0     0     0     0     0     0     0]
 [    0     0     0     0     0     0     0     0   171     0     0     0     0     0     0     0     0     0     0     0     0     0     0     0     0     0     0]
 [    0     0     0     0     0     0     0     0     0  6802     0     0     0     0     0     0     0     0     0     0     0     0     0     0     0     0     0]
 [    0     0     0     0     0     0     0     0     0     0   211     0     0     0     0     0     0     0     0     0     0     0     0     0     0     0     0]
 [    0     0     0     0     0     0     0     0     0     0     0  1191     0     0     0     0     0     0     0     0     0     0     0     0     0     0     0]
 [    0     0     0     0     0     2     0     0     0     0     0     0    96     1     0     0     0     2     0     6     0     0     0     0     0     0     0]
 [    0     0     0     0     0     0     0     0     0     0     0     0     1    82     0     0     0     1     0     3     0     0     0     0     0     0     0]
 [    2     0     0     0     0     2     0     0     0     0     0     0     2     1   288     0     0     1     8     4     0     0     0     0     0     0     0]
 [    0     0     0     0     0     0     0     0     0     0     0     0     0     0     0    49     0     0     0     0     0     0     0     0     0     0     0]
 [    2     0     0     0     0     0     0     0     0     0     0     0     0     0     0     0   409     0     0     0     0     0     0     0     0     0     0]
 [    0     0     0     0     0     4     0     0     0     0     0     0     7     2     0     0     0   242     0    21     0     0     0     0     0     0     0]
 [    1     0     0     0     0     3     0     0     0     0     0     0     1     1     9     0     0     1    99     9     0     0     0     0     0     0     0]
 [    0     0     0     0     0     3     0     0     0     0     0     0    25     4     1     0     0    27     0   308     0     0     0     0     0     0     0]
 [    1     0     0     0     0     0     0     0     0     0     0     0     0     0     0     0     0     0     0     0   982     0     0     0     0     0     0]
 [    0     0     0     0     0     0     0     0     0     0     0     0     0     0     0     0     0     0     0     0     0   213     0     0     0     0     0]
 [    0     0     0     0     0     0     0     0     0     0     0     0     0     0     0     0     0     0     0     0     0     0  2108     0     0     0     0]
 [    0     0     0     0     0     0     0     0     0     0     0     0     0     0     0     0     0     0     0     0     0     0     0    35     0     0     0]
 [    0     0     0     0     0     0     0     0     0     0     0     0     0     0     0     0     0     0     0     0     0     0     0     0    29     0     0]
 [    0     0     0     0     0     0     0     0     0     0     0     0     0     0     0     0     0     0     0     0     0     0     0     0     0    62     0]
 [    0     0     0     0     0     0     0     0     0     0     0     0     0     0     0     0     0     0     0     0     0     0     0     0     0     0   183]]

Accuracy: 0.9768047954130832

Precision: [0.9897 1.0000 0.9865 0.9608 0.9821 0.5750 1.0000 0.9874 0.9811 0.9960 1.0000 1.0000 0.5116 0.6667 0.8966 1.0000 0.9612 0.7027 0.8077 0.6517 0.9885 0.9500 0.9944 1.0000 0.8889 0.9231 1.0000]
Mean: 0.9037659359884105
Std: 0.14436305175123412

Recall: [0.9936 0.9016 0.9605 0.9800 1.0000 0.6216 0.9677 0.9793 0.9811 0.9989 0.9655 0.9930 0.7857 0.5714 0.8667 0.9474 0.9706 0.6842 0.6176 0.5918 0.9736 1.0000 0.9981 1.0000 0.8889 0.9231 1.0000]
Mean: 0.8948888988128646
Std: 0.14169458360824772

F1 score: [0.9916 0.9483 0.9733 0.9703 0.9910 0.5974 0.9836 0.9833 0.9811 0.9974 0.9825 0.9965 0.6197 0.6154 0.8814 0.9730 0.9659 0.6933 0.7000 0.6203 0.9810 0.9744 0.9963 1.0000 0.8889 0.9231 1.0000]
Mean: 0.8973666634686945
Std: 0.14133480403373666

Cohen Kappa score: 0.9678461320669753
Confusion matrix:
[[3544    0    1    2    1    0    0    2    0    7    0    0    0    0    2    0    4    0    0    1    0    0    2    0    1    0    0]
 [   6   55    0    0    0    0    0    0    0    0    0    0    0    0    0    0    0    0    0    0    0    0    0    0    0    0    0]
 [   1    0   73    0    0    0    0    0    0    0    0    0    0    0    0    0    0    0    0    0    0    2    0    0    0    0    0]
 [   1    0    0   49    0    0    0    0    0    0    0    0    0    0    0    0    0    0    0    0    0    0    0    0    0    0    0]
 [   0    0    0    0   55    0    0    0    0    0    0    0    0    0    0    0    0    0    0    0    0    0    0    0    0    0    0]
 [   0    0    0    0    0   23    0    0    0    0    0    0    1    1    0    0    0    3    0    9    0    0    0    0    0    0    0]
 [   1    0    0    0    0    0   30    0    0    0    0    0    0    0    0    0    0    0    0    0    0    0    0    0    0    0    0]
 [   0    0    0    0    0    0    0  236    0    0    0    0    0    0    0    0    0    0    0    0    3    1    0    0    0    1    0]
 [   0    0    0    0    0    0    0    0   52    0    0    0    0    0    0    0    0    0    0    0    0    0    1    0    0    0    0]
 [   2    0    0    0    0    0    0    0    0 1748    0    0    0    0    0    0    0    0    0    0    0    0    0    0    0    0    0]
 [   2    0    0    0    0    0    0    0    0    0   56    0    0    0    0    0    0    0    0    0    0    0    0    0    0    0    0]
 [   2    0    0    0    0    0    0    0    0    0    0  284    0    0    0    0    0    0    0    0    0    0    0    0    0    0    0]
 [   0    0    0    0    0    1    0    0    0    0    0    0   22    1    1    0    0    2    0    1    0    0    0    0    0    0    0]
 [   0    0    0    0    0    4    0    0    0    0    0    0    1   12    0    0    0    2    0    2    0    0    0    0    0    0    0]
 [   5    0    0    0    0    0    0    0    0    0    0    0    0    0   78    0    0    0    4    3    0    0    0    0    0    0    0]
 [   1    0    0    0    0    0    0    0    0    0    0    0    0    0    0   18    0    0    0    0    0    0    0    0    0    0    0]
 [   3    0    0    0    0    0    0    0    0    0    0    0    0    0    0    0   99    0    0    0    0    0    0    0    0    0    0]
 [   1    0    0    0    0    1    0    0    0    0    0    0    6    1    0    0    0   52    0   15    0    0    0    0    0    0    0]
 [   1    0    0    0    0    3    0    0    0    0    0    0    1    1    5    0    0    2   21    0    0    0    0    0    0    0    0]
 [   3    0    0    0    0    8    0    0    0    0    0    0   12    2    1    0    0   13    1   58    0    0    0    0    0    0    0]
 [   6    0    0    0    0    0    0    1    0    0    0    0    0    0    0    0    0    0    0    0  258    0    0    0    0    0    0]
 [   0    0    0    0    0    0    0    0    0    0    0    0    0    0    0    0    0    0    0    0    0   57    0    0    0    0    0]
 [   0    0    0    0    0    0    0    0    1    0    0    0    0    0    0    0    0    0    0    0    0    0  537    0    0    0    0]
 [   0    0    0    0    0    0    0    0    0    0    0    0    0    0    0    0    0    0    0    0    0    0    0   10    0    0    0]
 [   1    0    0    0    0    0    0    0    0    0    0    0    0    0    0    0    0    0    0    0    0    0    0    0    8    0    0]
 [   1    0    0    0    0    0    0    0    0    0    0    0    0    0    0    0    0    0    0    0    0    0    0    0    0   12    0]
 [   0    0    0    0    0    0    0    0    0    0    0    0    0    0    0    0    0    0    0    0    0    0    0    0    0    0   49]]

