Classifier: LinearSVC
Params: {'C': 1.0, 'class_weight': None, 'dual': True, 'fit_intercept': True, 'intercept_scaling': 1, 'loss': 'squared_hinge', 'max_iter': 1000, 'multi_class': 'ovr', 'penalty': 'l2', 'random_state': None, 'tol': 0.0001, 'verbose': 0}

Labels: None

Training accuracy: 0.9898032316914256
Training confusion matrix:
[[14776     0     0     5     0     0     0     1     0     0     0     0     0     0     0     0     4     0     0     0     0     0     0     0     1     0     0]
 [    0   237     0     0     0     0     0     0     0     0     0     0     0     0     0     0     0     0     0     0     0     0     0     0     0     0     0]
 [    0     0   284     0     0     0     0     0     0     0     0     0     0     0     0     0     0     0     0     0     0     0     0     0     0     0     0]
 [    0     0     0   194     0     0     0     0     0     0     0     0     0     0     0     0     0     0     0     0     0     0     0     0     0     0     0]
 [    0     0     0     0   197     0     0     0     0     0     0     0     0     0     0     0     0     0     0     0     0     0     0     0     0     0     0]
 [    0     0     0     0     0   117     0     0     0     0     0     0    10     2     1     0     0     2     3    20     0     0     0     0     0     0     0]
 [    0     0     0     0     0     0   120     0     0     0     0     0     0     0     0     0     0     0     0     0     0     0     0     0     0     0     0]
 [    0     0     0     0     0     0     0  1004     0     0     0     0     0     0     0     0     0     0     0     0     0     0     0     0     0     0     0]
 [    0     0     0     0     0     0     0     0   171     0     0     0     0     0     0     0     0     0     0     0     0     0     0     0     0     0     0]
 [    0     0     0     0     0     0     0     0     0  6802     0     0     0     0     0     0     0     0     0     0     0     0     0     0     0     0     0]
 [    0     0     0     0     0     0     0     0     0     0   211     0     0     0     0     0     0     0     0     0     0     0     0     0     0     0     0]
 [    0     0     0     0     0     0     0     0     0     0     0  1191     0     0     0     0     0     0     0     0     0     0     0     0     0     0     0]
 [    0     0     0     0     0     4     0     0     0     0     0     0    96     3     0     0     0     2     0     2     0     0     0     0     0     0     0]
 [    0     0     0     0     0     5     0     0     0     0     0     0     6    70     1     0     0     2     0     3     0     0     0     0     0     0     0]
 [    0     0     0     0     0     3     0     0     0     0     0     0     1     2   292     0     0     0     4     6     0     0     0     0     0     0     0]
 [    0     0     0     0     0     0     0     0     0     0     0     0     0     0     0    49     0     0     0     0     0     0     0     0     0     0     0]
 [    2     0     0     0     0     0     0     0     0     0     0     0     0     0     0     0   409     0     0     0     0     0     0     0     0     0     0]
 [    0     0     0     0     0     9     0     0     0     0     0     0    14     9     1     0     0   205     1    37     0     0     0     0     0     0     0]
 [    0     0     0     0     0     2     0     0     0     0     0     0     1     0    11     0     0     2   100     8     0     0     0     0     0     0     0]
 [    0     0     0     0     0    20     0     0     0     0     0     0    37    11     4     0     0    42     7   247     0     0     0     0     0     0     0]
 [    1     0     0     0     0     0     0     0     0     0     0     0     0     0     0     0     0     0     0     0   982     0     0     0     0     0     0]
 [    0     0     0     0     0     0     0     0     0     0     0     0     0     0     0     0     0     0     0     0     0   213     0     0     0     0     0]
 [    0     0     0     0     0     0     0     0     0     0     0     0     0     0     0     0     0     0     0     0     0     0  2108     0     0     0     0]
 [    1     0     0     0     0     0     0     0     0     0     0     0     0     0     0     0     0     0     0     0     0     0     0    34     0     0     0]
 [    0     0     0     0     0     0     0     0     0     0     0     0     0     0     0     0     0     0     0     0     0     0     0     0    29     0     0]
 [    0     0     0     0     0     0     0     0     0     0     0     0     0     0     0     0     0     0     0     0     0     0     0     0     0    62     0]
 [    0     0     0     0     0     0     0     0     0     0     0     0     0     0     0     0     0     0     0     0     0     0     0     0     0     0   183]]

Accuracy: 0.9790200677612718

Precision: [0.9930 1.0000 0.9867 0.9216 0.9649 0.6250 1.0000 0.9836 0.9808 0.9983 1.0000 1.0000 0.4894 0.6667 0.8571 1.0000 0.9615 0.8060 0.7586 0.6429 0.9923 0.9821 0.9944 1.0000 0.8750 1.0000 1.0000]
Mean: 0.9066625700955042
Std: 0.1423221894430055

Recall: [0.9941 0.9672 0.9737 0.9400 1.0000 0.6757 1.0000 0.9959 0.9623 0.9977 0.9483 0.9965 0.8214 0.6667 0.9333 0.9474 0.9804 0.7105 0.6471 0.5510 0.9774 0.9649 0.9981 1.0000 0.7778 1.0000 1.0000]
Mean: 0.9047140232649166
Std: 0.1335069962932779

F1 score: [0.9936 0.9833 0.9801 0.9307 0.9821 0.6494 1.0000 0.9897 0.9714 0.9980 0.9735 0.9982 0.6133 0.6667 0.8936 0.9730 0.9709 0.7552 0.6984 0.5934 0.9848 0.9735 0.9963 1.0000 0.8235 1.0000 1.0000]
Mean: 0.9034302066305551
Std: 0.13613985577755958

Cohen Kappa score: 0.9709472850751298
Confusion matrix:
[[3546    0    1    3    0    0    0    2    0    3    0    0    0    0    2    0    4    0    0    2    1    0    2    0    1    0    0]
 [   2   59    0    0    0    0    0    0    0    0    0    0    0    0    0    0    0    0    0    0    0    0    0    0    0    0    0]
 [   1    0   74    0    0    0    0    0    0    0    0    0    0    0    0    0    0    0    0    0    0    1    0    0    0    0    0]
 [   2    0    0   47    1    0    0    0    0    0    0    0    0    0    0    0    0    0    0    0    0    0    0    0    0    0    0]
 [   0    0    0    0   55    0    0    0    0    0    0    0    0    0    0    0    0    0    0    0    0    0    0    0    0    0    0]
 [   0    0    0    0    0   25    0    0    0    0    0    0    1    0    0    0    0    1    2    8    0    0    0    0    0    0    0]
 [   0    0    0    0    0    0   31    0    0    0    0    0    0    0    0    0    0    0    0    0    0    0    0    0    0    0    0]
 [   0    0    0    0    0    0    0  240    0    0    0    0    0    0    0    0    0    0    0    0    1    0    0    0    0    0    0]
 [   1    0    0    0    0    0    0    0   51    0    0    0    0    0    0    0    0    0    0    0    0    0    1    0    0    0    0]
 [   3    0    0    0    0    0    0    0    0 1746    0    0    0    0    0    0    0    0    0    1    0    0    0    0    0    0    0]
 [   2    0    0    0    0    0    0    0    0    0   55    0    0    0    1    0    0    0    0    0    0    0    0    0    0    0    0]
 [   1    0    0    0    0    0    0    0    0    0    0  285    0    0    0    0    0    0    0    0    0    0    0    0    0    0    0]
 [   0    0    0    0    0    0    0    0    0    0    0    0   23    1    0    0    0    0    0    4    0    0    0    0    0    0    0]
 [   0    0    0    0    0    4    0    0    0    0    0    0    1   14    0    0    0    0    0    2    0    0    0    0    0    0    0]
 [   1    0    0    0    0    0    0    0    0    0    0    0    0    0   84    0    0    0    1    4    0    0    0    0    0    0    0]
 [   1    0    0    0    0    0    0    0    0    0    0    0    0    0    0   18    0    0    0    0    0    0    0    0    0    0    0]
 [   1    0    0    0    1    0    0    0    0    0    0    0    0    0    0    0  100    0    0    0    0    0    0    0    0    0    0]
 [   0    0    0    0    0    1    0    0    0    0    0    0    7    2    2    0    0   54    1    9    0    0    0    0    0    0    0]
 [   1    0    0    0    0    1    0    0    0    0    0    0    3    0    7    0    0    0   22    0    0    0    0    0    0    0    0]
 [   2    0    0    0    0    9    0    0    0    0    0    0   12    4    2    0    0   12    3   54    0    0    0    0    0    0    0]
 [   4    0    0    0    0    0    0    2    0    0    0    0    0    0    0    0    0    0    0    0  259    0    0    0    0    0    0]
 [   2    0    0    0    0    0    0    0    0    0    0    0    0    0    0    0    0    0    0    0    0   55    0    0    0    0    0]
 [   0    0    0    0    0    0    0    0    1    0    0    0    0    0    0    0    0    0    0    0    0    0  537    0    0    0    0]
 [   0    0    0    0    0    0    0    0    0    0    0    0    0    0    0    0    0    0    0    0    0    0    0   10    0    0    0]
 [   1    0    0    1    0    0    0    0    0    0    0    0    0    0    0    0    0    0    0    0    0    0    0    0    7    0    0]
 [   0    0    0    0    0    0    0    0    0    0    0    0    0    0    0    0    0    0    0    0    0    0    0    0    0   13    0]
 [   0    0    0    0    0    0    0    0    0    0    0    0    0    0    0    0    0    0    0    0    0    0    0    0    0    0   49]]

