Classifier: LogisticRegression
Params: {'C': 1.0, 'class_weight': None, 'dual': False, 'fit_intercept': True, 'intercept_scaling': 1, 'max_iter': 100, 'multi_class': 'ovr', 'n_jobs': 1, 'penalty': 'l2', 'random_state': None, 'solver': 'liblinear', 'tol': 0.0001, 'verbose': 0, 'warm_start': False}

Labels: None

Training accuracy: 0.9881417774302841
Training confusion matrix:
[[14756     2     2     5     0     0     0     6     0     2     2     0     0     0     1     0     4     0     0     0     2     2     1     1     1     0     0]
 [    1   236     0     0     0     0     0     0     0     0     0     0     0     0     0     0     0     0     0     0     0     0     0     0     0     0     0]
 [    3     0   281     0     0     0     0     0     0     0     0     0     0     0     0     0     0     0     0     0     0     0     0     0     0     0     0]
 [    5     0     0   189     0     0     0     0     0     0     0     0     0     0     0     0     0     0     0     0     0     0     0     0     0     0     0]
 [    0     0     0     0   197     0     0     0     0     0     0     0     0     0     0     0     0     0     0     0     0     0     0     0     0     0     0]
 [    0     0     0     0     0   115     0     0     0     0     0     0     7     2     0     0     0     2     4    25     0     0     0     0     0     0     0]
 [    0     0     0     0     0     0   120     0     0     0     0     0     0     0     0     0     0     0     0     0     0     0     0     0     0     0     0]
 [    2     0     1     0     0     0     0   999     0     0     0     0     0     0     0     0     0     0     0     0     2     0     0     0     0     0     0]
 [    0     0     0     0     0     0     0     0   171     0     0     0     0     0     0     0     0     0     0     0     0     0     0     0     0     0     0]
 [    2     0     0     0     0     0     0     0     0  6800     0     0     0     0     0     0     0     0     0     0     0     0     0     0     0     0     0]
 [    1     0     0     0     0     0     0     0     0     0   210     0     0     0     0     0     0     0     0     0     0     0     0     0     0     0     0]
 [    0     0     0     0     0     0     0     0     0     0     0  1191     0     0     0     0     0     0     0     0     0     0     0     0     0     0     0]
 [    0     0     0     0     0     5     0     0     0     0     0     0    78     5     0     0     0     4     0    15     0     0     0     0     0     0     0]
 [    0     0     0     0     0     8     0     0     0     0     0     0     2    66     2     0     0     2     0     7     0     0     0     0     0     0     0]
 [    1     0     0     0     0     3     0     0     0     0     0     0     1     1   293     0     0     1     2     6     0     0     0     0     0     0     0]
 [    0     0     0     0     0     0     0     0     0     0     0     0     0     0     0    49     0     0     0     0     0     0     0     0     0     0     0]
 [    4     0     0     0     0     0     0     0     0     0     0     0     0     0     0     0   407     0     0     0     0     0     0     0     0     0     0]
 [    0     0     0     0     0     9     0     0     0     0     0     0    11     8     1     0     0   210     1    36     0     0     0     0     0     0     0]
 [    0     0     0     0     0     3     0     0     0     0     0     0     1     0    16     0     0     3    89    12     0     0     0     0     0     0     0]
 [    0     0     0     0     0    11     0     0     0     0     0     0    28     8     3     0     0    42     4   272     0     0     0     0     0     0     0]
 [    2     0     0     0     0     0     0     1     0     0     0     0     0     0     0     0     0     0     0     0   980     0     0     0     0     0     0]
 [    1     0     0     0     0     0     0     0     0     0     0     0     0     0     0     0     0     0     0     0     0   212     0     0     0     0     0]
 [    1     0     0     0     0     0     0     0     0     0     0     0     0     0     0     0     0     0     0     0     0     0  2107     0     0     0     0]
 [    1     0     0     0     0     0     0     0     0     1     0     0     0     0     0     0     0     0     0     0     0     0     0    33     0     0     0]
 [    1     0     0     0     0     0     0     0     0     0     0     0     0     0     0     0     0     0     0     0     0     0     0     0    28     0     0]
 [    0     0     0     0     0     0     0     1     0     0     0     0     0     0     0     0     0     0     0     0     0     0     0     0     0    61     0]
 [    1     0     0     0     0     0     0     0     0     0     0     0     0     0     0     0     0     0     0     0     0     0     0     0     0     0   182]]

Accuracy: 0.9792806880375293

Precision: [0.9908 1.0000 0.9865 0.9200 1.0000 0.6562 1.0000 0.9958 0.9808 0.9966 1.0000 1.0000 0.4872 0.7222 0.9022 1.0000 0.9619 0.7857 0.8148 0.6471 0.9887 0.9825 0.9944 1.0000 0.8750 1.0000 1.0000]
Mean: 0.9143825620108529
Std: 0.13599416175829696

Recall: [0.9944 0.9508 0.9605 0.9200 1.0000 0.5676 1.0000 0.9876 0.9623 0.9983 0.9310 0.9930 0.6786 0.6190 0.9222 0.9474 0.9902 0.7237 0.6471 0.6735 0.9887 0.9825 0.9981 0.9000 0.7778 1.0000 1.0000]
Mean: 0.8931156455396251
Std: 0.13878532170910074

F1 score: [0.9926 0.9748 0.9733 0.9200 1.0000 0.6087 1.0000 0.9917 0.9714 0.9974 0.9643 0.9965 0.5672 0.6667 0.9121 0.9730 0.9758 0.7534 0.7213 0.6600 0.9887 0.9825 0.9963 0.9474 0.8235 1.0000 1.0000]
Mean: 0.9021667434951461
Std: 0.13616484459626088

Cohen Kappa score: 0.9712816712716048
Confusion matrix:
[[3547    0    1    3    0    0    0    1    0    5    0    0    0    0    2    0    4    0    0    0    1    0    2    0    1    0    0]
 [   3   58    0    0    0    0    0    0    0    0    0    0    0    0    0    0    0    0    0    0    0    0    0    0    0    0    0]
 [   2    0   73    0    0    0    0    0    0    0    0    0    0    0    0    0    0    0    0    0    0    1    0    0    0    0    0]
 [   4    0    0   46    0    0    0    0    0    0    0    0    0    0    0    0    0    0    0    0    0    0    0    0    0    0    0]
 [   0    0    0    0   55    0    0    0    0    0    0    0    0    0    0    0    0    0    0    0    0    0    0    0    0    0    0]
 [   0    0    0    0    0   21    0    0    0    0    0    0    1    0    0    0    0    1    2   12    0    0    0    0    0    0    0]
 [   0    0    0    0    0    0   31    0    0    0    0    0    0    0    0    0    0    0    0    0    0    0    0    0    0    0    0]
 [   1    0    0    0    0    0    0  238    0    0    0    0    0    0    0    0    0    0    0    0    2    0    0    0    0    0    0]
 [   1    0    0    0    0    0    0    0   51    0    0    0    0    0    0    0    0    0    0    0    0    0    1    0    0    0    0]
 [   3    0    0    0    0    0    0    0    0 1747    0    0    0    0    0    0    0    0    0    0    0    0    0    0    0    0    0]
 [   3    0    0    0    0    0    0    0    0    0   54    0    0    0    1    0    0    0    0    0    0    0    0    0    0    0    0]
 [   2    0    0    0    0    0    0    0    0    0    0  284    0    0    0    0    0    0    0    0    0    0    0    0    0    0    0]
 [   0    0    0    0    0    1    0    0    0    0    0    0   19    1    0    0    0    1    0    6    0    0    0    0    0    0    0]
 [   0    0    0    0    0    4    0    0    0    0    0    0    0   13    0    0    0    0    0    4    0    0    0    0    0    0    0]
 [   2    0    0    0    0    0    0    0    0    0    0    0    0    0   83    0    0    0    1    4    0    0    0    0    0    0    0]
 [   1    0    0    0    0    0    0    0    0    0    0    0    0    0    0   18    0    0    0    0    0    0    0    0    0    0    0]
 [   1    0    0    0    0    0    0    0    0    0    0    0    0    0    0    0  101    0    0    0    0    0    0    0    0    0    0]
 [   2    0    0    0    0    0    0    0    0    0    0    0    6    2    0    0    0   55    1   10    0    0    0    0    0    0    0]
 [   1    0    0    0    0    1    0    0    0    0    0    0    3    0    6    0    0    1   22    0    0    0    0    0    0    0    0]
 [   2    0    0    0    0    5    0    0    0    0    0    0   10    2    0    0    0   12    1   66    0    0    0    0    0    0    0]
 [   3    0    0    0    0    0    0    0    0    0    0    0    0    0    0    0    0    0    0    0  262    0    0    0    0    0    0]
 [   1    0    0    0    0    0    0    0    0    0    0    0    0    0    0    0    0    0    0    0    0   56    0    0    0    0    0]
 [   0    0    0    0    0    0    0    0    1    0    0    0    0    0    0    0    0    0    0    0    0    0  537    0    0    0    0]
 [   0    0    0    0    0    0    0    0    0    1    0    0    0    0    0    0    0    0    0    0    0    0    0    9    0    0    0]
 [   1    0    0    1    0    0    0    0    0    0    0    0    0    0    0    0    0    0    0    0    0    0    0    0    7    0    0]
 [   0    0    0    0    0    0    0    0    0    0    0    0    0    0    0    0    0    0    0    0    0    0    0    0    0   13    0]
 [   0    0    0    0    0    0    0    0    0    0    0    0    0    0    0    0    0    0    0    0    0    0    0    0    0    0   49]]

