Classifier: MLPClassifier
Params: {'activation': 'relu', 'alpha': 0.0001, 'batch_size': 'auto', 'beta_1': 0.9, 'beta_2': 0.999, 'early_stopping': False, 'epsilon': 1e-08, 'hidden_layer_sizes': (100,), 'learning_rate': 'constant', 'learning_rate_init': 0.001, 'max_iter': 200, 'momentum': 0.9, 'nesterovs_momentum': True, 'power_t': 0.5, 'random_state': None, 'shuffle': True, 'solver': 'adam', 'tol': 0.0001, 'validation_fraction': 0.1, 'verbose': False, 'warm_start': False}

Labels: None

Training accuracy: 0.99091086786552
Training confusion matrix:
[[14775     0     0     5     0     0     0     0     0     0     0     0     0     0     0     0     6     0     0     0     0     0     0     1     0     0     0]
 [    0   237     0     0     0     0     0     0     0     0     0     0     0     0     0     0     0     0     0     0     0     0     0     0     0     0     0]
 [    0     0   284     0     0     0     0     0     0     0     0     0     0     0     0     0     0     0     0     0     0     0     0     0     0     0     0]
 [    3     0     0   191     0     0     0     0     0     0     0     0     0     0     0     0     0     0     0     0     0     0     0     0     0     0     0]
 [    0     0     0     0   197     0     0     0     0     0     0     0     0     0     0     0     0     0     0     0     0     0     0     0     0     0     0]
 [    0     0     0     0     0   123     0     0     0     0     0     0     3     1     0     0     0     2     0    26     0     0     0     0     0     0     0]
 [    0     0     0     0     0     0   120     0     0     0     0     0     0     0     0     0     0     0     0     0     0     0     0     0     0     0     0]
 [    0     0     0     0     0     0     0  1004     0     0     0     0     0     0     0     0     0     0     0     0     0     0     0     0     0     0     0]
 [    0     0     0     0     0     0     0     0   171     0     0     0     0     0     0     0     0     0     0     0     0     0     0     0     0     0     0]
 [    0     0     0     0     0     0     0     0     0  6802     0     0     0     0     0     0     0     0     0     0     0     0     0     0     0     0     0]
 [    0     0     0     0     0     0     0     0     0     0   211     0     0     0     0     0     0     0     0     0     0     0     0     0     0     0     0]
 [    0     0     0     0     0     0     0     0     0     0     0  1191     0     0     0     0     0     0     0     0     0     0     0     0     0     0     0]
 [    0     0     0     0     0     2     0     0     0     0     0     0    76     2     0     0     0     4     0    23     0     0     0     0     0     0     0]
 [    0     0     0     0     0     7     0     0     0     0     0     0     5    55     0     0     0     5     0    15     0     0     0     0     0     0     0]
 [    1     0     0     0     0     3     0     0     0     0     0     0     1     2   275     0     0     0    20     6     0     0     0     0     0     0     0]
 [    0     0     0     0     0     0     0     0     0     0     0     0     0     0     0    49     0     0     0     0     0     0     0     0     0     0     0]
 [    0     0     0     0     0     0     0     0     0     0     0     0     0     0     0     0   411     0     0     0     0     0     0     0     0     0     0]
 [    0     0     0     0     0     8     0     0     0     0     0     0     3     4     0     0     0   233     0    28     0     0     0     0     0     0     0]
 [    0     0     0     0     0     5     0     0     0     0     0     0     1     1     2     0     0     2   101    12     0     0     0     0     0     0     0]
 [    0     0     0     0     0     7     0     0     0     0     0     0     8     3     1     0     0    48     2   299     0     0     0     0     0     0     0]
 [    1     0     0     0     0     0     0     0     0     0     0     0     0     0     0     0     0     0     0     0   982     0     0     0     0     0     0]
 [    0     0     0     0     0     0     0     0     0     0     0     0     0     0     0     0     0     0     0     0     0   213     0     0     0     0     0]
 [    0     0     0     0     0     0     0     0     0     0     0     0     0     0     0     0     0     0     0     0     0     0  2108     0     0     0     0]
 [    0     0     0     0     0     0     0     0     0     0     0     0     0     0     0     0     0     0     0     0     0     0     0    35     0     0     0]
 [    0     0     0     0     0     0     0     0     0     0     0     0     0     0     0     0     0     0     0     0     0     0     0     0    29     0     0]
 [    0     0     0     0     0     0     0     0     0     0     0     0     0     0     0     0     0     0     0     0     0     0     0     0     0    62     0]
 [    0     0     0     0     0     0     0     0     0     0     0     0     0     0     0     0     0     0     0     0     0     0     0     0     0     0   183]]

Accuracy: 0.979410998175658

Precision: [0.9922 1.0000 0.9865 0.9231 1.0000 0.6765 1.0000 0.9835 0.9808 0.9989 1.0000 1.0000 0.4815 0.7143 0.9405 1.0000 0.9623 0.7089 0.7429 0.6330 0.9924 0.9649 0.9944 1.0000 0.8750 1.0000 1.0000]
Mean: 0.9093077326680543
Std: 0.14238167758140668

Recall: [0.9950 0.9344 0.9605 0.9600 0.9636 0.6216 0.9677 0.9876 0.9623 0.9989 0.9655 1.0000 0.4643 0.4762 0.8778 0.9474 1.0000 0.7368 0.7647 0.7041 0.9849 0.9649 0.9981 1.0000 0.7778 1.0000 0.9796]
Mean: 0.8886547200069642
Std: 0.1567689309623665

F1 score: [0.9936 0.9661 0.9733 0.9412 0.9815 0.6479 0.9836 0.9855 0.9714 0.9989 0.9825 1.0000 0.4727 0.5714 0.9080 0.9730 0.9808 0.7226 0.7536 0.6667 0.9886 0.9649 0.9963 1.0000 0.8235 1.0000 0.9897]
Mean: 0.8976766563201496
Std: 0.14922549622351483

Cohen Kappa score: 0.971472047810387
Confusion matrix:
[[3549    0    1    3    0    0    0    3    0    2    0    0    0    0    1    0    4    0    0    0    1    0    2    0    1    0    0]
 [   4   57    0    0    0    0    0    0    0    0    0    0    0    0    0    0    0    0    0    0    0    0    0    0    0    0    0]
 [   1    0   73    0    0    0    0    0    0    0    0    0    0    0    0    0    0    0    0    0    0    2    0    0    0    0    0]
 [   2    0    0   48    0    0    0    0    0    0    0    0    0    0    0    0    0    0    0    0    0    0    0    0    0    0    0]
 [   2    0    0    0   53    0    0    0    0    0    0    0    0    0    0    0    0    0    0    0    0    0    0    0    0    0    0]
 [   0    0    0    0    0   23    0    0    0    0    0    0    0    0    0    0    0    2    0   12    0    0    0    0    0    0    0]
 [   1    0    0    0    0    0   30    0    0    0    0    0    0    0    0    0    0    0    0    0    0    0    0    0    0    0    0]
 [   2    0    0    0    0    0    0  238    0    0    0    0    0    0    0    0    0    0    0    0    1    0    0    0    0    0    0]
 [   1    0    0    0    0    0    0    0   51    0    0    0    0    0    0    0    0    0    0    0    0    0    1    0    0    0    0]
 [   2    0    0    0    0    0    0    0    0 1748    0    0    0    0    0    0    0    0    0    0    0    0    0    0    0    0    0]
 [   2    0    0    0    0    0    0    0    0    0   56    0    0    0    0    0    0    0    0    0    0    0    0    0    0    0    0]
 [   0    0    0    0    0    0    0    0    0    0    0  286    0    0    0    0    0    0    0    0    0    0    0    0    0    0    0]
 [   0    0    0    0    0    2    0    0    0    0    0    0   13    1    1    0    0    2    0    9    0    0    0    0    0    0    0]
 [   0    0    0    0    0    4    0    0    0    0    0    0    1   10    0    0    0    2    0    4    0    0    0    0    0    0    0]
 [   1    0    0    0    0    0    0    0    0    0    0    0    0    0   79    0    0    0    6    4    0    0    0    0    0    0    0]
 [   1    0    0    0    0    0    0    0    0    0    0    0    0    0    0   18    0    0    0    0    0    0    0    0    0    0    0]
 [   0    0    0    0    0    0    0    0    0    0    0    0    0    0    0    0  102    0    0    0    0    0    0    0    0    0    0]
 [   0    0    0    0    0    1    0    0    0    0    0    0    4    1    2    0    0   56    1   11    0    0    0    0    0    0    0]
 [   0    0    0    0    0    1    0    0    0    0    0    0    3    1    1    0    0    2   26    0    0    0    0    0    0    0    0]
 [   2    0    0    0    0    3    0    0    0    0    0    0    6    1    0    0    0   15    2   69    0    0    0    0    0    0    0]
 [   3    0    0    0    0    0    0    1    0    0    0    0    0    0    0    0    0    0    0    0  261    0    0    0    0    0    0]
 [   2    0    0    0    0    0    0    0    0    0    0    0    0    0    0    0    0    0    0    0    0   55    0    0    0    0    0]
 [   0    0    0    0    0    0    0    0    1    0    0    0    0    0    0    0    0    0    0    0    0    0  537    0    0    0    0]
 [   0    0    0    0    0    0    0    0    0    0    0    0    0    0    0    0    0    0    0    0    0    0    0   10    0    0    0]
 [   1    0    0    1    0    0    0    0    0    0    0    0    0    0    0    0    0    0    0    0    0    0    0    0    7    0    0]
 [   0    0    0    0    0    0    0    0    0    0    0    0    0    0    0    0    0    0    0    0    0    0    0    0    0   13    0]
 [   1    0    0    0    0    0    0    0    0    0    0    0    0    0    0    0    0    0    0    0    0    0    0    0    0    0   48]]

