Classifier: MultinomialNB
Params: {'alpha': 1.0, 'class_prior': None, 'fit_prior': True}

Labels: None

Training accuracy: 0.9204130831378681
Training confusion matrix:
[[14127    42     4    37     2     0     0   235     0    29    48     3     0     0    64     0     2    53     0    97    34     0    10     0     0     0     0]
 [   18   219     0     0     0     0     0     0     0     0     0     0     0     0     0     0     0     0     0     0     0     0     0     0     0     0     0]
 [    2     0   177     0     1     0     3    75     0     0     0     0     0     0     0     0     3     0     0     0    23     0     0     0     0     0     0]
 [   72     0     0    99     0     0     0     0     0     0     0     0     0     0     0     0    14     0     0     0     0     0     9     0     0     0     0]
 [    1     0     0     0   150     0     5    30     0     0     0     0     0     0     0     0     4     0     0     0     1     0     6     0     0     0     0]
 [    1     0     0     0     0     1     0     0     0     0     0     0     0     0     3     0     0     0     0   150     0     0     0     0     0     0     0]
 [    0     0     0     0     0     0   101     6     0     0     0     0     0     0     0     0     3     0     0     0     0     0    10     0     0     0     0]
 [    2     0     1     0     1     0     0   991     0     0     0     0     0     0     0     0     0     0     0     0     9     0     0     0     0     0     0]
 [    1     0     0     0     0     0     1     1   163     0     0     0     0     0     0     0     0     0     0     0     0     0     5     0     0     0     0]
 [  142     0     0     0     0     0     0     3     0  6635     0     1     0     0     1     0     2     0     0     0     0     0    18     0     0     0     0]
 [   48     0     0     0     0     0     0     0     0     0   161     0     0     0     0     0     0     0     0     2     0     0     0     0     0     0     0]
 [   19     0     0     0     0     0     0     0     0     1     0  1171     0     0     0     0     0     0     0     0     0     0     0     0     0     0     0]
 [    0     0     0     0     0     0     0     0     0     0     0     0     0     0     0     0     0     0     0   107     0     0     0     0     0     0     0]
 [    1     0     0     0     0     0     0     0     0     0     0     0     0     0     0     0     0     0     0    86     0     0     0     0     0     0     0]
 [   10     0     0     0     0     0     0     2     0     0     0     0     0     0   150     0     0    11     0   117     0     0    18     0     0     0     0]
 [    0     0     0     0     1     0     0     1     0     0     0     0     0     0     0    27     0     0     0     0     1     0    19     0     0     0     0]
 [   66     0     0     0     1     0     0     1     0     0     0     0     0     0     0     0   343     0     0     0     0     0     0     0     0     0     0]
 [    8     0     0     0     0     0     0     0     0     0     0     0     0     0     0     0     0    54     0   214     0     0     0     0     0     0     0]
 [    3     0     0     0     0     0     0     0     0     0     0     0     0     0    14     0     0     9     1    97     0     0     0     0     0     0     0]
 [    5     0     0     0     0     0     0     1     0     0     4     0     0     0     1     0     0    11     0   340     0     0     6     0     0     0     0]
 [    3     0     0     0     0     0     0     7     0     0     0     0     0     0     0     0     0     0     0     0   972     0     1     0     0     0     0]
 [    2     0     0     0     0     0     0    30     0     0     0     0     0     0     0     0     1     0     0     0    62   113     5     0     0     0     0]
 [    3     0     1     0     1     0     1     7     0     0     0     0     0     0     0     0     0     0     0     0     0     0  2095     0     0     0     0]
 [   21    13     0     0     0     0     0     0     0     0     0     1     0     0     0     0     0     0     0     0     0     0     0     0     0     0     0]
 [   20     0     0     0     0     0     0     0     0     0     0     0     0     0     0     0     0     0     0     0     0     0     0     0     9     0     0]
 [    0     0     1     0     5     0     0    25     0     0     0     0     0     0     0     0     2     0     0     0    16     0     6     0     0     7     0]
 [    2     0     3     0     1     0     0    19     0     0     0     0     0     0     0     0     0     0     0     0    11     0     0     0     0     0   147]]

Accuracy: 0.9121709669012249

Precision: [0.9621 0.8358 0.9545 0.7692 0.9000 0.0000 0.9524 0.6667 0.9792 0.9948 0.7451 0.9856 0.0000 0.0000 0.5915 1.0000 0.8911 0.4545 0.0000 0.2827 0.8490 1.0000 0.9371 0.0000 1.0000 1.0000 1.0000]
Mean: 0.6944931480144069
Std: 0.37368221792317957

Recall: [0.9540 0.9180 0.5526 0.4000 0.8182 0.0000 0.6452 0.9876 0.8868 0.9771 0.6552 0.9580 0.0000 0.0000 0.4667 0.4737 0.8824 0.1316 0.0000 0.9490 0.9547 0.4737 0.9963 0.0000 0.3333 0.2308 0.8367]
Mean: 0.5733894572949978
Std: 0.3662691145608884

F1 score: [0.9581 0.8750 0.7000 0.5263 0.8571 0.0000 0.7692 0.7960 0.9307 0.9859 0.6972 0.9716 0.0000 0.0000 0.5217 0.6429 0.8867 0.2041 0.0000 0.4356 0.8988 0.6429 0.9658 0.0000 0.5000 0.3750 0.9111]
Mean: 0.5945051850568446
Std: 0.34499954108123887

Cohen Kappa score: 0.8787025837011284
Confusion matrix:
[[3403    6    2    6    0    0    0   57    0    8   12    4    0    0   19    0    1    8    0   29    7    0    5    0    0    0    0]
 [   5   56    0    0    0    0    0    0    0    0    0    0    0    0    0    0    0    0    0    0    0    0    0    0    0    0    0]
 [   2    0   42    0    2    0    1   17    0    0    0    0    0    0    0    0    0    0    0    0   12    0    0    0    0    0    0]
 [  23    0    0   20    0    0    0    0    0    0    0    0    0    0    0    0    5    0    0    0    0    0    2    0    0    0    0]
 [   0    0    0    0   45    0    0    7    0    0    0    0    0    0    0    0    1    0    0    0    0    0    2    0    0    0    0]
 [   0    0    0    0    0    0    0    0    0    0    0    0    0    0    1    0    0    0    0   36    0    0    0    0    0    0    0]
 [   0    0    0    0    0    0   20    3    0    0    0    0    0    0    0    0    2    0    0    0    0    0    6    0    0    0    0]
 [   1    0    0    0    0    0    0  238    0    0    0    0    0    0    0    0    0    0    0    0    2    0    0    0    0    0    0]
 [   0    0    0    0    1    0    0    1   47    0    0    0    0    0    0    0    1    0    0    0    0    0    3    0    0    0    0]
 [  34    0    0    0    0    0    0    1    0 1710    0    0    0    0    1    0    0    0    0    0    0    0    4    0    0    0    0]
 [  19    0    0    0    0    0    0    0    0    0   38    0    0    0    0    0    0    0    0    1    0    0    0    0    0    0    0]
 [  11    0    0    0    0    0    0    0    0    1    0  274    0    0    0    0    0    0    0    0    0    0    0    0    0    0    0]
 [   0    0    0    0    0    0    0    0    0    0    0    0    0    0    0    0    0    0    0   28    0    0    0    0    0    0    0]
 [   0    0    0    0    0    0    0    0    0    0    0    0    0    0    0    0    0    0    0   21    0    0    0    0    0    0    0]
 [   5    0    0    0    0    0    0    1    0    0    0    0    0    0   42    0    0    2    0   33    0    0    7    0    0    0    0]
 [   1    0    0    0    2    0    0    3    0    0    0    0    0    0    0    9    1    0    0    0    0    0    3    0    0    0    0]
 [  11    0    0    0    0    0    0    1    0    0    0    0    0    0    0    0   90    0    0    0    0    0    0    0    0    0    0]
 [   3    0    0    0    0    0    0    0    0    0    0    0    0    0    1    0    0   10    0   62    0    0    0    0    0    0    0]
 [   2    0    0    0    0    0    0    0    0    0    0    0    0    0    6    0    0    0    0   26    0    0    0    0    0    0    0]
 [   1    0    0    0    0    0    0    0    0    0    1    0    0    0    1    0    0    2    0   93    0    0    0    0    0    0    0]
 [   3    0    0    0    0    0    0    9    0    0    0    0    0    0    0    0    0    0    0    0  253    0    0    0    0    0    0]
 [   0    0    0    0    0    0    0    8    0    0    0    0    0    0    0    0    0    0    0    0   21   27    1    0    0    0    0]
 [   1    0    0    0    0    0    0    0    1    0    0    0    0    0    0    0    0    0    0    0    0    0  536    0    0    0    0]
 [   5    5    0    0    0    0    0    0    0    0    0    0    0    0    0    0    0    0    0    0    0    0    0    0    0    0    0]
 [   6    0    0    0    0    0    0    0    0    0    0    0    0    0    0    0    0    0    0    0    0    0    0    0    3    0    0]
 [   0    0    0    0    0    0    0    4    0    0    0    0    0    0    0    0    0    0    0    0    3    0    3    0    0    3    0]
 [   1    0    0    0    0    0    0    7    0    0    0    0    0    0    0    0    0    0    0    0    0    0    0    0    0    0   41]]

