Classifier: RandomForestClassifier
Params: {'bootstrap': True, 'class_weight': None, 'criterion': 'gini', 'max_depth': None, 'max_features': 'auto', 'max_leaf_nodes': None, 'min_impurity_decrease': 0.0, 'min_impurity_split': None, 'min_samples_leaf': 1, 'min_samples_split': 2, 'min_weight_fraction_leaf': 0.0, 'n_estimators': 100, 'n_jobs': 1, 'oob_score': False, 'random_state': None, 'verbose': 0, 'warm_start': False}

Labels: None

Training accuracy: 0.9967096690122491
Training confusion matrix:
[[14779     0     0     5     0     0     0     0     0     0     0     0     0     0     0     0     3     0     0     0     0     0     0     0     0     0     0]
 [    0   237     0     0     0     0     0     0     0     0     0     0     0     0     0     0     0     0     0     0     0     0     0     0     0     0     0]
 [    0     0   284     0     0     0     0     0     0     0     0     0     0     0     0     0     0     0     0     0     0     0     0     0     0     0     0]
 [    0     0     0   194     0     0     0     0     0     0     0     0     0     0     0     0     0     0     0     0     0     0     0     0     0     0     0]
 [    0     0     0     0   197     0     0     0     0     0     0     0     0     0     0     0     0     0     0     0     0     0     0     0     0     0     0]
 [    0     0     0     0     0   153     0     0     0     0     0     0     0     1     0     0     0     0     0     1     0     0     0     0     0     0     0]
 [    0     0     0     0     0     0   120     0     0     0     0     0     0     0     0     0     0     0     0     0     0     0     0     0     0     0     0]
 [    0     0     0     0     0     0     0  1004     0     0     0     0     0     0     0     0     0     0     0     0     0     0     0     0     0     0     0]
 [    0     0     0     0     0     0     0     0   171     0     0     0     0     0     0     0     0     0     0     0     0     0     0     0     0     0     0]
 [    0     0     0     0     0     0     0     0     0  6802     0     0     0     0     0     0     0     0     0     0     0     0     0     0     0     0     0]
 [    0     0     0     0     0     0     0     0     0     0   211     0     0     0     0     0     0     0     0     0     0     0     0     0     0     0     0]
 [    0     0     0     0     0     0     0     0     0     0     0  1191     0     0     0     0     0     0     0     0     0     0     0     0     0     0     0]
 [    0     0     0     0     0     0     0     0     0     0     0     0    95     0     0     0     0     0     0    12     0     0     0     0     0     0     0]
 [    0     0     0     0     0     1     0     0     0     0     0     0     1    81     0     0     0     1     0     3     0     0     0     0     0     0     0]
 [    0     0     0     0     0     0     0     0     0     0     0     0     0     1   302     0     0     0     2     3     0     0     0     0     0     0     0]
 [    0     0     0     0     0     0     0     0     0     0     0     0     0     0     0    49     0     0     0     0     0     0     0     0     0     0     0]
 [    2     0     0     0     0     0     0     0     0     0     0     0     0     0     0     0   409     0     0     0     0     0     0     0     0     0     0]
 [    0     0     0     0     0     1     0     0     0     0     0     0     1     1     0     0     0   259     0    14     0     0     0     0     0     0     0]
 [    0     0     0     0     0     0     0     0     0     0     0     0     0     0     7     0     0     1   111     5     0     0     0     0     0     0     0]
 [    0     0     0     0     0     8     0     0     0     0     0     0     7     4     1     0     0    14     0   334     0     0     0     0     0     0     0]
 [    0     0     0     0     0     0     0     0     0     0     0     0     0     0     0     0     0     0     0     0   983     0     0     0     0     0     0]
 [    0     0     0     0     0     0     0     0     0     0     0     0     0     0     0     0     0     0     0     0     0   213     0     0     0     0     0]
 [    0     0     0     0     0     0     0     0     0     0     0     0     0     0     0     0     0     0     0     0     0     0  2108     0     0     0     0]
 [    1     0     0     0     0     0     0     0     0     0     0     0     0     0     0     0     0     0     0     0     0     0     0    34     0     0     0]
 [    0     0     0     0     0     0     0     0     0     0     0     0     0     0     0     0     0     0     0     0     0     0     0     0    29     0     0]
 [    0     0     0     0     0     0     0     0     0     0     0     0     0     0     0     0     0     0     0     0     0     0     0     0     0    62     0]
 [    0     0     0     0     0     0     0     0     0     0     0     0     0     0     0     0     0     0     0     0     0     0     0     0     0     0   183]]

Accuracy: 0.9702892885066459

Precision: [0.9814 1.0000 0.9726 0.9091 0.9138 0.5556 1.0000 0.9794 0.9804 0.9983 1.0000 1.0000 0.4815 0.6000 0.8795 1.0000 0.9700 0.6316 0.7241 0.6224 0.9772 0.9643 0.9926 0.8000 0.8750 1.0000 1.0000]
Mean: 0.8818079168793166
Std: 0.16033438937403383

Recall: [0.9924 0.9016 0.9342 0.8000 0.9636 0.6757 0.9677 0.9876 0.9434 0.9989 0.9138 0.9860 0.4643 0.4286 0.8111 0.7895 0.9510 0.6316 0.6176 0.6224 0.9698 0.9474 0.9981 0.8000 0.7778 1.0000 0.9796]
Mean: 0.8464346193210923
Std: 0.16663939849420403

F1 score: [0.9869 0.9483 0.9530 0.8511 0.9381 0.6098 0.9836 0.9835 0.9615 0.9986 0.9550 0.9930 0.4727 0.5000 0.8439 0.8824 0.9604 0.6316 0.6667 0.6224 0.9735 0.9558 0.9954 0.8000 0.8235 1.0000 0.9897]
Mean: 0.8622256125119405
Std: 0.16171095411964037

Cohen Kappa score: 0.9587302059793593
Confusion matrix:
[[3540    0    1    3    0    0    0    0    0    3    0    0    0    1    4    0    3    1    2    0    2    2    2    2    1    0    0]
 [   6   55    0    0    0    0    0    0    0    0    0    0    0    0    0    0    0    0    0    0    0    0    0    0    0    0    0]
 [   2    0   71    0    2    0    0    1    0    0    0    0    0    0    0    0    0    0    0    0    0    0    0    0    0    0    0]
 [  10    0    0   40    0    0    0    0    0    0    0    0    0    0    0    0    0    0    0    0    0    0    0    0    0    0    0]
 [   1    0    0    0   53    0    0    0    0    0    0    0    0    0    0    0    0    0    0    0    1    0    0    0    0    0    0]
 [   0    0    0    0    0   25    0    0    0    0    0    0    0    1    0    0    0    3    0    8    0    0    0    0    0    0    0]
 [   0    0    0    0    0    0   30    0    0    0    0    0    0    0    0    0    0    0    0    0    0    0    1    0    0    0    0]
 [   1    0    0    0    0    0    0  238    0    0    0    0    0    0    0    0    0    0    0    0    2    0    0    0    0    0    0]
 [   0    0    1    0    1    0    0    0   50    0    0    0    0    0    0    0    0    0    0    0    0    0    1    0    0    0    0]
 [   2    0    0    0    0    0    0    0    0 1748    0    0    0    0    0    0    0    0    0    0    0    0    0    0    0    0    0]
 [   5    0    0    0    0    0    0    0    0    0   53    0    0    0    0    0    0    0    0    0    0    0    0    0    0    0    0]
 [   4    0    0    0    0    0    0    0    0    0    0  282    0    0    0    0    0    0    0    0    0    0    0    0    0    0    0]
 [   0    0    0    0    0    2    0    0    0    0    0    0   13    1    1    0    0    5    0    6    0    0    0    0    0    0    0]
 [   0    0    0    0    0    4    0    0    0    0    0    0    1    9    0    0    0    3    1    3    0    0    0    0    0    0    0]
 [   7    0    0    0    0    0    0    0    0    0    0    0    0    0   73    0    0    1    5    4    0    0    0    0    0    0    0]
 [   1    0    0    0    2    0    0    1    0    0    0    0    0    0    0   15    0    0    0    0    0    0    0    0    0    0    0]
 [   4    0    0    0    0    0    0    1    0    0    0    0    0    0    0    0   97    0    0    0    0    0    0    0    0    0    0]
 [   3    0    0    0    0    3    0    0    0    0    0    0    4    1    1    0    0   48    0   16    0    0    0    0    0    0    0]
 [   4    0    0    0    0    1    0    0    0    0    0    0    2    0    3    0    0    3   21    0    0    0    0    0    0    0    0]
 [   5    0    0    0    0   10    0    0    0    0    0    0    7    2    1    0    0   12    0   61    0    0    0    0    0    0    0]
 [   7    0    0    0    0    0    0    1    0    0    0    0    0    0    0    0    0    0    0    0  257    0    0    0    0    0    0]
 [   1    0    0    0    0    0    0    1    0    0    0    0    0    0    0    0    0    0    0    0    1   54    0    0    0    0    0]
 [   0    0    0    0    0    0    0    0    1    0    0    0    0    0    0    0    0    0    0    0    0    0  537    0    0    0    0]
 [   2    0    0    0    0    0    0    0    0    0    0    0    0    0    0    0    0    0    0    0    0    0    0    8    0    0    0]
 [   1    0    0    1    0    0    0    0    0    0    0    0    0    0    0    0    0    0    0    0    0    0    0    0    7    0    0]
 [   0    0    0    0    0    0    0    0    0    0    0    0    0    0    0    0    0    0    0    0    0    0    0    0    0   13    0]
 [   1    0    0    0    0    0    0    0    0    0    0    0    0    0    0    0    0    0    0    0    0    0    0    0    0    0   48]]

