Classifier: GradientBoostingClassifier
Params: {'criterion': 'friedman_mse', 'init': None, 'learning_rate': 0.1, 'loss': 'deviance', 'max_depth': 3, 'max_features': None, 'max_leaf_nodes': None, 'min_impurity_decrease': 0.0, 'min_impurity_split': None, 'min_samples_leaf': 1, 'min_samples_split': 2, 'min_weight_fraction_leaf': 0.0, 'n_estimators': 100, 'presort': 'auto', 'random_state': None, 'subsample': 1.0, 'verbose': 0, 'warm_start': False}

Labels: None

Training accuracy: 0.9903862146967832
Training confusion matrix:
[[17404     0     0     7     0     0     0     0     0     1     0     0     0     0     0     0     4     0     0     0     0     0     1     0     0]
 [    2   246     0     0     0     0     0     0     0     0     0     0     0     0     0     0     0     0     0     0     0     0     0     0     0]
 [    0     0     1     0     0     0     0     0     0     0     0     0     0     0     0     0     0     0     0     0     0     0     0     0     0]
 [    1     0     0   243     0     0     0     0     0     0     0     0     0     0     0     0     0     0     0     0     0     0     0     0     0]
 [    0     0     0     0    21     0     0     0     0     0     0     0     0     0     0     0     0     0     0     0     0     0     0     0     0]
 [    0     0     0     0     0   157     0     0     0     0     0     0     8     3     0     0     0     0     2    22     0     0     0     0     0]
 [    0     0     0     0     0     0     4     0     0     0     0     0     0     0     0     0     0     0     0     0     0     0     0     0     0]
 [    0     0     0     0     0     0     0    10     0     0     0     0     0     0     0     0     0     0     0     0     0     0     0     0     0]
 [    0     0     0     0     0     0     0     0    13     0     0     0     0     0     0     0     0     0     0     0     0     0     0     0     0]
 [   13     0     0     0     0     0     0     0     0  8538     0     0     0     0     0     0     0     0     0     0     0     0     0     0     0]
 [    0     0     0     0     0     0     0     0     0     0   255     0     0     0     0     0     0     0     0     0     0     0     0     0     0]
 [    0     0     0     0     0     0     0     0     0     0     0  1477     0     0     0     0     0     0     0     0     0     0     0     0     0]
 [    0     0     0     0     0     2     0     0     0     0     0     0   111     1     0     0     0     8     0    13     0     0     0     0     0]
 [    0     0     0     0     0     2     0     0     0     0     0     0     2   101     0     0     0     0     0     3     0     0     0     0     0]
 [    1     0     0     0     0     7     0     0     0     0     0     0     2     1   273     0     0     0     9     6     0     0     0     0     0]
 [    0     0     0     0     0     0     0     0     0     0     0     0     0     0     0     4     0     0     0     0     0     0     0     0     0]
 [    3     0     0     0     0     0     0     0     0     0     0     0     0     0     0     0    88     0     0     0     0     0     0     0     0]
 [    0     0     0     0     0     6     0     0     0     0     0     0     7     6     0     0     0   246     2    27     0     0     0     0     0]
 [    0     0     0     0     0     5     0     0     0     0     0     0     2     2    11     0     0     2   106    10     0     0     0     0     0]
 [    0     0     0     0     0     6     0     0     0     0     0     0    27     8     2     0     0    42     0   352     0     0     0     0     0]
 [    0     0     0     0     0     0     0     0     0     0     0     0     0     0     0     0     0     0     0     0    11     0     0     0     0]
 [    0     0     0     0     0     0     0     0     0     0     0     0     0     0     0     0     0     0     0     0     0    27     0     0     0]
 [    0     0     0     0     0     0     0     0     0     0     0     0     0     0     0     0     0     0     0     0     0     0    45     0     0]
 [    0     0     0     0     0     0     0     0     0     0     0     0     0     0     0     0     0     0     0     0     0     0     0    38     0]
 [    0     0     0     0     0     0     0     0     0     0     0     0     0     0     0     0     0     0     0     0     0     0     0     0     1]]

Accuracy: 0.6962330003610543

Precision: [0.3951 1.0000 1.0000 0.9828 1.0000 0.5753 0.9899 0.0714 1.0000 0.9884 1.0000 1.0000 0.8679 0.7222 0.9286 0.5199 0.0000 0.9925 0.0000 1.0000]
Mean: 0.7516996910084162
Std: 0.3539985525196613

Recall: [0.8015 0.7400 0.1783 0.9913 0.9864 0.3927 0.9289 1.0000 1.0000 0.8586 0.9062 0.9739 0.7931 0.6500 0.8966 0.8456 0.0000 0.8064 0.0000 0.2857]
Mean: 0.7017636985318731
Std: 0.3282109597787542

F1 score: [0.5292 0.8506 0.3026 0.9871 0.9932 0.4668 0.9584 0.1333 1.0000 0.9189 0.9508 0.9868 0.8288 0.6842 0.9123 0.6439 0.0000 0.8898 0.0000 0.4444]
Mean: 0.6740608855466947
Std: 0.3343962227160648

Cohen Kappa score: 0.6372139880896315
Confusion matrix:
[[ 751    0    0    4    0  140    0    0    0    1    0    0    5    0    1   19    0   16    0    0]
 [  13   37    0    0    0    0    0    0    0    0    0    0    0    0    0    0    0    0    0    0]
 [ 194    0   64    0    0   96    0    0    0    0    0    0    0    0    0    5    0    0    0    0]
 [   2    0    0  229    0    0    0    0    0    0    0    0    0    0    0    0    0    0    0    0]
 [   2    0    0    0  145    0    0    0    0    0    0    0    0    0    0    0    0    0    0    0]
 [  35    0    0    0    0  485    0    0    0    0    0    0    0    0    0  715    0    0    0    0]
 [  15    0    0    0    0    0  196    0    0    0    0    0    0    0    0    0    0    0    0    0]
 [   0    0    0    0    0    0    0    1    0    0    0    0    0    0    0    0    0    0    0    0]
 [   0    0    0    0    0    0    0    0   14    0    0    0    0    0    0    0    0    0    0    0]
 [  12    0    0    0    0    0    0    0    0   85    0    0    1    1    0    0    0    0    0    0]
 [   6    0    0    0    0    0    0    0    0    0   58    0    0    0    0    0    0    0    0    0]
 [  10    0    0    0    0    0    0    0    0    0    0  411    0    0    0    1    0    0    0    0]
 [   7    0    0    0    0    0    0    0    0    0    0    0   46    4    1    0    0    0    0    0]
 [   6    0    0    0    0    0    0    0    0    0    0    0    1   13    0    0    0    0    0    0]
 [   3    0    0    0    0    0    0    0    0    0    0    0    0    0   26    0    0    0    0    0]
 [ 121    0    0    0    0   70    0    0    0    0    0    0    0    0    0 1046    0    0    0    0]
 [  34    0    0    0    0   12    0    0    0    0    0    0    0    0    0  224    0    0    0    0]
 [ 492    0    0    0    0    0    2   13    0    0    0    0    0    0    0    0    0 2112    0    0]
 [  74    0    0    0    0    0    0    0    0    0    0    0    0    0    0    1    0    0    0    0]
 [ 124    0    0    0    0   40    0    0    0    0    0    0    0    0    0    1    0    0    0   66]]

