Classifier: LinearSVC
Params: {'C': 1.0, 'class_weight': None, 'dual': True, 'fit_intercept': True, 'intercept_scaling': 1, 'loss': 'squared_hinge', 'max_iter': 1000, 'multi_class': 'ovr', 'penalty': 'l2', 'random_state': None, 'tol': 0.0001, 'verbose': 0}

Labels: None

Training accuracy: 0.9872259738531652
Training confusion matrix:
[[17404     0     0     6     0     0     0     0     0     0     0     0     0     0     0     0     6     0     0     0     0     0     0     1     0]
 [    0   248     0     0     0     0     0     0     0     0     0     0     0     0     0     0     0     0     0     0     0     0     0     0     0]
 [    0     0     1     0     0     0     0     0     0     0     0     0     0     0     0     0     0     0     0     0     0     0     0     0     0]
 [    0     0     0   244     0     0     0     0     0     0     0     0     0     0     0     0     0     0     0     0     0     0     0     0     0]
 [    0     0     0     0    21     0     0     0     0     0     0     0     0     0     0     0     0     0     0     0     0     0     0     0     0]
 [    0     0     0     0     0   133     0     0     0     0     0     0    10     3     1     0     0     3     4    38     0     0     0     0     0]
 [    0     0     0     0     0     0     4     0     0     0     0     0     0     0     0     0     0     0     0     0     0     0     0     0     0]
 [    0     0     0     0     0     0     0    10     0     0     0     0     0     0     0     0     0     0     0     0     0     0     0     0     0]
 [    0     0     0     0     0     0     0     0    13     0     0     0     0     0     0     0     0     0     0     0     0     0     0     0     0]
 [    0     0     0     0     0     0     0     0     0  8551     0     0     0     0     0     0     0     0     0     0     0     0     0     0     0]
 [    0     0     0     0     0     0     0     0     0     0   255     0     0     0     0     0     0     0     0     0     0     0     0     0     0]
 [    0     0     0     0     0     0     0     0     0     0     0  1477     0     0     0     0     0     0     0     0     0     0     0     0     0]
 [    0     0     0     0     0     3     0     0     0     0     0     0   111     7     0     0     0     5     0     9     0     0     0     0     0]
 [    0     0     0     0     0     6     0     0     0     0     0     0     3    91     1     0     0     3     0     4     0     0     0     0     0]
 [    0     0     0     0     0     5     0     0     0     0     0     0     2     2   277     0     0     0     7     6     0     0     0     0     0]
 [    0     0     0     0     0     0     0     0     0     0     0     0     0     0     0     4     0     0     0     0     0     0     0     0     0]
 [    3     0     0     0     0     0     0     0     0     0     0     0     0     0     0     0    88     0     0     0     0     0     0     0     0]
 [    0     0     0     0     0    14     0     0     0     0     0     0    16    11     1     0     0   218     1    33     0     0     0     0     0]
 [    0     0     0     0     0     3     0     0     0     0     0     0     3     2    14     0     0     3   102    11     0     0     0     0     0]
 [    0     0     0     0     0    15     0     0     0     0     0     0    37    16     5     0     0    58     2   304     0     0     0     0     0]
 [    0     0     0     0     0     0     0     0     0     0     0     0     0     0     0     0     0     0     0     0    11     0     0     0     0]
 [    0     0     0     0     0     0     0     0     0     0     0     0     0     0     0     0     0     0     0     0     0    27     0     0     0]
 [    1     0     0     0     0     0     0     0     0     0     0     0     0     0     0     0     0     0     0     0     0     0    44     0     0]
 [    0     0     0     0     0     0     0     0     0     0     0     0     0     0     0     0     0     0     0     0     0     0     0    38     0]
 [    0     0     0     0     0     0     0     0     0     0     0     0     0     0     0     0     0     0     0     0     0     0     0     0     1]]

Accuracy: 0.8318690576483332

Precision: [0.6291 0.9000 0.9803 0.0000 0.7679 1.0000 0.8991 0.8118 0.0833 0.1333 0.5276 0.7079 0.9813 0.8800 0.7059 0.7500 0.7770 0.0000 0.9932 0.0000 1.0000]
Mean: 0.6441722534293659
Std: 0.3587009891483281

Recall: [0.9050 0.5400 0.5543 0.0000 0.9740 0.9932 0.7717 0.9810 1.0000 1.0000 0.8687 0.9844 0.9953 0.7586 0.6000 0.8276 0.8844 0.0000 0.9458 0.0000 0.3117]
Mean: 0.7093169377405085
Std: 0.3418173850968187

F1 score: [0.7422 0.6750 0.7082 0.0000 0.8588 0.9966 0.8305 0.8884 0.1538 0.2353 0.6565 0.8235 0.9882 0.8148 0.6486 0.7869 0.8272 0.0000 0.9689 0.0000 0.4752]
Mean: 0.6228004520930445
Std: 0.3302141074511143

Cohen Kappa score: 0.7990074762217224
Confusion matrix:
[[ 848    0    4   12    7    0   14    0    0    0    1    0    6    5    0    2   21    0   17    0    0]
 [   4   27    0   19    0    0    0    0    0    0    0    0    0    0    0    0    0    0    0    0    0]
 [  40    2  199   16    8    0   60    0    0    0   18    0    0    0    0    4   12    0    0    0    0]
 [   0    0    0    0    0    0    0    0    0    0    0    0    0    0    0    0    0    0    0    0    0]
 [   6    0    0    0  225    0    0    0    0    0    0    0    0    0    0    0    0    0    0    0    0]
 [   0    0    0    1    0  146    0    0    0    0    0    0    0    0    0    0    0    0    0    0    0]
 [ 162    0    0   13    0    0  953    0    0    3   55    0    0    0    0    0   49    0    0    0    0]
 [   4    0    0    0    0    0    0  207    0    0    0    0    0    0    0    0    0    0    0    0    0]
 [   0    0    0    0    0    0    0    0    1    0    0    0    0    0    0    0    0    0    0    0    0]
 [   0    0    0    0    0    0    0    0    0   14    0    0    0    0    0    0    0    0    0    0    0]
 [   8    0    0    2    0    0    1    0    1    0   86    0    0    1    0    0    0    0    0    0    0]
 [   1    0    0    0    0    0    0    0    0    0    0   63    0    0    0    0    0    0    0    0    0]
 [   0    0    0    0    0    0    0    1    0    0    0    0  420    0    0    0    1    0    0    0    0]
 [   8    0    0    0    0    0    0    0    0    0    0    0    0   44    5    1    0    0    0    0    0]
 [   3    1    0    3    0    0    0    0    0    0    0    0    0    0   12    1    0    0    0    0    0]
 [   2    0    0    1    0    0    0    0    2    0    0    0    0    0    0   24    0    0    0    0    0]
 [ 129    0    0    5    0    0    3    0    2    0    0    4    0    0    0    0 1094    0    0    0    0]
 [  25    0    0    5    6    0    4    0    4    0    0    9    1    0    0    0  216    0    0    0    0]
 [  28    0    0   23    0    0    0    1    0   88    0    1    1    0    0    0    0    0 2477    0    0]
 [  15    0    0    3   27    0    9    0    0    0    0   10    0    0    0    0   11    0    0    0    0]
 [  65    0    0    1   20    0   16   46    2    0    3    2    0    0    0    0    4    0    0    0   72]]

