Classifier: LogisticRegression
Params: {'C': 1.0, 'class_weight': None, 'dual': False, 'fit_intercept': True, 'intercept_scaling': 1, 'max_iter': 100, 'multi_class': 'ovr', 'n_jobs': 1, 'penalty': 'l2', 'random_state': None, 'solver': 'liblinear', 'tol': 0.0001, 'verbose': 0, 'warm_start': False}

Labels: None

Training accuracy: 0.985496157812448
Training confusion matrix:
[[17398     2     0     6     0     0     0     0     0     1     1     0     0     0     0     0     6     0     0     0     0     0     1     2     0]
 [    1   247     0     0     0     0     0     0     0     0     0     0     0     0     0     0     0     0     0     0     0     0     0     0     0]
 [    0     0     1     0     0     0     0     0     0     0     0     0     0     0     0     0     0     0     0     0     0     0     0     0     0]
 [    8     0     0   236     0     0     0     0     0     0     0     0     0     0     0     0     0     0     0     0     0     0     0     0     0]
 [    0     0     0     0    21     0     0     0     0     0     0     0     0     0     0     0     0     0     0     0     0     0     0     0     0]
 [    0     0     0     0     0   131     0     0     0     0     0     0    10     2     4     0     0     3     4    38     0     0     0     0     0]
 [    2     0     0     0     0     0     2     0     0     0     0     0     0     0     0     0     0     0     0     0     0     0     0     0     0]
 [    0     0     0     0     0     0     0    10     0     0     0     0     0     0     0     0     0     0     0     0     0     0     0     0     0]
 [    0     0     0     0     0     0     0     0    13     0     0     0     0     0     0     0     0     0     0     0     0     0     0     0     0]
 [    5     0     0     0     0     0     0     0     0  8546     0     0     0     0     0     0     0     0     0     0     0     0     0     0     0]
 [    4     0     0     0     0     0     0     0     0     0   251     0     0     0     0     0     0     0     0     0     0     0     0     0     0]
 [    0     0     0     0     0     0     0     0     0     0     0  1477     0     0     0     0     0     0     0     0     0     0     0     0     0]
 [    0     0     0     0     0     3     0     0     0     0     0     0    97     8     0     0     0     4     0    23     0     0     0     0     0]
 [    0     0     0     0     0     7     0     0     0     0     0     0     3    87     1     0     0     3     2     5     0     0     0     0     0]
 [    1     0     0     0     0     3     0     0     0     0     0     0     2     2   277     0     0     0     8     6     0     0     0     0     0]
 [    0     0     0     0     0     0     0     0     0     0     0     0     0     0     0     4     0     0     0     0     0     0     0     0     0]
 [    3     0     0     0     0     0     0     0     0     0     0     0     0     0     0     0    87     0     0     0     0     0     0     1     0]
 [    0     0     0     0     0    12     0     0     0     0     0     0    18    10     0     0     0   205     3    46     0     0     0     0     0]
 [    0     0     0     0     0     3     0     0     0     0     0     0     3     1    17     0     0     2    97    15     0     0     0     0     0]
 [    1     0     0     0     0    17     0     0     0     0     0     0    25    14     6     0     0    51     3   320     0     0     0     0     0]
 [    0     0     0     0     0     0     0     0     0     0     0     0     0     0     0     0     0     0     0     0    11     0     0     0     0]
 [    0     0     0     0     0     0     0     0     0     0     0     0     0     0     0     0     0     0     0     0     0    27     0     0     0]
 [    1     0     0     0     0     0     0     0     0     1     0     0     0     0     0     0     0     0     0     0     0     0    43     0     0]
 [    1     0     0     1     0     0     0     0     0     0     0     0     0     0     0     0     0     0     0     0     0     0     0    36     0]
 [    0     0     0     0     0     0     0     0     0     0     0     0     0     0     0     0     0     0     0     0     0     0     0     0     1]]

Accuracy: 0.6987603803105067

Precision: [0.5223 0.7586 1.0000 0.0000 0.5475 1.0000 0.7504 0.8423 0.0000 0.1818 0.3982 0.8507 0.9904 0.9750 0.7391 0.7333 0.7741 0.0000 0.9948 0.0000 1.0000]
Mean: 0.6218440751391495
Std: 0.36645569886356644

Recall: [0.9370 0.4400 0.0808 0.0000 0.9481 0.9184 0.3773 0.9621 0.0000 1.0000 0.9091 0.8906 0.9763 0.6724 0.8500 0.7586 0.8367 0.0000 0.8045 0.0000 0.2641]
Mean: 0.6012369416402785
Std: 0.38029708913606114

F1 score: [0.6707 0.5570 0.1495 0.0000 0.6941 0.9574 0.5022 0.8982 0.0000 0.3077 0.5538 0.8702 0.9833 0.7959 0.7907 0.7458 0.8042 0.0000 0.8896 0.0000 0.4178]
Mean: 0.5518186817857218
Std: 0.33795440731497756

Cohen Kappa score: 0.6481009329423115
Confusion matrix:
[[ 878    0    0   16   15    0    5    0    0    0    2    2    1    0    0    0   11    0    7    0    0]
 [  14   22    0   13    0    0    0    0    0    0    0    0    1    0    0    0    0    0    0    0    0]
 [  77    7   29    3   87    0  109    0    0    0   24    0    1    0    0    3   17    0    2    0    0]
 [   0    0    0    0    0    0    0    0    0    0    0    0    0    0    0    0    0    0    0    0    0]
 [  11    0    0    0  219    0    0    0    0    0    0    0    0    0    0    0    1    0    0    0    0]
 [   4    0    0    3    0  135    4    0    0    0    0    0    0    0    0    0    0    0    1    0    0]
 [ 329    0    0  248    0    0  466    0    0    3  104    0    0    0    0    4   81    0    0    0    0]
 [   8    0    0    0    0    0    0  203    0    0    0    0    0    0    0    0    0    0    0    0    0]
 [   1    0    0    0    0    0    0    0    0    0    0    0    0    0    0    0    0    0    0    0    0]
 [   0    0    0    0    0    0    0    0    0   14    0    0    0    0    0    0    0    0    0    0    0]
 [   7    0    0    0    0    0    0    0    0    0   90    0    0    1    1    0    0    0    0    0    0]
 [   1    0    0    0    2    0    4    0    0    0    0   57    0    0    0    0    0    0    0    0    0]
 [  10    0    0    0    0    0    0    0    0    0    0    0  412    0    0    0    0    0    0    0    0]
 [   9    0    0    0    0    0    0    0    1    0    3    0    0   39    5    1    0    0    0    0    0]
 [   2    0    0    1    0    0    0    0    0    0    0    0    0    0   17    0    0    0    0    0    0]
 [   4    0    0    0    0    0    0    0    0    0    3    0    0    0    0   22    0    0    0    0    0]
 [ 165    0    0   18   16    0    0    0    0    0    0    3    0    0    0    0 1035    0    0    0    0]
 [  30    0    0   44    8    0    3    0    1    0    0    2    1    0    0    0  181    0    0    0    0]
 [  34    0    0  417    0    0    0    1    0   60    0    0    0    0    0    0    0    0 2107    0    0]
 [  20    0    0   10   27    0   10    0    0    0    0    0    0    0    0    0    8    0    0    0    0]
 [  77    0    0    3   26    0   20   37    0    0    0    3    0    0    0    0    3    0    1    0   61]]

