Classifier: MLPClassifier
Params: {'activation': 'relu', 'alpha': 0.0001, 'batch_size': 'auto', 'beta_1': 0.9, 'beta_2': 0.999, 'early_stopping': False, 'epsilon': 1e-08, 'hidden_layer_sizes': (100,), 'learning_rate': 'constant', 'learning_rate_init': 0.001, 'max_iter': 200, 'momentum': 0.9, 'nesterovs_momentum': True, 'power_t': 0.5, 'random_state': None, 'shuffle': True, 'solver': 'adam', 'tol': 0.0001, 'validation_fraction': 0.1, 'verbose': False, 'warm_start': False}

Labels: None

Training accuracy: 0.9878912877149796
Training confusion matrix:
[[17410     0     0     0     0     0     0     0     0     0     0     0     0     0     0     0     7     0     0     0     0     0     0     0     0]
 [    0   248     0     0     0     0     0     0     0     0     0     0     0     0     0     0     0     0     0     0     0     0     0     0     0]
 [    0     0     1     0     0     0     0     0     0     0     0     0     0     0     0     0     0     0     0     0     0     0     0     0     0]
 [    8     0     0   236     0     0     0     0     0     0     0     0     0     0     0     0     0     0     0     0     0     0     0     0     0]
 [    0     0     0     0    21     0     0     0     0     0     0     0     0     0     0     0     0     0     0     0     0     0     0     0     0]
 [    0     0     0     0     0   143     0     0     0     0     0     0    10     9     1     0     0    10     7    12     0     0     0     0     0]
 [    0     0     0     0     0     0     4     0     0     0     0     0     0     0     0     0     0     0     0     0     0     0     0     0     0]
 [    0     0     0     0     0     0     0    10     0     0     0     0     0     0     0     0     0     0     0     0     0     0     0     0     0]
 [    0     0     0     0     0     0     0     0    13     0     0     0     0     0     0     0     0     0     0     0     0     0     0     0     0]
 [    0     0     0     0     0     0     0     0     0  8551     0     0     0     0     0     0     0     0     0     0     0     0     0     0     0]
 [    0     0     0     0     0     0     0     0     0     0   255     0     0     0     0     0     0     0     0     0     0     0     0     0     0]
 [    0     0     0     0     0     0     0     0     0     0     0  1477     0     0     0     0     0     0     0     0     0     0     0     0     0]
 [    0     0     0     0     0     0     0     0     0     0     0     0   118     8     0     0     0     8     0     1     0     0     0     0     0]
 [    0     0     0     0     0     2     0     0     0     0     0     0     0   103     0     0     0     2     0     1     0     0     0     0     0]
 [    0     0     0     0     0     6     0     0     0     0     0     0     2     2   265     0     0     0    17     7     0     0     0     0     0]
 [    0     0     0     0     0     0     0     0     0     0     0     0     0     0     0     4     0     0     0     0     0     0     0     0     0]
 [    1     0     0     0     0     0     0     0     0     0     0     0     0     0     0     0    90     0     0     0     0     0     0     0     0]
 [    0     0     0     0     0     7     0     0     0     0     0     0    11    10     0     0     0   254     1    11     0     0     0     0     0]
 [    0     0     0     0     0     1     0     0     0     0     0     0     1     2     5     0     0     4   118     7     0     0     0     0     0]
 [    0     0     0     0     0    29     0     0     0     0     0     0    38    17     2     0     0    91     5   255     0     0     0     0     0]
 [    0     0     0     0     0     0     0     0     0     0     0     0     0     0     0     0     0     0     0     0    11     0     0     0     0]
 [    0     0     0     0     0     0     0     0     0     0     0     0     0     0     0     0     0     0     0     0     0    27     0     0     0]
 [    1     0     0     0     0     0     0     0     0     0     0     0     0     0     0     0     0     0     0     0     0     0    44     0     0]
 [    0     0     0     0     0     0     0     0     0     0     0     0     0     0     0     0     0     0     0     0     0     0     0    38     0]
 [    0     0     0     0     0     0     0     0     0     0     0     0     0     0     0     0     0     0     0     0     0     0     0     0     1]]

Accuracy: 0.8019015525333976

Precision: [0.4894 0.9250 0.9708 0.0000 0.7935 1.0000 0.8248 0.8462 0.0370 0.2090 0.8812 0.9130 0.9586 0.5056 0.7143 0.6429 0.8281 0.0000 0.9934 0.0000 1.0000]
Mean: 0.6444089103805816
Std: 0.363091668132633

Recall: [0.9328 0.7400 0.4624 0.0000 0.9481 0.9864 0.5449 0.9905 1.0000 1.0000 0.8990 0.9844 0.9882 0.7759 0.7500 0.9310 0.8529 0.0000 0.9729 0.0000 0.2857]
Mean: 0.7164264021896688
Std: 0.3479988541579902

F1 score: [0.6419 0.8222 0.6264 0.0000 0.8639 0.9932 0.6563 0.9127 0.0714 0.3457 0.8900 0.9474 0.9732 0.6122 0.7317 0.7606 0.8403 0.0000 0.9830 0.0000 0.4444]
Mean: 0.6245946168854095
Std: 0.33836331376023804

Cohen Kappa score: 0.7627358801441834
Confusion matrix:
[[ 874    0    5   14    7    0    8    0    0    0    1    0    4    0    1    0   14    0    9    0    0]
 [  13   37    0    0    0    0    0    0    0    0    0    0    0    0    0    0    0    0    0    0    0]
 [  82    1  166    3   17    0   55    0    5    0    0    0    1   24    0    0    2    0    3    0    0]
 [   0    0    0    0    0    0    0    0    0    0    0    0    0    0    0    0    0    0    0    0    0]
 [  11    0    0    0  219    0    0    0    0    0    0    0    0    0    0    0    1    0    0    0    0]
 [   1    0    0    0    0  145    0    0    0    0    0    0    0    0    0    0    0    0    1    0    0]
 [ 508    0    0   10    0    0  673    0    0    3    9    0    3    3    0    1   25    0    0    0    0]
 [   1    0    0    0    0    0    0  209    0    0    0    0    0    0    0    0    0    0    1    0    0]
 [   0    0    0    0    0    0    0    0    1    0    0    0    0    0    0    0    0    0    0    0    0]
 [   0    0    0    0    0    0    0    0    0   14    0    0    0    0    0    0    0    0    0    0    0]
 [   3    0    0    0    0    0    0    0    0    0   89    0    0    4    1    2    0    0    0    0    0]
 [   1    0    0    0    0    0    0    0    0    0    0   63    0    0    0    0    0    0    0    0    0]
 [   5    0    0    0    0    0    0    0    0    0    0    0  417    0    0    0    0    0    0    0    0]
 [   6    0    0    0    0    0    0    0    0    0    1    0    0   45    4    2    0    0    0    0    0]
 [   1    0    0    1    0    0    0    0    0    0    0    0    0    0   15    3    0    0    0    0    0]
 [   1    0    0    0    0    0    0    0    0    0    1    0    0    0    0   27    0    0    0    0    0]
 [ 136    1    0   11    0    0   13    0    3    0    0    2    3    9    0    4 1055    0    0    0    0]
 [  30    1    0   31    8    0    7    0   10    0    0    2    4    1    0    3  172    0    1    0    0]
 [  18    0    0    0    0    0    0    2    0   50    0    0    1    0    0    0    0    0 2548    0    0]
 [  21    0    0    1   23    0   15    0    5    0    0    2    1    2    0    0    4    0    1    0    0]
 [  74    0    0    1    2    0   45   36    3    0    0    0    1    1    0    0    1    0    1    0   66]]

