Classifier: MultinomialNB
Params: {'alpha': 1.0, 'class_prior': None, 'fit_prior': True}

Labels: None

Training accuracy: 0.909949768803433
Training confusion matrix:
[[16499    90     0   100     0     0     0     0     0    42   257     7     0     0   108     0   139    16     0   149     0     0     7     3     0]
 [    5   243     0     0     0     0     0     0     0     0     0     0     0     0     0     0     0     0     0     0     0     0     0     0     0]
 [    0     1     0     0     0     0     0     0     0     0     0     0     0     0     0     0     0     0     0     0     0     0     0     0     0]
 [   51     0     0   182     0     0     0     0     0     0     0     0     0     0     0     0    11     0     0     0     0     0     0     0     0]
 [    0     0     0    10    11     0     0     0     0     0     0     0     0     0     0     0     0     0     0     0     0     0     0     0     0]
 [    1     0     0     0     0     3     0     0     0     0     0     0     0     0     2     0     0     0     0   186     0     0     0     0     0]
 [    2     1     0     1     0     0     0     0     0     0     0     0     0     0     0     0     0     0     0     0     0     0     0     0     0]
 [    0     1     0     6     3     0     0     0     0     0     0     0     0     0     0     0     0     0     0     0     0     0     0     0     0]
 [    0     0     0     0     0     0     0     0    13     0     0     0     0     0     0     0     0     0     0     0     0     0     0     0     0]
 [  573     0     0    12     0     0     0     0     0  7959     2     2     0     0     2     0     1     0     0     0     0     0     0     0     0]
 [   23     0     0     0     0     0     0     0     0     0   232     0     0     0     0     0     0     0     0     0     0     0     0     0     0]
 [   36     0     0     0     0     0     0     0     0     2     0  1439     0     0     0     0     0     0     0     0     0     0     0     0     0]
 [    0     0     0     0     0     0     0     0     0     0     0     0     0     0     0     0     0     0     0   135     0     0     0     0     0]
 [    0     0     0     0     0     0     0     0     0     0     0     0     0     0     1     0     0     0     0   107     0     0     0     0     0]
 [    2     0     0     4     0     0     0     0     0     0     0     0     0     0   189     0     0     0     0   104     0     0     0     0     0]
 [    0     0     0     4     0     0     0     0     0     0     0     0     0     0     0     0     0     0     0     0     0     0     0     0     0]
 [   26     0     0     6     0     0     0     0     0     0     0     0     0     0     0     0    59     0     0     0     0     0     0     0     0]
 [    5     0     0     0     0     0     0     0     0     0     0     0     0     0     4     0     0    15     0   270     0     0     0     0     0]
 [    0     0     0     0     0     0     0     0     0     0     0     0     0     0    32     0     0     0     0   106     0     0     0     0     0]
 [    1     0     0     0     0     0     0     0     0     0     4     0     0     0     0     0     0     1     0   431     0     0     0     0     0]
 [    0     0     0     0     0     0     0     0     0     0     0     0     0     0     0     0     0     0     0     0    11     0     0     0     0]
 [    0     5     0     4     1     0     0     0     0     0     0     0     0     0     0     0     0     0     0     0     0    17     0     0     0]
 [    7    21     0     0     0     0     0     0     0     0     0     0     0     0     0     0     0     0     0     0     0     0    17     0     0]
 [    4     0     0     0     0     0     0     0     0     0     0     0     0     0     0     0     0     0     0     0     0     0     0    34     0]
 [    0     0     0     1     0     0     0     0     0     0     0     0     0     0     0     0     0     0     0     0     0     0     0     0     0]]

Accuracy: 0.17342640510290047

Precision: [0.7533 0.0509 0.0000 0.0000 0.6395 0.0000 0.0000 1.0000 0.9825 0.0000 0.0435 0.0000 0.0000 0.3571 0.0000 0.3846 0.1875 1.0000 0.2653 0.8219 0.0000 0.9831 0.0000 0.0000 0.0000]
Mean: 0.2987682259693984
Std: 0.38665448150641024

Recall: [0.5475 0.7200 0.0000 0.0000 0.2381 0.0000 0.0000 0.0130 0.5308 0.0000 1.0000 0.0000 0.0000 0.3535 0.0000 0.0237 0.2586 0.0500 0.4483 0.4551 0.0000 0.0221 0.0000 0.0000 0.0000]
Mean: 0.18643024875062572
Std: 0.2750545353903202

F1 score: [0.6341 0.0951 0.0000 0.0000 0.3470 0.0000 0.0000 0.0256 0.6892 0.0000 0.0833 0.0000 0.0000 0.3553 0.0000 0.0446 0.2174 0.0952 0.3333 0.5858 0.0000 0.0433 0.0000 0.0000 0.0000]
Mean: 0.14197899173171494
Std: 0.21457258142754557

Cohen Kappa score: 0.15167430574679575
Confusion matrix:
[[ 513   20    0  213    0    3    0    0    0    0   90    0    2   17    0    3   48    0   20    3    0    1    4    0    0]
 [  14   36    0    0    0    0    0    0    0    0    0    0    0    0    0    0    0    0    0    0    0    0    0    0    0]
 [   4  142    0  167    6    0    0    0    0    0   37    1    0    0    0    0    0    0    1    1    0    0    0    0    0]
 [   0    0    0    0    0    0    0    0    0    0    0    0    0    0    0    0    0    0    0    0    0    0    0    0    0]
 [   0   62    0  112   55    0    0    0    0    0    1    0    0    0    0    0    0    0    0    1    0    0    0    0    0]
 [   0    0    0    0    0    0    0    0    0    0    0    0    0    0    0    0    0    0    0    0    0    0    0    0    0]
 [   1   31    0  113    2    0    0    0    0    0    0    0    0    0    0    0    0    0    0    0    0    0    0    0    0]
 [  35  230    0  835    8    0    0   16    0    0   53    0    0   32    0   12    0    0    0   14    0    0    0    0    0]
 [   1   40    0   56    2    0    0    0  112    0    0    0    0    0    0    0    0    0    0    0    0    0    0    0    0]
 [   0    0    0    0    0    0    0    0    0    0    0    0    0    0    0    1    0    0    0    0    0    0    0    0    0]
 [   0    0    0    0    0    0    0    0    0    0   14    0    0    0    0    0    0    0    0    0    0    0    0    0    0]
 [   0    0    0    0    0    0    0    0    0    0    0    0    0    0    0    0    0    0    0    0    0    0    0    0    0]
 [   0    0    0    0    0    0    0    0    0    0    0    0    0    0    0    0    0    0    0    0    0    0    0    0    0]
 [  17    0    0   41    0    0    0    0    0    0    0    0    0   35    0    0    5    0    1    0    0    0    0    0    0]
 [   0   29    0   33    1    0    0    0    0    0    1    0    0    0    0    0    0    0    0    0    0    0    0    0    0]
 [   0   11    0  399    2    0    0    0    0    0    0    0    0    0    0   10    0    0    0    0    0    0    0    0    0]
 [  24    1    0    1    0    0    0    0    0    0    0    0    0    7    0    0   15    0   10    0    0    0    0    0    0]
 [   4    0    0    1    0    0    0    0    0    0    0    0    0    1    0    0    9    1    4    0    0    0    0    0    0]
 [   3    0    0    7    0    0    0    0    0    0    1    0    0    2    0    0    3    0   13    0    0    0    0    0    0]
 [  17   65    0  486    0    0    0    0    1    0   99    3    0    3    0    0    0    0    0  563    0    0    0    0    0]
 [  17   15    0  131    1    0    0    0    0    0    4    0    0    0    0    0    0    0    0  102    0    0    0    0    0]
 [  27   22    0 2505    4    0    0    0    1    0    1    0    0    1    0    0    0    0    0    0    0   58    0    0    0]
 [   0    0    0    0    0    0    0    0    0    0    0    0    0    0    0    0    0    0    0    0    0    0    0    0    0]
 [   2    0    0   70    3    0    0    0    0    0    0    0    0    0    0    0    0    0    0    0    0    0    0    0    0]
 [   2    3    0  202    2    0    0    0    0    0   21    0    0    0    0    0    0    0    0    1    0    0    0    0    0]]

