Classifier: RandomForestClassifier
Params: {'bootstrap': True, 'class_weight': None, 'criterion': 'gini', 'max_depth': None, 'max_features': 'auto', 'max_leaf_nodes': None, 'min_impurity_decrease': 0.0, 'min_impurity_split': None, 'min_samples_leaf': 1, 'min_samples_split': 2, 'min_weight_fraction_leaf': 0.0, 'n_estimators': 100, 'n_jobs': 1, 'oob_score': False, 'random_state': None, 'verbose': 0, 'warm_start': False}

Labels: None

Training accuracy: 0.9933135956887662
Training confusion matrix:
[[17409     0     0     6     0     0     0     0     0     0     0     0     0     0     0     0     2     0     0     0     0     0     0     0     0]
 [    0   248     0     0     0     0     0     0     0     0     0     0     0     0     0     0     0     0     0     0     0     0     0     0     0]
 [    0     0     1     0     0     0     0     0     0     0     0     0     0     0     0     0     0     0     0     0     0     0     0     0     0]
 [    0     0     0   244     0     0     0     0     0     0     0     0     0     0     0     0     0     0     0     0     0     0     0     0     0]
 [    0     0     0     0    21     0     0     0     0     0     0     0     0     0     0     0     0     0     0     0     0     0     0     0     0]
 [    0     0     0     0     0   175     0     0     0     0     0     0     0     2     1     0     0     2     0    12     0     0     0     0     0]
 [    0     0     0     0     0     0     4     0     0     0     0     0     0     0     0     0     0     0     0     0     0     0     0     0     0]
 [    0     0     0     0     0     0     0    10     0     0     0     0     0     0     0     0     0     0     0     0     0     0     0     0     0]
 [    0     0     0     0     0     0     0     0    13     0     0     0     0     0     0     0     0     0     0     0     0     0     0     0     0]
 [    0     0     0     0     0     0     0     0     0  8551     0     0     0     0     0     0     0     0     0     0     0     0     0     0     0]
 [    0     0     0     0     0     0     0     0     0     0   255     0     0     0     0     0     0     0     0     0     0     0     0     0     0]
 [    0     0     0     0     0     0     0     0     0     0     0  1477     0     0     0     0     0     0     0     0     0     0     0     0     0]
 [    0     0     0     0     0     1     0     0     0     0     0     0   115     1     0     0     0     6     0    12     0     0     0     0     0]
 [    0     0     0     0     0     2     0     0     0     0     0     0     1   100     1     0     0     2     1     1     0     0     0     0     0]
 [    0     0     0     0     0     2     0     0     0     0     0     0     0     0   287     0     0     0     5     5     0     0     0     0     0]
 [    0     0     0     0     0     0     0     0     0     0     0     0     0     0     0     4     0     0     0     0     0     0     0     0     0]
 [    5     0     0     0     0     0     0     0     0     0     0     0     0     0     0     0    86     0     0     0     0     0     0     0     0]
 [    0     0     0     0     0     2     0     0     0     0     0     0     4     4     0     0     0   263     0    21     0     0     0     0     0]
 [    0     0     0     0     0     2     0     0     0     0     0     0     0     1    12     0     0     3   114     6     0     0     0     0     0]
 [    0     0     0     0     0     9     0     0     0     0     0     0    16     7     1     0     0    40     2   362     0     0     0     0     0]
 [    0     0     0     0     0     0     0     0     0     0     0     0     0     0     0     0     0     0     0     0    11     0     0     0     0]
 [    0     0     0     0     0     0     0     0     0     0     0     0     0     0     0     0     0     0     0     0     0    27     0     0     0]
 [    1     0     0     0     0     0     0     0     0     0     0     0     0     0     0     0     0     0     0     0     0     0    44     0     0]
 [    0     0     0     0     0     0     0     0     0     0     0     0     0     0     0     0     0     0     0     0     0     0     0    38     0]
 [    0     0     0     0     0     0     0     0     0     0     0     0     0     0     0     0     0     0     0     0     0     0     0     0     1]]

Accuracy: 0.35046335299073295

Precision: [0.3219 0.7500 1.0000 0.0000 0.4798 0.9082 0.5053 0.7965 0.2000 1.0000 0.9855 0.1327 0.9951 1.0000 0.5000 0.9474 0.7733 0.0000 0.9841 0.0000 1.0000]
Mean: 0.6323731988450393
Std: 0.3745574262415047

Recall: [0.9648 0.3000 0.1616 0.0000 0.5152 0.6054 0.1166 0.8531 1.0000 0.9286 0.6869 0.4375 0.4834 0.4138 0.2000 0.6207 0.5489 0.0000 0.1184 0.0000 0.2338]
Mean: 0.43754716308498537
Std: 0.31813107727671897

F1 score: [0.4828 0.4286 0.2782 0.0000 0.4969 0.7265 0.1895 0.8238 0.3333 0.9630 0.8095 0.2036 0.6507 0.5854 0.2857 0.7500 0.6421 0.0000 0.2113 0.0000 0.3789]
Mean: 0.4399902376686316
Std: 0.28148644779133775

Cohen Kappa score: 0.29802914186489315
Confusion matrix:
[[ 904    0    0    4    9    0    2    0    0    0    1    2    0    0    0    0   12    0    3    0    0]
 [  35   15    0    0    0    0    0    0    0    0    0    0    0    0    0    0    0    0    0    0    0]
 [ 208    0   58    1   30    0   49    0    0    0    0    0    1    0    0    0   12    0    0    0    0]
 [   0    0    0    0    0    0    0    0    0    0    0    0    0    0    0    0    0    0    0    0    0]
 [  59    0    0   13  119    2   37    0    0    0    0    0    0    0    0    0    1    0    0    0    0]
 [  15    0    0   33    0   89    8    0    0    0    0    1    0    0    0    0    0    0    1    0    0]
 [ 718    3    0  309    0    2  144    0    2    0    0    4    0    0    0    0   52    0    1    0    0]
 [  22    0    0    6    0    1    1  180    0    0    0    1    0    0    0    0    0    0    0    0    0]
 [   0    0    0    0    0    0    0    0    1    0    0    0    0    0    0    0    0    0    0    0    0]
 [   1    0    0    0    0    0    0    0    0   13    0    0    0    0    0    0    0    0    0    0    0]
 [  31    0    0    0    0    0    0    0    0    0   68    0    0    0    0    0    0    0    0    0    0]
 [  30    0    0    2    2    0    2    0    0    0    0   28    0    0    0    0    0    0    0    0    0]
 [  27    1    0  184    1    0    5    0    0    0    0    0  204    0    0    0    0    0    0    0    0]
 [  31    0    0    0    0    0    0    0    0    0    0    0    0   24    3    0    0    0    0    0    0]
 [  15    0    0    0    0    0    0    0    0    0    0    0    0    0    4    1    0    0    0    0    0]
 [  10    0    0    0    0    0    0    0    0    0    0    0    0    0    1   18    0    0    0    0    0]
 [ 214    0    0  304   21    0    0    0    2    0    0   17    0    0    0    0  679    0    0    0    0]
 [  67    0    0   79    6    0    4    0    0    0    0    2    0    0    0    0  112    0    0    0    0]
 [ 326    1    0 1812    0    4    9    2    0    0    0  155    0    0    0    0    0    0  310    0    0]
 [  11    0    0   14   32    0   10    0    0    0    0    1    0    0    0    0    7    0    0    0    0]
 [  84    0    0    4   28    0   14   44    0    0    0    0    0    0    0    0    3    0    0    0   54]]

