Classifier: LogisticRegression
Params: {'C': 1.0, 'class_weight': None, 'dual': False, 'fit_intercept': True, 'intercept_scaling': 1, 'max_iter': 100, 'multi_class': 'ovr', 'n_jobs': 1, 'penalty': 'l2', 'random_state': None, 'solver': 'liblinear', 'tol': 0.0001, 'verbose': 0, 'warm_start': False}

Labels: None

Training accuracy: 0.9903244722439406
Training confusion matrix:
[[14697     0     1     4     0     0     0     1     0     0     0     0     0     0     0     0     2     0     0     0     0     1     0     0     0     0     0]
 [    0   238     0     0     0     0     0     0     0     0     0     0     0     0     0     0     0     0     0     0     0     0     0     0     0     0     0]
 [    0     0   295     0     0     0     0     0     0     0     0     0     0     0     0     0     0     0     0     0     0     0     0     0     0     0     0]
 [    1     0     0   192     0     0     0     0     0     0     0     0     0     0     0     0     0     0     0     0     0     0     0     0     0     0     0]
 [    0     0     0     0   196     0     0     0     0     0     0     0     0     0     0     0     0     0     0     0     0     0     0     0     0     0     0]
 [    0     0     0     0     0   114     0     0     0     0     0     0     8     1     4     0     0     2     3    21     0     0     0     0     0     0     0]
 [    0     0     0     0     0     0   120     0     0     0     0     0     0     0     0     0     0     0     0     0     0     0     0     0     0     0     0]
 [    0     0     0     0     0     0     0   971     0     0     0     0     0     0     0     0     0     0     0     0     1     0     0     0     0     0     0]
 [    0     0     0     0     0     0     0     0   179     0     0     0     0     0     0     0     0     0     0     0     0     0     0     0     0     0     0]
 [    4     0     0     0     0     0     0     0     0  6811     0     0     0     0     0     0     0     0     0     0     0     0     0     0     0     0     0]
 [    0     0     0     0     0     0     0     0     0     0   212     0     0     0     0     0     0     0     0     0     0     0     0     0     0     0     0]
 [    0     0     0     0     0     0     0     0     0     0     0  1178     0     0     0     0     0     0     0     0     0     0     0     0     0     0     0]
 [    0     0     0     0     0     4     0     0     0     0     0     0    71     7     0     0     0     4     0    19     0     0     0     0     0     0     0]
 [    0     0     0     0     0     5     0     0     0     0     0     0     0    77     0     0     0     2     0     5     0     0     0     0     0     0     0]
 [    0     0     0     0     0     2     0     0     0     0     0     0     2     2   303     0     0     1     6     6     0     0     0     0     0     0     0]
 [    1     0     0     0     0     0     0     0     0     0     0     0     0     0     0    54     0     0     0     0     0     0     0     0     0     0     0]
 [    2     0     0     0     0     0     0     0     0     0     0     0     0     0     0     0   419     0     0     0     0     0     0     0     0     0     0]
 [    0     0     0     0     0     8     0     0     0     0     0     0    11     8     0     0     0   210     1    43     0     0     0     0     0     0     0]
 [    0     0     0     0     0     2     0     0     0     0     0     0     1     0     6     0     0     2   104     9     0     0     0     0     0     0     0]
 [    0     0     0     0     0    15     0     0     0     0     0     0    22    10     3     0     0    27     1   306     0     0     0     0     0     0     0]
 [    2     0     0     0     0     0     0     0     0     0     0     0     0     0     0     0     0     0     0     0   994     0     0     0     0     0     0]
 [    1     0     0     0     0     0     0     0     0     0     0     0     0     0     0     0     0     0     0     0     0   210     0     0     0     0     0]
 [    0     0     0     0     0     0     0     0     1     0     0     0     0     0     0     0     0     0     0     0     0     0  2140     0     0     0     0]
 [    0     0     0     0     0     0     0     0     0     1     0     0     0     0     0     0     0     0     0     0     0     0     0    35     0     0     0]
 [    0     0     0     0     0     0     0     0     0     0     0     0     0     0     0     0     0     0     0     0     0     0     0     0    29     0     0]
 [    0     0     0     0     0     0     0     1     0     0     0     0     0     0     0     0     0     0     0     0     0     0     0     0     0    59     0]
 [    0     0     0     0     0     0     0     0     0     0     0     0     0     0     0     0     0     0     0     0     0     0     0     0     0     0   185]]

Accuracy: 0.9827990617670055

Precision: [0.9951 1.0000 0.9848 0.9259 1.0000 0.5957 1.0000 1.0000 1.0000 0.9994 0.9655 1.0000 0.8000 0.5600 0.8831 1.0000 0.9579 0.8235 0.7500 0.6087 0.9882 1.0000 0.9980 1.0000 1.0000 1.0000 0.9792]
Mean: 0.9190794389642548
Std: 0.13470486354549419

Recall: [0.9959 0.9833 1.0000 0.9804 1.0000 0.7179 1.0000 0.9890 1.0000 0.9965 0.9825 1.0000 0.6667 0.7368 0.8947 1.0000 0.9891 0.5915 0.7059 0.6829 0.9960 0.9831 1.0000 0.8889 0.7778 1.0000 1.0000]
Mean: 0.9095947796639166
Std: 0.13158075947083628

F1 score: [0.9955 0.9916 0.9924 0.9524 1.0000 0.6512 1.0000 0.9945 1.0000 0.9980 0.9739 1.0000 0.7273 0.6364 0.8889 1.0000 0.9733 0.6885 0.7273 0.6437 0.9921 0.9915 0.9990 0.9412 0.8750 1.0000 0.9895]
Mean: 0.9119565772916317
Std: 0.12951363152266473

Cohen Kappa score: 0.975895587522924
Confusion matrix:
[[3633    0    1    3    0    0    0    0    0    1    2    0    0    0    1    0    4    0    0    0    1    0    1    0    0    0    1]
 [   1   59    0    0    0    0    0    0    0    0    0    0    0    0    0    0    0    0    0    0    0    0    0    0    0    0    0]
 [   0    0   65    0    0    0    0    0    0    0    0    0    0    0    0    0    0    0    0    0    0    0    0    0    0    0    0]
 [   1    0    0   50    0    0    0    0    0    0    0    0    0    0    0    0    0    0    0    0    0    0    0    0    0    0    0]
 [   0    0    0    0   56    0    0    0    0    0    0    0    0    0    0    0    0    0    0    0    0    0    0    0    0    0    0]
 [   0    0    0    0    0   28    0    0    0    0    0    0    1    0    3    0    0    0    0    7    0    0    0    0    0    0    0]
 [   0    0    0    0    0    0   31    0    0    0    0    0    0    0    0    0    0    0    0    0    0    0    0    0    0    0    0]
 [   1    0    0    0    0    0    0  270    0    0    0    0    0    0    0    0    0    0    0    0    2    0    0    0    0    0    0]
 [   0    0    0    0    0    0    0    0   45    0    0    0    0    0    0    0    0    0    0    0    0    0    0    0    0    0    0]
 [   6    0    0    0    0    0    0    0    0 1731    0    0    0    0    0    0    0    0    0    0    0    0    0    0    0    0    0]
 [   1    0    0    0    0    0    0    0    0    0   56    0    0    0    0    0    0    0    0    0    0    0    0    0    0    0    0]
 [   0    0    0    0    0    0    0    0    0    0    0  299    0    0    0    0    0    0    0    0    0    0    0    0    0    0    0]
 [   0    0    0    0    0    0    0    0    0    0    0    0   20    3    0    0    0    2    0    5    0    0    0    0    0    0    0]
 [   0    0    0    0    0    3    0    0    0    0    0    0    0   14    1    0    0    0    0    1    0    0    0    0    0    0    0]
 [   0    0    0    0    0    0    0    0    0    0    0    0    0    0   68    0    0    0    6    2    0    0    0    0    0    0    0]
 [   0    0    0    0    0    0    0    0    0    0    0    0    0    0    0   13    0    0    0    0    0    0    0    0    0    0    0]
 [   1    0    0    0    0    0    0    0    0    0    0    0    0    0    0    0   91    0    0    0    0    0    0    0    0    0    0]
 [   1    0    0    0    0    4    0    0    0    0    0    0    1    2    1    0    0   42    1   19    0    0    0    0    0    0    0]
 [   0    0    0    0    0    1    0    0    0    0    0    0    2    2    3    0    0    0   24    2    0    0    0    0    0    0    0]
 [   2    0    0    0    0   11    0    0    0    0    0    0    1    4    0    0    0    7    1   56    0    0    0    0    0    0    0]
 [   1    0    0    0    0    0    0    0    0    0    0    0    0    0    0    0    0    0    0    0  251    0    0    0    0    0    0]
 [   1    0    0    0    0    0    0    0    0    0    0    0    0    0    0    0    0    0    0    0    0   58    0    0    0    0    0]
 [   0    0    0    0    0    0    0    0    0    0    0    0    0    0    0    0    0    0    0    0    0    0  505    0    0    0    0]
 [   1    0    0    0    0    0    0    0    0    0    0    0    0    0    0    0    0    0    0    0    0    0    0    8    0    0    0]
 [   1    0    0    1    0    0    0    0    0    0    0    0    0    0    0    0    0    0    0    0    0    0    0    0    7    0    0]
 [   0    0    0    0    0    0    0    0    0    0    0    0    0    0    0    0    0    0    0    0    0    0    0    0    0   15    0]
 [   0    0    0    0    0    0    0    0    0    0    0    0    0    0    0    0    0    0    0    0    0    0    0    0    0    0   47]]

