Classifier: MultinomialNB
Params: {'alpha': 1.0, 'class_prior': None, 'fit_prior': True}

Labels: None

Training accuracy: 0.920901746155851
Training confusion matrix:
[[13658   107    14    89    10     0     1   252     1    21   156    12     0     0    91     0    25    58     3   126    31     7    14     8     0     0    22]
 [    6   232     0     0     0     0     0     0     0     0     0     0     0     0     0     0     0     0     0     0     0     0     0     0     0     0     0]
 [    2     0   262     0     5     0     3    11     0     0     0     0     0     0     0     0     1     0     0     0    11     0     0     0     0     0     0]
 [   32     0     0   142     0     0     0     0     0     0     0     0     0     0     0     0    19     0     0     0     0     0     0     0     0     0     0]
 [    0     0     0     0   164     0     8    18     0     0     0     0     0     0     0     0     0     0     0     0     1     0     5     0     0     0     0]
 [    0     0     0     0     0     8     0     0     0     0     0     0     0     0     3     0     0     1     0   141     0     0     0     0     0     0     0]
 [    0     0     0     0     2     0   111     1     0     0     0     0     0     0     0     0     0     0     0     0     0     0     6     0     0     0     0]
 [    0     0     1     0    10     0     0   949     0     0     0     0     0     0     0     0     0     0     0     0    10     0     2     0     0     0     0]
 [    1     0     0     0     0     0     1     1   170     0     0     0     0     0     0     0     0     0     0     0     0     0     6     0     0     0     0]
 [   84     0     0     2     0     0     0     1     0  6693     5     1     0     0     2     0     2     0     0     0     3     0    22     0     0     0     0]
 [    9     0     0     0     0     0     0     0     0     0   203     0     0     0     0     0     0     0     0     0     0     0     0     0     0     0     0]
 [   13     0     0     0     0     0     0     0     0     3     0  1162     0     0     0     0     0     0     0     0     0     0     0     0     0     0     0]
 [    0     0     0     0     0     0     0     0     0     0     0     0     0     0     0     0     0     2     0   103     0     0     0     0     0     0     0]
 [    0     0     0     0     0     0     0     0     0     0     0     0     0     0     0     0     0     0     0    89     0     0     0     0     0     0     0]
 [    1     0     0     0     0     0     0     0     0     0     0     0     0     0   176     0     0    10     0   124     0     0    11     0     0     0     0]
 [    0     0     0     0     4     0     1     4     0     0     0     0     0     0     0    28     0     0     0     0     0     0    18     0     0     0     0]
 [   41     0     0     2     2     0     1     1     0     0     0     0     0     0     0     0   374     0     0     0     0     0     0     0     0     0     0]
 [    6     0     0     0     0     0     0     0     0     0     0     0     0     0     0     0     0    64     1   210     0     0     0     0     0     0     0]
 [    1     0     0     0     0     0     0     0     0     0     0     0     0     0     8     0     0     5    11    99     0     0     0     0     0     0     0]
 [    3     0     0     0     0     0     0     1     0     0     0     0     0     0     1     0     0     9     0   364     0     0     6     0     0     0     0]
 [    2     0     0     0     0     0     0     2     0     0     0     0     0     0     0     0     0     0     0     0   991     0     1     0     0     0     0]
 [    1     0     0     0     0     0     0    17     0     0     0     0     0     0     0     0     0     0     0     0    25   161     7     0     0     0     0]
 [    3     0     1     0     4     0     3     4     1     0     0     0     0     0     0     0     0     0     0     0     0     0  2125     0     0     0     0]
 [    6    16     0     0     0     0     0     0     0     0     0     0     0     0     0     0     0     0     0     0     0     0     0    14     0     0     0]
 [    8     0     0     0     0     0     0     0     0     0     0     0     0     0     0     0     0     0     0     0     0     0     0     0    21     0     0]
 [    0     0     2     0     2     0     0    10     0     0     0     0     0     0     0     0     1     0     0     0     0     0    26     0     0    19     0]
 [    1     0     0     0     4     0     1     5     0     0     0     0     0     0     0     0     0     0     0     0     6     0     2     0     0     0   166]]

Accuracy: 0.9152984102163149

Precision: [0.9762 0.6444 0.9000 0.5088 0.8077 1.0000 0.7273 0.7778 1.0000 0.9953 0.6709 0.9966 0.0000 0.0000 0.6032 1.0000 0.8556 0.4412 0.3333 0.2405 0.9179 0.9792 0.9276 0.5000 0.7143 1.0000 0.8723]
Mean: 0.7181499469144614
Std: 0.29657005183841306

Recall: [0.9326 0.9667 0.8308 0.5686 0.7500 0.0513 0.7742 0.9744 0.9556 0.9787 0.9298 0.9833 0.0000 0.0000 0.5000 0.6154 0.8370 0.2113 0.0294 0.9268 0.9762 0.7966 0.9901 0.2222 0.5556 0.0667 0.8723]
Mean: 0.640568689937997
Std: 0.35901033979860003

F1 score: [0.9539 0.7733 0.8640 0.5370 0.7778 0.0976 0.7500 0.8650 0.9773 0.9869 0.7794 0.9899 0.0000 0.0000 0.5468 0.7619 0.8462 0.2857 0.0541 0.3819 0.9462 0.8785 0.9579 0.3077 0.6250 0.1250 0.8723]
Mean: 0.6274515533338716
Std: 0.3348296018073978

Cohen Kappa score: 0.8829619832337251
Confusion matrix:
[[3402   27    6   28    1    0    0   56    0    7   26    1    0    0   19    0    5   10    2   44    1    1    2    2    2    0    6]
 [   2   58    0    0    0    0    0    0    0    0    0    0    0    0    0    0    0    0    0    0    0    0    0    0    0    0    0]
 [   1    0   54    0    1    0    2    3    0    0    0    0    0    0    0    0    0    0    0    0    4    0    0    0    0    0    0]
 [  18    0    0   29    0    0    0    0    0    0    0    0    0    0    0    0    4    0    0    0    0    0    0    0    0    0    0]
 [   0    0    0    0   42    0    3    6    0    0    0    0    0    0    0    0    0    0    0    0    0    0    5    0    0    0    0]
 [   0    0    0    0    0    2    0    0    0    0    0    0    0    0    0    0    0    0    0   37    0    0    0    0    0    0    0]
 [   0    0    0    0    0    0   24    2    0    0    0    0    0    0    0    0    1    0    0    0    0    0    4    0    0    0    0]
 [   2    0    0    0    2    0    0  266    0    0    0    0    0    0    0    0    0    0    0    0    3    0    0    0    0    0    0]
 [   0    0    0    0    0    0    0    1   43    0    0    0    0    0    0    0    0    0    0    0    0    0    1    0    0    0    0]
 [  27    0    0    0    0    0    0    0    0 1700    0    0    0    0    0    0    3    0    0    0    0    0    7    0    0    0    0]
 [   4    0    0    0    0    0    0    0    0    0   53    0    0    0    0    0    0    0    0    0    0    0    0    0    0    0    0]
 [   4    0    0    0    0    0    0    0    0    1    0  294    0    0    0    0    0    0    0    0    0    0    0    0    0    0    0]
 [   0    0    0    0    0    0    0    0    0    0    0    0    0    0    0    0    0    1    0   29    0    0    0    0    0    0    0]
 [   0    0    0    0    0    0    0    0    0    0    0    0    0    0    0    0    0    0    0   19    0    0    0    0    0    0    0]
 [   2    0    0    0    0    0    0    0    0    0    0    0    0    0   38    0    0    1    0   31    2    0    2    0    0    0    0]
 [   0    0    0    0    0    0    0    0    0    0    0    0    0    0    0    8    0    0    0    0    0    0    5    0    0    0    0]
 [  13    0    0    0    1    0    1    0    0    0    0    0    0    0    0    0   77    0    0    0    0    0    0    0    0    0    0]
 [   1    0    0    0    0    0    0    0    0    0    0    0    0    0    1    0    0   15    0   54    0    0    0    0    0    0    0]
 [   0    0    0    0    0    0    0    0    0    0    0    0    0    0    3    0    0    4    1   26    0    0    0    0    0    0    0]
 [   1    0    0    0    0    0    0    0    0    0    0    0    0    0    2    0    0    3    0   76    0    0    0    0    0    0    0]
 [   1    0    0    0    0    0    0    4    0    0    0    0    0    0    0    0    0    0    0    0  246    0    1    0    0    0    0]
 [   0    0    0    0    0    0    0    2    0    0    0    0    0    0    0    0    0    0    0    0    9   47    1    0    0    0    0]
 [   1    0    0    0    0    0    3    1    0    0    0    0    0    0    0    0    0    0    0    0    0    0  500    0    0    0    0]
 [   2    5    0    0    0    0    0    0    0    0    0    0    0    0    0    0    0    0    0    0    0    0    0    2    0    0    0]
 [   4    0    0    0    0    0    0    0    0    0    0    0    0    0    0    0    0    0    0    0    0    0    0    0    5    0    0]
 [   0    0    0    0    4    0    0    1    0    0    0    0    0    0    0    0    0    0    0    0    0    0    9    0    0    1    0]
 [   0    0    0    0    1    0    0    0    0    0    0    0    0    0    0    0    0    0    0    0    3    0    2    0    0    0   41]]

