Classifier: RandomForestClassifier
Params: {'bootstrap': True, 'class_weight': None, 'criterion': 'gini', 'max_depth': None, 'max_features': 'auto', 'max_leaf_nodes': None, 'min_impurity_decrease': 0.0, 'min_impurity_split': None, 'min_samples_leaf': 1, 'min_samples_split': 2, 'min_weight_fraction_leaf': 0.0, 'n_estimators': 100, 'n_jobs': 1, 'oob_score': False, 'random_state': None, 'verbose': 0, 'warm_start': False}

Labels: None

Training accuracy: 0.9956020328381548
Training confusion matrix:
[[14701     0     0     4     0     0     0     0     0     0     0     0     0     0     0     0     1     0     0     0     0     0     0     0     0     0     0]
 [    0   238     0     0     0     0     0     0     0     0     0     0     0     0     0     0     0     0     0     0     0     0     0     0     0     0     0]
 [    0     0   295     0     0     0     0     0     0     0     0     0     0     0     0     0     0     0     0     0     0     0     0     0     0     0     0]
 [    0     0     0   193     0     0     0     0     0     0     0     0     0     0     0     0     0     0     0     0     0     0     0     0     0     0     0]
 [    0     0     0     0   196     0     0     0     0     0     0     0     0     0     0     0     0     0     0     0     0     0     0     0     0     0     0]
 [    0     0     0     0     0   141     0     0     0     0     0     0     0     2     1     0     0     1     0     8     0     0     0     0     0     0     0]
 [    0     0     0     0     0     0   120     0     0     0     0     0     0     0     0     0     0     0     0     0     0     0     0     0     0     0     0]
 [    0     0     0     0     0     0     0   972     0     0     0     0     0     0     0     0     0     0     0     0     0     0     0     0     0     0     0]
 [    0     0     0     0     0     0     0     0   179     0     0     0     0     0     0     0     0     0     0     0     0     0     0     0     0     0     0]
 [    0     0     0     0     0     0     0     0     0  6815     0     0     0     0     0     0     0     0     0     0     0     0     0     0     0     0     0]
 [    0     0     0     0     0     0     0     0     0     0   212     0     0     0     0     0     0     0     0     0     0     0     0     0     0     0     0]
 [    0     0     0     0     0     0     0     0     0     0     0  1178     0     0     0     0     0     0     0     0     0     0     0     0     0     0     0]
 [    0     0     0     0     0     1     0     0     0     0     0     0    90     1     0     0     0     2     0    11     0     0     0     0     0     0     0]
 [    0     0     0     0     0     1     0     0     0     0     0     0     1    83     1     0     0     1     0     2     0     0     0     0     0     0     0]
 [    0     0     0     0     0     2     0     0     0     0     0     0     0     0   315     0     0     1     3     1     0     0     0     0     0     0     0]
 [    0     0     0     0     0     0     0     0     0     0     0     0     0     0     0    55     0     0     0     0     0     0     0     0     0     0     0]
 [    1     0     0     0     0     0     0     0     0     0     0     0     0     0     0     0   420     0     0     0     0     0     0     0     0     0     0]
 [    0     0     0     0     0     2     0     0     0     0     0     0     1     2     0     0     0   247     0    29     0     0     0     0     0     0     0]
 [    0     0     0     0     0     1     0     0     0     0     0     0     0     0     5     0     0     2   110     6     0     0     0     0     0     0     0]
 [    0     0     0     0     0     7     0     0     0     0     0     0    13     4     3     0     0    12     1   344     0     0     0     0     0     0     0]
 [    1     0     0     0     0     0     0     0     0     0     0     0     0     0     0     0     0     0     0     0   995     0     0     0     0     0     0]
 [    0     0     0     0     0     0     0     0     0     0     0     0     0     0     0     0     0     0     0     0     0   211     0     0     0     0     0]
 [    0     0     0     0     0     0     0     0     0     0     0     0     0     0     0     0     0     0     0     0     0     0  2141     0     0     0     0]
 [    0     0     0     0     0     0     0     0     0     0     0     0     0     0     0     0     0     0     0     0     0     0     0    36     0     0     0]
 [    0     0     0     0     0     0     0     0     0     0     0     0     0     0     0     0     0     0     0     0     0     0     0     0    29     0     0]
 [    0     0     0     0     0     0     0     0     0     0     0     0     0     0     0     0     0     0     0     0     0     0     0     0     0    60     0]
 [    0     0     0     0     0     0     0     0     0     0     0     0     0     0     0     0     0     0     0     0     0     0     0     0     0     0   185]]

Accuracy: 0.971722700026062

Precision: [0.9877 0.9322 0.9365 0.9000 0.9286 0.6296 0.9688 0.9963 1.0000 0.9983 1.0000 1.0000 0.6818 0.4783 0.7901 1.0000 0.9457 0.6316 0.6250 0.5351 0.9653 0.9825 0.9980 0.6667 1.0000 1.0000 0.9778]
Mean: 0.872430681620407
Std: 0.1665257064085878

Recall: [0.9918 0.9167 0.9077 0.8824 0.9286 0.4359 1.0000 0.9817 0.9778 0.9977 0.9298 0.9933 0.5000 0.5789 0.8421 1.0000 0.9457 0.5070 0.4412 0.7439 0.9921 0.9492 1.0000 0.8889 0.8889 0.8000 0.9362]
Mean: 0.8502682454110938
Std: 0.18263736070527015

F1 score: [0.9897 0.9244 0.9219 0.8911 0.9286 0.5152 0.9841 0.9889 0.9888 0.9980 0.9636 0.9966 0.5769 0.5238 0.8153 1.0000 0.9457 0.5625 0.5172 0.6224 0.9785 0.9655 0.9990 0.7619 0.9412 0.8889 0.9565]
Mean: 0.8572681346640721
Std: 0.17230726594788612

Cohen Kappa score: 0.960325381532075
Confusion matrix:
[[3618    4    1    4    0    0    0    0    0    3    0    0    0    0    4    0    5    1    1    2    0    0    1    4    0    0    0]
 [   5   55    0    0    0    0    0    0    0    0    0    0    0    0    0    0    0    0    0    0    0    0    0    0    0    0    0]
 [   2    0   59    0    1    0    0    0    0    0    0    0    0    0    0    0    0    0    0    0    2    0    0    0    0    0    1]
 [   5    0    0   45    0    0    0    0    0    0    0    0    0    0    1    0    0    0    0    0    0    0    0    0    0    0    0]
 [   0    0    0    0   52    0    0    1    0    0    0    0    0    0    0    0    0    0    0    0    2    1    0    0    0    0    0]
 [   2    0    0    0    0   17    0    0    0    0    0    0    0    4    2    0    0    3    0   11    0    0    0    0    0    0    0]
 [   0    0    0    0    0    0   31    0    0    0    0    0    0    0    0    0    0    0    0    0    0    0    0    0    0    0    0]
 [   2    0    1    0    0    0    0  268    0    0    0    0    0    0    0    0    0    0    0    0    2    0    0    0    0    0    0]
 [   0    0    0    0    0    0    1    0   44    0    0    0    0    0    0    0    0    0    0    0    0    0    0    0    0    0    0]
 [   4    0    0    0    0    0    0    0    0 1733    0    0    0    0    0    0    0    0    0    0    0    0    0    0    0    0    0]
 [   4    0    0    0    0    0    0    0    0    0   53    0    0    0    0    0    0    0    0    0    0    0    0    0    0    0    0]
 [   2    0    0    0    0    0    0    0    0    0    0  297    0    0    0    0    0    0    0    0    0    0    0    0    0    0    0]
 [   0    0    0    0    0    1    0    0    0    0    0    0   15    1    0    0    0    5    0    8    0    0    0    0    0    0    0]
 [   0    0    0    0    0    3    0    0    0    0    0    0    1   11    1    0    0    1    0    2    0    0    0    0    0    0    0]
 [   2    0    0    0    0    0    0    0    0    0    0    0    1    0   64    0    0    0    6    3    0    0    0    0    0    0    0]
 [   0    0    0    0    0    0    0    0    0    0    0    0    0    0    0   13    0    0    0    0    0    0    0    0    0    0    0]
 [   5    0    0    0    0    0    0    0    0    0    0    0    0    0    0    0   87    0    0    0    0    0    0    0    0    0    0]
 [   2    0    0    0    0    3    0    0    0    0    0    0    2    2    2    0    0   36    1   23    0    0    0    0    0    0    0]
 [   4    0    0    0    0    1    0    0    0    0    0    0    2    2    4    0    0    2   15    4    0    0    0    0    0    0    0]
 [   2    0    0    0    0    2    0    0    0    0    0    0    1    3    3    0    0    9    1   61    0    0    0    0    0    0    0]
 [   2    0    0    0    0    0    0    0    0    0    0    0    0    0    0    0    0    0    0    0  250    0    0    0    0    0    0]
 [   1    0    0    0    0    0    0    0    0    0    0    0    0    0    0    0    0    0    0    0    2   56    0    0    0    0    0]
 [   0    0    0    0    0    0    0    0    0    0    0    0    0    0    0    0    0    0    0    0    0    0  505    0    0    0    0]
 [   1    0    0    0    0    0    0    0    0    0    0    0    0    0    0    0    0    0    0    0    0    0    0    8    0    0    0]
 [   0    0    0    1    0    0    0    0    0    0    0    0    0    0    0    0    0    0    0    0    0    0    0    0    8    0    0]
 [   0    0    0    0    2    0    0    0    0    0    0    0    0    0    0    0    0    0    0    0    1    0    0    0    0   12    0]
 [   0    0    2    0    1    0    0    0    0    0    0    0    0    0    0    0    0    0    0    0    0    0    0    0    0    0   44]]

