Classifier: GradientBoostingClassifier
Params: {'criterion': 'friedman_mse', 'init': None, 'learning_rate': 0.1, 'loss': 'deviance', 'max_depth': 3, 'max_features': None, 'max_leaf_nodes': None, 'min_impurity_decrease': 0.0, 'min_impurity_split': None, 'min_samples_leaf': 1, 'min_samples_split': 2, 'min_weight_fraction_leaf': 0.0, 'n_estimators': 100, 'presort': 'auto', 'random_state': None, 'subsample': 1.0, 'verbose': 0, 'warm_start': False}

Labels: None

Training accuracy: 0.9965946578695328
Training confusion matrix:
[[8876    0    0    0    0    0    0    2    0    0    0    0    0    0    1    0    0    0    0    0    0    0    0    0    0    0    0]
 [   2   61    0    0    0    0    0    0    0    0    0    0    0    0    0    0    0    0    0    0    0    0    0    0    0    0    0]
 [   0    0  193    0    0    0    0    0    0    0    0    0    0    0    0    0    0    0    0    0    0    0    0    0    0    0    0]
 [   1    0    0  118    0    0    0    0    0    0    0    0    0    0    0    0    0    0    0    0    0    0    0    0    0    0    0]
 [   0    0    0    0  159    0    0    0    0    0    0    0    0    0    0    0    0    0    0    0    0    0    0    0    0    0    0]
 [   0    0    0    0    0   46    0    0    0    0    0    0    0    0    1    0    0    0    1    1    0    0    0    0    0    0    0]
 [   0    0    0    0    0    0   29    0    0    0    0    0    0    0    0    0    0    0    0    0    0    0    0    0    0    0    0]
 [   0    0    0    0    0    0    0  535    0    0    0    0    0    0    0    0    0    0    0    0    0    0    0    0    0    0    0]
 [   0    0    0    0    0    0    0    0  116    0    0    0    0    0    0    0    0    0    0    0    0    0    0    0    0    0    0]
 [   5    0    0    0    0    0    0    0    0 5076    0    0    0    0    0    0    0    0    0    0    0    0    0    0    0    0    0]
 [   0    0    0    0    0    0    0    0    0    0  133    0    0    0    0    0    0    0    0    0    0    0    0    0    0    0    0]
 [   0    0    0    0    0    0    0    0    0    0    0   45    0    0    0    0    0    0    0    0    0    0    0    0    0    0    0]
 [   0    0    0    0    0    0    0    0    0    0    0    0   43    0    0    0    0    0    0    2    0    0    0    0    0    0    0]
 [   0    0    0    0    0    0    0    0    0    0    0    0    0   14    0    0    0    0    0    1    0    0    0    0    0    0    0]
 [   0    0    0    0    0    2    0    0    0    0    0    0    0    0  147    0    0    1    0    4    0    0    0    0    0    0    0]
 [   0    0    0    0    0    0    0    0    0    0    0    0    0    0    0   30    0    0    0    0    0    0    0    0    0    0    0]
 [   1    0    0    0    0    0    0    0    0    0    0    0    0    0    0    0  323    0    0    0    0    0    0    0    0    0    0]
 [   0    0    0    0    0    0    0    0    0    0    0    0    1    1    0    0    0  120    0   12    0    0    0    0    0    0    0]
 [   0    0    0    0    0    2    0    0    0    0    0    0    0    1    0    0    0    3   44    6    0    0    0    0    0    0    0]
 [   0    0    0    0    0    3    0    0    0    0    0    0    4    0    2    0    0    4    0  121    0    0    0    0    0    0    0]
 [   0    0    0    0    0    0    0    0    0    0    0    0    0    0    0    0    0    0    0    0  652    0    0    0    0    0    0]
 [   0    0    0    0    0    0    0    0    0    0    0    0    0    0    0    0    0    0    0    0    0  159    0    0    0    0    0]
 [   0    0    0    0    0    0    0    0    0    0    0    0    0    0    0    0    0    0    0    0    0    0 1495    0    0    0    0]
 [   0    0    0    0    0    0    0    0    0    0    0    0    0    0    0    0    0    0    0    0    0    0    0   13    0    0    0]
 [   0    0    0    0    0    0    0    0    0    0    0    0    0    0    0    0    0    0    0    0    0    0    0    0   17    0    0]
 [   0    0    0    0    0    0    0    0    0    0    0    0    0    0    0    0    0    0    0    0    0    0    0    0    0   43    0]
 [   0    0    0    0    0    0    0    0    0    0    0    0    0    0    0    0    0    0    0    0    0    0    0    0    0    0  122]]

Accuracy: 0.9444217409072333

Precision: [0.9665 0.9625 0.9937 0.9652 1.0000 0.4923 0.9683 0.9910 0.9730 0.9953 0.8608 1.0000 0.1466 0.8621 0.8235 1.0000 1.0000 0.6220 0.3128 0.6011 0.9966 0.9821 0.9983 0.7561 1.0000 1.0000 0.9904]
Mean: 0.8614815648419326
Std: 0.22585940526999768

Recall: [0.9851 0.9830 0.9461 0.8880 1.0000 0.2238 1.0000 0.9324 1.0000 0.9697 1.0000 0.9888 0.6778 0.2688 0.7459 0.9737 0.8677 0.2339 0.6471 0.3404 0.9866 0.9910 0.9974 0.9688 0.4762 0.9375 0.9364]
Mean: 0.8135551399040276
Std: 0.2608281871235796

F1 score: [0.9757 0.9726 0.9693 0.9250 1.0000 0.3077 0.9839 0.9608 0.9863 0.9823 0.9252 0.9944 0.2411 0.4098 0.7828 0.9867 0.9292 0.3400 0.4217 0.4346 0.9916 0.9865 0.9978 0.8493 0.6452 0.9677 0.9626]
Mean: 0.8122195539120661
Std: 0.2553587104555592

Cohen Kappa score: 0.9226557710768445
Confusion matrix:
[[9334    9    1    1    0   15    4    2    0   16   22    0   42    0    1    0    0    0    6    9    0    1    2   10    0    0    0]
 [   4  231    0    0    0    0    0    0    0    0    0    0    0    0    0    0    0    0    0    0    0    0    0    0    0    0    0]
 [   5    0  158    0    0    0    0    0    0    0    0    0    0    0    0    0    0    0    0    0    2    1    0    0    0    0    1]
 [  14    0    0  111    0    0    0    0    0    0    0    0    0    0    0    0    0    0    0    0    0    0    0    0    0    0    0]
 [   0    0    0    0   93    0    0    0    0    0    0    0    0    0    0    0    0    0    0    0    0    0    0    0    0    0    0]
 [  17    0    0    0    0   32    0    0    0    0    0    0   61    0    1    0    0    1   18   13    0    0    0    0    0    0    0]
 [   0    0    0    0    0    0  122    0    0    0    0    0    0    0    0    0    0    0    0    0    0    0    0    0    0    0    0]
 [  47    0    0    0    0    0    0  662    1    0    0    0    0    0    0    0    0    0    0    0    0    0    0    0    0    0    0]
 [   0    0    0    0    0    0    0    0  108    0    0    0    0    0    0    0    0    0    0    0    0    0    0    0    0    0    0]
 [ 105    0    0    0    0    0    0    0    0 3366    0    0    0    0    0    0    0    0    0    0    0    0    0    0    0    0    0]
 [   0    0    0    0    0    0    0    0    0    0  136    0    0    0    0    0    0    0    0    0    0    0    0    0    0    0    0]
 [  16    0    0    0    0    0    0    0    0    0    0 1416    0    0    0    0    0    0    0    0    0    0    0    0    0    0    0]
 [   0    0    0    0    0    1    0    0    0    0    0    0   61    0    0    0    0    1   11   16    0    0    0    0    0    0    0]
 [   3    0    0    0    0    1    0    0    0    0    0    0   40   25    0    0    0    3   14    7    0    0    0    0    0    0    0]
 [  20    0    0    0    0    3    0    0    0    0    0    0   15    1  182    0    0    0   22    1    0    0    0    0    0    0    0]
 [   1    0    0    0    0    0    0    0    0    0    0    0    0    0    0   37    0    0    0    0    0    0    0    0    0    0    0]
 [  22    0    0    3    0    0    0    0    0    0    0    0    0    0    0    0  164    0    0    0    0    0    0    0    0    0    0]
 [  18    0    0    0    0    3    0    0    0    0    0    0   93    1    2    0    0   51   23   27    0    0    0    0    0    0    0]
 [   1    0    0    0    0    1    0    0    0    0    0    0    0    0   32    0    0    0   66    2    0    0    0    0    0    0    0]
 [  24    0    0    0    0    9    0    0    0    0    0    0  104    2    3    0    0   26   51  113    0    0    0    0    0    0    0]
 [   4    0    0    0    0    0    0    4    0    0    0    0    0    0    0    0    0    0    0    0  588    0    0    0    0    0    0]
 [   1    0    0    0    0    0    0    0    0    0    0    0    0    0    0    0    0    0    0    0    0  110    0    0    0    0    0]
 [   1    0    0    0    0    0    0    0    2    0    0    0    0    0    0    0    0    0    0    0    0    0 1148    0    0    0    0]
 [   1    0    0    0    0    0    0    0    0    0    0    0    0    0    0    0    0    0    0    0    0    0    0   31    0    0    0]
 [  11    0    0    0    0    0    0    0    0    0    0    0    0    0    0    0    0    0    0    0    0    0    0    0   10    0    0]
 [   2    0    0    0    0    0    0    0    0    0    0    0    0    0    0    0    0    0    0    0    0    0    0    0    0   30    0]
 [   7    0    0    0    0    0    0    0    0    0    0    0    0    0    0    0    0    0    0    0    0    0    0    0    0    0  103]]

