Classifier: LinearSVC
Params: {'C': 1.0, 'class_weight': None, 'dual': True, 'fit_intercept': True, 'intercept_scaling': 1, 'loss': 'squared_hinge', 'max_iter': 1000, 'multi_class': 'ovr', 'penalty': 'l2', 'random_state': None, 'tol': 0.0001, 'verbose': 0}

Labels: None

Training accuracy: 0.9953708630413962
Training confusion matrix:
[[8879    0    0    0    0    0    0    0    0    0    0    0    0    0    0    0    0    0    0    0    0    0    0    0    0    0    0]
 [   0   63    0    0    0    0    0    0    0    0    0    0    0    0    0    0    0    0    0    0    0    0    0    0    0    0    0]
 [   0    0  193    0    0    0    0    0    0    0    0    0    0    0    0    0    0    0    0    0    0    0    0    0    0    0    0]
 [   0    0    0  119    0    0    0    0    0    0    0    0    0    0    0    0    0    0    0    0    0    0    0    0    0    0    0]
 [   0    0    0    0  159    0    0    0    0    0    0    0    0    0    0    0    0    0    0    0    0    0    0    0    0    0    0]
 [   0    0    0    0    0   33    0    0    0    0    0    0    2    0    4    0    0    1    2    7    0    0    0    0    0    0    0]
 [   0    0    0    0    0    0   29    0    0    0    0    0    0    0    0    0    0    0    0    0    0    0    0    0    0    0    0]
 [   0    0    0    0    0    0    0  534    0    0    0    0    0    0    0    0    0    0    0    0    1    0    0    0    0    0    0]
 [   0    0    0    0    0    0    0    0  116    0    0    0    0    0    0    0    0    0    0    0    0    0    0    0    0    0    0]
 [   0    0    0    0    0    0    0    0    0 5081    0    0    0    0    0    0    0    0    0    0    0    0    0    0    0    0    0]
 [   0    0    0    0    0    0    0    0    0    0  133    0    0    0    0    0    0    0    0    0    0    0    0    0    0    0    0]
 [   0    0    0    0    0    0    0    0    0    0    0   45    0    0    0    0    0    0    0    0    0    0    0    0    0    0    0]
 [   0    0    0    0    0    0    0    0    0    0    0    0   42    0    0    0    0    0    0    3    0    0    0    0    0    0    0]
 [   0    0    0    0    0    1    0    0    0    0    0    0    0   13    0    0    0    0    0    1    0    0    0    0    0    0    0]
 [   0    0    0    0    0    2    0    0    0    0    0    0    2    0  146    0    0    1    0    3    0    0    0    0    0    0    0]
 [   0    0    0    0    0    0    0    0    0    0    0    0    0    0    0   30    0    0    0    0    0    0    0    0    0    0    0]
 [   1    0    0    0    0    0    0    0    0    0    0    0    0    0    0    0  323    0    0    0    0    0    0    0    0    0    0]
 [   0    0    0    0    0    2    0    0    0    0    0    0    2    1    0    0    0  122    0    7    0    0    0    0    0    0    0]
 [   0    0    0    0    0    2    0    0    0    0    0    0    3    1    0    0    0    2   42    6    0    0    0    0    0    0    0]
 [   0    0    0    0    0    5    0    0    0    0    0    0    7    0    3    0    0   15    0  104    0    0    0    0    0    0    0]
 [   0    0    0    0    0    0    0    0    0    0    0    0    0    0    0    0    0    0    0    0  652    0    0    0    0    0    0]
 [   0    0    0    0    0    0    0    0    0    0    0    0    0    0    0    0    0    0    0    0    0  159    0    0    0    0    0]
 [   0    0    0    0    0    0    0    0    0    0    0    0    0    0    0    0    0    0    0    0    0    0 1495    0    0    0    0]
 [   0    0    0    0    0    0    0    0    0    0    0    0    0    0    0    0    0    0    0    0    0    0    0   13    0    0    0]
 [   0    0    0    0    0    0    0    0    0    0    0    0    0    0    0    0    0    0    0    0    0    0    0    0   17    0    0]
 [   0    0    0    0    0    0    0    0    0    0    0    0    0    0    0    0    0    0    0    0    0    0    0    0    0   43    0]
 [   0    0    0    0    0    0    0    0    0    0    0    0    0    0    0    0    0    0    0    0    0    0    0    0    0    0  122]]

Accuracy: 0.9492235390273804

Precision: [0.9680 0.9522 0.9357 0.9106 0.9892 0.7826 0.7578 0.9969 1.0000 0.9973 0.8267 0.9993 0.5098 0.7391 0.7264 0.9487 0.9755 0.5753 0.7708 0.5287 0.9784 1.0000 0.9551 0.7692 0.8571 1.0000 0.7519]
Mean: 0.8593445085318224
Std: 0.14864450162247161

Recall: [0.9835 0.9319 0.9581 0.8960 0.9892 0.1259 1.0000 0.9014 1.0000 0.9669 0.9118 0.9756 0.5778 0.1828 0.9467 0.9737 0.8413 0.6835 0.3627 0.6386 0.9899 0.9820 0.9974 0.9375 0.5714 1.0000 0.9091]
Mean: 0.8235043796220327
Std: 0.24853934776906952

F1 score: [0.9757 0.9419 0.9467 0.9032 0.9892 0.2169 0.8622 0.9467 1.0000 0.9819 0.8671 0.9873 0.5417 0.2931 0.8221 0.9610 0.9034 0.6247 0.4933 0.5784 0.9842 0.9909 0.9758 0.8451 0.6857 1.0000 0.8230]
Mean: 0.8200520925522823
Std: 0.21754421619282738

Cohen Kappa score: 0.9294000021675023
Confusion matrix:
[[9319   11    1    6    0    0   18    1    0    3   25    0    0    0    7    1    2   31    0   21    1    0   18    9    1    0    0]
 [   7  219    0    0    0    0    0    0    0    6    0    0    0    0    0    0    0    1    1    0    0    0    0    0    0    0    1]
 [   5    0  160    0    0    0    0    0    0    0    0    0    0    0    0    1    0    0    0    0    0    0    1    0    0    0    0]
 [  12    0    0  112    0    0    0    0    0    0    0    0    0    0    0    0    0    0    0    1    0    0    0    0    0    0    0]
 [   1    0    0    0   92    0    0    0    0    0    0    0    0    0    0    0    0    0    0    0    0    0    0    0    0    0    0]
 [  17    0    0    0    0   18    9    0    0    0    0    0    9    0   18    0    0   18    2   38    0    0   14    0    0    0    0]
 [   0    0    0    0    0    0  122    0    0    0    0    0    0    0    0    0    0    0    0    0    0    0    0    0    0    0    0]
 [  25    0    5    0    1    0    0  640    0    0    0    0    0    0    0    0    0    0    0    0   12    0    0    0    0    0   27]
 [   0    0    0    0    0    0    0    0  108    0    0    0    0    0    0    0    0    0    0    0    0    0    0    0    0    0    0]
 [ 110    0    0    0    0    0    0    0    0 3356    1    0    0    0    1    0    2    0    0    1    0    0    0    0    0    0    0]
 [   6    0    0    0    0    0    0    0    0    0  124    0    0    0    0    0    0    0    2    3    0    0    0    0    0    0    1]
 [  35    0    0    0    0    0    0    0    0    0    0 1397    0    0    0    0    0    0    0    0    0    0    0    0    0    0    0]
 [   0    0    0    0    0    0    1    0    0    0    0    0   52    4    0    0    0    1    0   32    0    0    0    0    0    0    0]
 [   0    0    0    0    0    0   10    0    0    0    0    0    8   17    5    0    0    6    0   37    0    0   10    0    0    0    0]
 [   5    0    0    1    0    0    1    0    0    0    0    0    0    0  231    0    0    0    4    2    0    0    0    0    0    0    0]
 [   1    0    0    0    0    0    0    0    0    0    0    0    0    0    0   37    0    0    0    0    0    0    0    0    0    0    0]
 [  26    0    0    3    0    0    0    0    0    0    0    0    0    0    0    0  159    0    0    0    0    0    0    0    1    0    0]
 [   1    0    0    0    0    1    0    0    0    0    0    0   18    2    0    0    0  149    0   47    0    0    0    0    0    0    0]
 [   0    0    0    0    0    1    0    0    0    0    0    0    1    0   45    0    0    2   37    6    0    0   10    0    0    0    0]
 [  31    0    4    0    0    3    0    0    0    0    0    1   14    0   11    0    0   51    2  212    0    0    1    0    0    0    2]
 [   6    0    0    0    0    0    0    0    0    0    0    0    0    0    0    0    0    0    0    0  590    0    0    0    0    0    0]
 [   1    0    0    0    0    0    0    0    0    0    0    0    0    0    0    0    0    0    0    0    0  109    0    0    0    0    1]
 [   0    0    1    0    0    0    0    1    0    0    0    0    0    0    0    0    0    0    0    0    0    0 1148    0    0    0    1]
 [   1    0    0    0    0    0    0    0    0    0    0    0    0    0    0    0    0    0    0    1    0    0    0   30    0    0    0]
 [   8    0    0    1    0    0    0    0    0    0    0    0    0    0    0    0    0    0    0    0    0    0    0    0   12    0    0]
 [   0    0    0    0    0    0    0    0    0    0    0    0    0    0    0    0    0    0    0    0    0    0    0    0    0   32    0]
 [  10    0    0    0    0    0    0    0    0    0    0    0    0    0    0    0    0    0    0    0    0    0    0    0    0    0  100]]

