Classifier: LogisticRegression
Params: {'C': 1.0, 'class_weight': None, 'dual': False, 'fit_intercept': True, 'intercept_scaling': 1, 'max_iter': 100, 'multi_class': 'ovr', 'n_jobs': 1, 'penalty': 'l2', 'random_state': None, 'solver': 'liblinear', 'tol': 0.0001, 'verbose': 0, 'warm_start': False}

Labels: None

Training accuracy: 0.9923379802064489
Training confusion matrix:
[[8867    1    1    0    0    0    0    5    0    1    0    0    0    0    1    0    0    0    0    0    1    1    1    0    0    0    0]
 [   1   62    0    0    0    0    0    0    0    0    0    0    0    0    0    0    0    0    0    0    0    0    0    0    0    0    0]
 [   0    0  193    0    0    0    0    0    0    0    0    0    0    0    0    0    0    0    0    0    0    0    0    0    0    0    0]
 [   6    0    0  113    0    0    0    0    0    0    0    0    0    0    0    0    0    0    0    0    0    0    0    0    0    0    0]
 [   0    0    0    0  159    0    0    0    0    0    0    0    0    0    0    0    0    0    0    0    0    0    0    0    0    0    0]
 [   0    0    0    0    0   24    0    0    0    0    0    0    3    0    4    0    0    1    2   15    0    0    0    0    0    0    0]
 [   0    0    0    0    0    0   29    0    0    0    0    0    0    0    0    0    0    0    0    0    0    0    0    0    0    0    0]
 [   1    0    0    0    0    0    0  533    0    0    0    0    0    0    0    0    0    0    0    0    1    0    0    0    0    0    0]
 [   0    0    0    0    0    0    0    0  116    0    0    0    0    0    0    0    0    0    0    0    0    0    0    0    0    0    0]
 [   4    0    0    0    0    0    0    0    0 5077    0    0    0    0    0    0    0    0    0    0    0    0    0    0    0    0    0]
 [   2    0    0    0    0    0    0    0    0    0  131    0    0    0    0    0    0    0    0    0    0    0    0    0    0    0    0]
 [   2    0    0    0    0    0    0    0    0    0    0   43    0    0    0    0    0    0    0    0    0    0    0    0    0    0    0]
 [   0    0    0    0    0    0    0    0    0    0    0    0   38    0    0    0    0    0    0    7    0    0    0    0    0    0    0]
 [   0    0    0    0    0    1    0    0    0    0    0    0    1    8    0    0    0    0    1    4    0    0    0    0    0    0    0]
 [   1    0    0    0    0    3    0    0    0    0    0    0    2    0  144    0    0    1    0    3    0    0    0    0    0    0    0]
 [   0    0    0    0    0    0    0    0    0    0    0    0    0    0    0   30    0    0    0    0    0    0    0    0    0    0    0]
 [   2    0    0    0    0    0    0    0    0    0    0    0    0    0    0    0  322    0    0    0    0    0    0    0    0    0    0]
 [   0    0    0    0    0    2    0    0    0    0    0    0    3    1    0    0    0  120    1    7    0    0    0    0    0    0    0]
 [   0    0    0    0    0    2    0    0    0    0    0    0    3    0    1    0    0    3   39    8    0    0    0    0    0    0    0]
 [   0    0    0    0    0    5    0    0    0    0    0    0    5    0    2    0    0   15    0  107    0    0    0    0    0    0    0]
 [   1    0    0    0    0    0    0    0    0    0    0    0    0    0    0    0    0    0    0    0  651    0    0    0    0    0    0]
 [   0    0    0    0    0    0    0    1    0    0    0    0    0    0    0    0    0    0    0    0    0  158    0    0    0    0    0]
 [   1    0    0    0    0    0    0    0    1    0    0    0    0    0    0    0    0    0    0    0    0    0 1493    0    0    0    0]
 [   1    0    0    0    0    0    0    0    0    0    0    0    0    0    0    0    0    0    0    0    0    0    0   12    0    0    0]
 [   0    0    0    0    0    0    0    0    0    0    0    0    0    0    0    0    0    0    0    0    0    0    0    0   17    0    0]
 [   0    0    0    0    0    0    0    1    0    0    0    0    0    0    0    0    0    0    0    0    0    0    0    0    0   42    0]
 [   0    0    0    0    0    0    0    0    0    0    0    0    0    0    0    0    0    0    0    0    0    0    0    0    0    0  122]]

Accuracy: 0.9330813240702901

Precision: [0.9230 0.9944 0.9586 0.9016 1.0000 0.7551 1.0000 0.9969 1.0000 0.9997 0.8322 1.0000 0.5143 1.0000 0.7319 1.0000 1.0000 0.6579 0.9286 0.4698 0.9753 0.9909 0.9948 0.9545 1.0000 1.0000 1.0000]
Mean: 0.9103557202712083
Std: 0.1493629452620307

Recall: [0.9921 0.7617 0.9701 0.8800 1.0000 0.2587 1.0000 0.9141 1.0000 0.9689 0.9118 0.7486 0.4000 0.0215 0.9508 0.9737 0.8095 0.3440 0.5098 0.7500 0.9933 0.9820 0.9991 0.6562 0.5714 1.0000 0.8636]
Mean: 0.786333914705061
Std: 0.2638065880488861

F1 score: [0.9563 0.8627 0.9643 0.8907 1.0000 0.3854 1.0000 0.9537 1.0000 0.9841 0.8702 0.8562 0.4500 0.0421 0.8271 0.9867 0.8947 0.4518 0.6582 0.5777 0.9842 0.9864 0.9970 0.7778 0.7273 1.0000 0.9268]
Mean: 0.8152354241452185
Std: 0.2369812604049935

Cohen Kappa score: 0.9053240677090469
Confusion matrix:
[[9400    1    1    3    0    0    0    2    0    1   25    0    0    0    4    0    0    0    0   29    1    1    6    1    0    0    0]
 [  54  179    0    2    0    0    0    0    0    0    0    0    0    0    0    0    0    0    0    0    0    0    0    0    0    0    0]
 [   5    0  162    0    0    0    0    0    0    0    0    0    0    0    0    0    0    0    0    0    0    0    0    0    0    0    0]
 [  15    0    0  110    0    0    0    0    0    0    0    0    0    0    0    0    0    0    0    0    0    0    0    0    0    0    0]
 [   0    0    0    0   93    0    0    0    0    0    0    0    0    0    0    0    0    0    0    0    0    0    0    0    0    0    0]
 [  23    0    0    2    0   37    0    0    0    0    0    0    8    0   21    0    0    9    1   42    0    0    0    0    0    0    0]
 [   0    0    0    0    0    0  122    0    0    0    0    0    0    0    0    0    0    0    0    0    0    0    0    0    0    0    0]
 [  49    0    1    0    0    0    0  649    0    0    0    0    0    0    0    0    0    0    0    0   11    0    0    0    0    0    0]
 [   0    0    0    0    0    0    0    0  108    0    0    0    0    0    0    0    0    0    0    0    0    0    0    0    0    0    0]
 [ 108    0    0    0    0    0    0    0    0 3363    0    0    0    0    0    0    0    0    0    0    0    0    0    0    0    0    0]
 [  12    0    0    0    0    0    0    0    0    0  124    0    0    0    0    0    0    0    0    0    0    0    0    0    0    0    0]
 [ 360    0    0    0    0    0    0    0    0    0    0 1072    0    0    0    0    0    0    0    0    0    0    0    0    0    0    0]
 [   4    0    0    0    0    0    0    0    0    0    0    0   36    0    0    0    0    1    0   49    0    0    0    0    0    0    0]
 [   7    0    0    0    0    6    0    0    0    0    0    0   11    2    9    0    0    9    0   49    0    0    0    0    0    0    0]
 [   7    0    0    1    0    0    0    0    0    0    0    0    0    0  232    0    0    0    1    3    0    0    0    0    0    0    0]
 [   1    0    0    0    0    0    0    0    0    0    0    0    0    0    0   37    0    0    0    0    0    0    0    0    0    0    0]
 [  33    0    0    3    0    0    0    0    0    0    0    0    0    0    0    0  153    0    0    0    0    0    0    0    0    0    0]
 [  15    0    0    0    0    5    0    0    0    0    0    0   14    0    8    0    0   75    0  101    0    0    0    0    0    0    0]
 [   3    0    0    0    0    1    0    0    0    0    0    0    1    0   36    0    0    1   52    8    0    0    0    0    0    0    0]
 [  51    0    4    0    0    0    0    0    0    0    0    0    0    0    7    0    0   19    2  249    0    0    0    0    0    0    0]
 [   4    0    0    0    0    0    0    0    0    0    0    0    0    0    0    0    0    0    0    0  592    0    0    0    0    0    0]
 [   1    0    0    0    0    0    0    0    0    0    0    0    0    0    0    0    0    0    0    0    1  109    0    0    0    0    0]
 [   0    0    1    0    0    0    0    0    0    0    0    0    0    0    0    0    0    0    0    0    0    0 1150    0    0    0    0]
 [  11    0    0    0    0    0    0    0    0    0    0    0    0    0    0    0    0    0    0    0    0    0    0   21    0    0    0]
 [   8    0    0    1    0    0    0    0    0    0    0    0    0    0    0    0    0    0    0    0    0    0    0    0   12    0    0]
 [   0    0    0    0    0    0    0    0    0    0    0    0    0    0    0    0    0    0    0    0    0    0    0    0    0   32    0]
 [  13    0    0    0    0    0    0    0    0    0    0    0    0    0    0    0    0    0    0    0    2    0    0    0    0    0   95]]

