Classifier: MLPClassifier
Params: {'activation': 'relu', 'alpha': 0.0001, 'batch_size': 'auto', 'beta_1': 0.9, 'beta_2': 0.999, 'early_stopping': False, 'epsilon': 1e-08, 'hidden_layer_sizes': (100,), 'learning_rate': 'constant', 'learning_rate_init': 0.001, 'max_iter': 200, 'momentum': 0.9, 'nesterovs_momentum': True, 'power_t': 0.5, 'random_state': None, 'shuffle': True, 'solver': 'adam', 'tol': 0.0001, 'validation_fraction': 0.1, 'verbose': False, 'warm_start': False}

Labels: None

Training accuracy: 0.9964350324571671
Training confusion matrix:
[[8879    0    0    0    0    0    0    0    0    0    0    0    0    0    0    0    0    0    0    0    0    0    0    0    0    0    0]
 [   0   63    0    0    0    0    0    0    0    0    0    0    0    0    0    0    0    0    0    0    0    0    0    0    0    0    0]
 [   0    0  193    0    0    0    0    0    0    0    0    0    0    0    0    0    0    0    0    0    0    0    0    0    0    0    0]
 [   0    0    0  119    0    0    0    0    0    0    0    0    0    0    0    0    0    0    0    0    0    0    0    0    0    0    0]
 [   0    0    0    0  159    0    0    0    0    0    0    0    0    0    0    0    0    0    0    0    0    0    0    0    0    0    0]
 [   0    0    0    0    0   37    0    0    0    0    0    0    0    0    4    0    0    1    0    7    0    0    0    0    0    0    0]
 [   0    0    0    0    0    0   29    0    0    0    0    0    0    0    0    0    0    0    0    0    0    0    0    0    0    0    0]
 [   0    0    0    0    0    0    0  535    0    0    0    0    0    0    0    0    0    0    0    0    0    0    0    0    0    0    0]
 [   0    0    0    0    0    0    0    0  116    0    0    0    0    0    0    0    0    0    0    0    0    0    0    0    0    0    0]
 [   0    0    0    0    0    0    0    0    0 5081    0    0    0    0    0    0    0    0    0    0    0    0    0    0    0    0    0]
 [   0    0    0    0    0    0    0    0    0    0  133    0    0    0    0    0    0    0    0    0    0    0    0    0    0    0    0]
 [   0    0    0    0    0    0    0    0    0    0    0   45    0    0    0    0    0    0    0    0    0    0    0    0    0    0    0]
 [   0    0    0    0    0    1    0    0    0    0    0    0   35    0    1    0    0    1    0    7    0    0    0    0    0    0    0]
 [   0    0    0    0    0    0    0    0    0    0    0    0    0   10    0    0    0    1    1    3    0    0    0    0    0    0    0]
 [   0    0    0    0    0    0    0    0    0    0    0    0    0    0  151    0    0    0    0    3    0    0    0    0    0    0    0]
 [   0    0    0    0    0    0    0    0    0    0    0    0    0    0    0   30    0    0    0    0    0    0    0    0    0    0    0]
 [   4    0    0    0    0    0    0    0    0    0    0    0    0    0    0    0  320    0    0    0    0    0    0    0    0    0    0]
 [   0    0    0    0    0    0    0    0    0    0    0    0    1    0    1    0    0  118    0   14    0    0    0    0    0    0    0]
 [   0    0    0    0    0    1    0    0    0    0    0    0    0    0    0    0    0    2   47    6    0    0    0    0    0    0    0]
 [   0    0    0    0    0    3    0    0    0    0    0    0    0    0    2    0    0    3    0  126    0    0    0    0    0    0    0]
 [   0    0    0    0    0    0    0    0    0    0    0    0    0    0    0    0    0    0    0    0  652    0    0    0    0    0    0]
 [   0    0    0    0    0    0    0    0    0    0    0    0    0    0    0    0    0    0    0    0    0  159    0    0    0    0    0]
 [   0    0    0    0    0    0    0    0    0    0    0    0    0    0    0    0    0    0    0    0    0    0 1495    0    0    0    0]
 [   0    0    0    0    0    0    0    0    0    0    0    0    0    0    0    0    0    0    0    0    0    0    0   13    0    0    0]
 [   0    0    0    0    0    0    0    0    0    0    0    0    0    0    0    0    0    0    0    0    0    0    0    0   17    0    0]
 [   0    0    0    0    0    0    0    0    0    0    0    0    0    0    0    0    0    0    0    0    0    0    0    0    0   43    0]
 [   0    0    0    0    0    0    0    0    0    0    0    0    0    0    0    0    0    0    0    0    0    0    0    0    0    0  122]]

Accuracy: 0.9417654270535349

Precision: [0.9592 0.9571 0.9581 0.9040 1.0000 0.7500 1.0000 1.0000 1.0000 0.9991 0.3761 1.0000 0.7500 1.0000 0.7806 1.0000 0.9620 0.6230 0.7941 0.4404 0.9833 0.9910 0.9974 0.8750 1.0000 1.0000 0.9541]
Mean: 0.8909095019672402
Std: 0.16917294117506224

Recall: [0.9704 0.9489 0.9581 0.9040 0.9785 0.2937 1.0000 0.9225 1.0000 0.9625 0.9044 0.9818 0.0667 0.0215 0.8893 0.9737 0.8042 0.5229 0.5294 0.7681 0.9899 0.9910 0.9974 0.8750 0.4286 0.9688 0.9455]
Mean: 0.7998871634099936
Std: 0.28404315809088265

F1 score: [0.9648 0.9530 0.9581 0.9040 0.9891 0.4221 1.0000 0.9597 1.0000 0.9805 0.5313 0.9908 0.1224 0.0421 0.8314 0.9867 0.8761 0.5686 0.6353 0.5598 0.9866 0.9910 0.9974 0.8750 0.6000 0.9841 0.9498]
Mean: 0.8022141620931544
Std: 0.26785821743314797

Cohen Kappa score: 0.9191640533593373
Confusion matrix:
[[9195   10    1    6    0    0    0    0    0    3  204    0    0    0    0    0    4    1    0   43    1    0    3    4    0    0    0]
 [  12  223    0    0    0    0    0    0    0    0    0    0    0    0    0    0    0    0    0    0    0    0    0    0    0    0    0]
 [   5    0  160    0    0    0    0    0    0    0    0    0    0    0    0    0    0    0    0    0    1    1    0    0    0    0    0]
 [  12    0    0  113    0    0    0    0    0    0    0    0    0    0    0    0    0    0    0    0    0    0    0    0    0    0    0]
 [   2    0    0    0   91    0    0    0    0    0    0    0    0    0    0    0    0    0    0    0    0    0    0    0    0    0    0]
 [  15    0    0    2    0   42    0    0    0    0    0    0    0    0   10    0    0   16    1   57    0    0    0    0    0    0    0]
 [   0    0    0    0    0    0  122    0    0    0    0    0    0    0    0    0    0    0    0    0    0    0    0    0    0    0    0]
 [  41    0    2    1    0    0    0  655    0    0    0    0    0    0    0    0    0    0    0    0    6    0    0    0    0    0    5]
 [   0    0    0    0    0    0    0    0  108    0    0    0    0    0    0    0    0    0    0    0    0    0    0    0    0    0    0]
 [ 128    0    0    0    0    0    0    0    0 3341    0    0    0    0    0    0    2    0    0    0    0    0    0    0    0    0    0]
 [  13    0    0    0    0    0    0    0    0    0  123    0    0    0    0    0    0    0    0    0    0    0    0    0    0    0    0]
 [  26    0    0    0    0    0    0    0    0    0    0 1406    0    0    0    0    0    0    0    0    0    0    0    0    0    0    0]
 [   1    0    0    0    0    2    0    0    0    0    0    0    6    0    5    0    0   14    1   61    0    0    0    0    0    0    0]
 [   7    0    0    0    0    6    0    0    0    0    0    0    2    2    3    0    0   12    2   59    0    0    0    0    0    0    0]
 [   6    0    0    0    0    0    0    0    0    0    0    0    0    0  217    0    0    1    8   12    0    0    0    0    0    0    0]
 [   1    0    0    0    0    0    0    0    0    0    0    0    0    0    0   37    0    0    0    0    0    0    0    0    0    0    0]
 [  36    0    0    1    0    0    0    0    0    0    0    0    0    0    0    0  152    0    0    0    0    0    0    0    0    0    0]
 [  17    0    0    0    0    2    0    0    0    0    0    0    0    0    0    0    0  114    0   85    0    0    0    0    0    0    0]
 [   2    0    0    0    0    1    0    0    0    0    0    0    0    0   36    0    0    2   54    7    0    0    0    0    0    0    0]
 [  40    0    2    0    0    3    0    0    0    0    0    0    0    0    7    0    0   23    2  255    0    0    0    0    0    0    0]
 [   6    0    0    0    0    0    0    0    0    0    0    0    0    0    0    0    0    0    0    0  590    0    0    0    0    0    0]
 [   1    0    0    0    0    0    0    0    0    0    0    0    0    0    0    0    0    0    0    0    0  110    0    0    0    0    0]
 [   1    0    2    0    0    0    0    0    0    0    0    0    0    0    0    0    0    0    0    0    0    0 1148    0    0    0    0]
 [   3    0    0    1    0    0    0    0    0    0    0    0    0    0    0    0    0    0    0    0    0    0    0   28    0    0    0]
 [  11    0    0    1    0    0    0    0    0    0    0    0    0    0    0    0    0    0    0    0    0    0    0    0    9    0    0]
 [   1    0    0    0    0    0    0    0    0    0    0    0    0    0    0    0    0    0    0    0    0    0    0    0    0   31    0]
 [   4    0    0    0    0    0    0    0    0    0    0    0    0    0    0    0    0    0    0    0    2    0    0    0    0    0  104]]

