Classifier: MultinomialNB
Params: {'alpha': 1.0, 'class_prior': None, 'fit_prior': True}

Labels: None

Training accuracy: 0.9166755347451314
Training confusion matrix:
[[8423    1    8   15    3    0    0  214    0   29   45    4    0    0   13    0    2   79    2    0   29    1    9    0    0    0    2]
 [  23   40    0    0    0    0    0    0    0    0    0    0    0    0    0    0    0    0    0    0    0    0    0    0    0    0    0]
 [   3    1  158    0   12    0    0   16    0    0    0    0    0    0    0    0    0    0    0    0    3    0    0    0    0    0    0]
 [  60    0    0   49    0    0    0    0    0    0    0    0    0    0    0    0    4    0    0    0    0    0    6    0    0    0    0]
 [   1    0    0    0  155    0    0    0    0    0    0    0    0    0    0    0    0    0    0    0    1    0    2    0    0    0    0]
 [   1    0    0    0    0    0    0    0    0    0    0    0    0    0    0    0    0    0    0   48    0    0    0    0    0    0    0]
 [   0    0    0    0    4    0    4    1    0    0    0    0    0    0    0    0    8    0    0    0    0    0   12    0    0    0    0]
 [   5    0    0    0    4    0    0  524    0    0    0    0    0    0    0    0    0    0    0    0    2    0    0    0    0    0    0]
 [   1    0    0    0    0    0    0    0  113    0    0    0    0    0    0    0    0    0    0    0    0    0    2    0    0    0    0]
 [ 393    0    0    0    0    0    0    1    0 4684    1    0    0    0    1    0    1    0    0    0    0    0    0    0    0    0    0]
 [  24    0    0    0    0    0    0    0    0    0  109    0    0    0    0    0    0    0    0    0    0    0    0    0    0    0    0]
 [  21    0    0    0    0    0    0    0    0    0    0   24    0    0    0    0    0    0    0    0    0    0    0    0    0    0    0]
 [   2    0    0    0    0    0    0    0    0    0    0    0    0    0    0    0    0    0    0   43    0    0    0    0    0    0    0]
 [   0    0    0    0    0    0    0    0    0    0    0    0    0    0    0    0    0    0    0   15    0    0    0    0    0    0    0]
 [  22    0    0    0    0    0    0    1    0    0    0    0    0    0   90    0    0   12    0   25    2    0    2    0    0    0    0]
 [   0    0    1    0    3    0    0    0    0    0    0    0    0    0    0    7    9    0    0    0    0    0   10    0    0    0    0]
 [  29    0    0    0    2    0    0    0    0    0    0    0    0    0    0    0  293    0    0    0    0    0    0    0    0    0    0]
 [  12    0    0    0    0    0    0    0    0    0    0    0    0    0    1    0    0   68    0   53    0    0    0    0    0    0    0]
 [   9    0    0    0    0    0    0    0    0    0    0    0    0    0    1    0    0   11    6   29    0    0    0    0    0    0    0]
 [   4    0    0    0    0    0    0    1    0    0    0    0    0    0    2    0    0   10    0  111    1    0    5    0    0    0    0]
 [   5    0    0    0    0    0    0    8    0    0    0    0    0    0    0    0    0    0    0    0  639    0    0    0    0    0    0]
 [   1    0    0    0    0    0    0   10    0    0    0    0    0    0    0    0    0    0    0    0   37  110    1    0    0    0    0]
 [   4    0    0    0    2    0    0    0    1    0    0    0    0    0    0    0    0    0    0    0    0    0 1488    0    0    0    0]
 [  10    0    0    2    1    0    0    0    0    0    0    0    0    0    0    0    0    0    0    0    0    0    0    0    0    0    0]
 [  12    0    0    0    0    0    0    0    0    0    0    0    0    0    0    0    0    0    0    0    0    0    0    0    5    0    0]
 [   0    0    1    0    6    0    0   15    0    0    0    0    0    0    0    0    1    0    0    0    5    0    4    0    0   11    0]
 [   0    0    0    0    1    0    0    3    0    0    0    0    0    0    0    0    0    0    0    0    1    0    0    0    0    0  117]]

Accuracy: 0.7839701675521046

Precision: [0.7638 0.8462 0.8462 0.7593 0.4767 0.0000 0.0000 0.8687 1.0000 0.9971 0.3046 0.0000 0.0000 0.0000 0.6403 1.0000 0.5216 0.4839 0.0000 0.3004 0.8567 1.0000 0.8770 0.0000 1.0000 1.0000 0.9861]
Mean: 0.5751220524032753
Std: 0.39495759451256723

Recall: [0.9640 0.0468 0.4611 0.6560 0.9892 0.0000 0.0000 0.9408 0.9352 0.7911 0.4412 0.0000 0.0000 0.0000 0.3648 0.0789 0.7037 0.0688 0.0000 0.7319 0.9933 0.6577 0.9974 0.0000 0.1429 0.1875 0.6455]
Mean: 0.4369544130275083
Std: 0.3867850955230283

F1 score: [0.8523 0.0887 0.5969 0.7039 0.6434 0.0000 0.0000 0.9033 0.9665 0.8822 0.3604 0.0000 0.0000 0.0000 0.4648 0.1463 0.5991 0.1205 0.0000 0.4259 0.9200 0.7935 0.9333 0.0000 0.2500 0.3158 0.7802]
Mean: 0.43507240425183497
Std: 0.357861224450687

Cohen Kappa score: 0.6784017700458926
Confusion matrix:
[[9134    2    0   25    6    0    0   29    0    8  137    0    0    0   11    0   59   13    0   33    9    0    8    0    0    0    1]
 [ 182   11    0    0    0    0    0    1    0    0    0    0    0    0    0    0   41    0    0    0    0    0    0    0    0    0    0]
 [   3    0   77    0   25    0    0   17    0    0    0    0    0    0    0    0    0    0    0    0   34    0   11    0    0    0    0]
 [  23    0    0   82    0    0    0    0    0    0    0    0    0    0    0    0   14    0    0    0    0    0    6    0    0    0    0]
 [   0    0    0    0   92    0    0    0    0    0    0    0    0    0    0    0    0    0    0    0    0    0    1    0    0    0    0]
 [   6    0    0    0    0    0    0    0    0    0    0    0    0    0   14    0    0    0    0  121    0    0    2    0    0    0    0]
 [   0    0    0    0   13    0    0   20    0    0    0    0    0    0    0    0    4    0    0    0    0    0   85    0    0    0    0]
 [  12    0    2    0   10    0    0  668    0    0    0    0    0    0    0    0    0    0    0    0   14    0    4    0    0    0    0]
 [   0    0    0    0    0    0    0    1  101    0    0    0    0    0    0    0    0    0    0    0    0    0    6    0    0    0    0]
 [ 691    0    0    0    0    0    0    2    0 2746    0    0    0    0    7    0    3    0    0    0    0    0   22    0    0    0    0]
 [  76    0    0    0    0    0    0    0    0    0   60    0    0    0    0    0    0    0    0    0    0    0    0    0    0    0    0]
 [1432    0    0    0    0    0    0    0    0    0    0    0    0    0    0    0    0    0    0    0    0    0    0    0    0    0    0]
 [   3    0    0    0    0    0    0    0    0    0    0    0    0    0    1    0    0    0    0   86    0    0    0    0    0    0    0]
 [  11    0    0    0    0    0    0    0    0    0    0    0    0    0    1    0    0    0    0   81    0    0    0    0    0    0    0]
 [ 118    0    0    0    0    0    0    0    0    0    0    0    0    0   89    0    0    2    0   33    1    0    1    0    0    0    0]
 [   1    0    0    0   34    0    0    0    0    0    0    0    0    0    0    3    0    0    0    0    0    0    0    0    0    0    0]
 [  52    0    0    0    3    0    0    0    0    0    0    0    0    0    0    0  133    0    0    0    0    0    1    0    0    0    0]
 [  28    0    0    0    0    0    0    0    0    0    0    0    0    0    0    0    0   15    0  175    0    0    0    0    0    0    0]
 [  58    0    0    0    0    0    0    0    0    0    0    0    0    0    6    0    0    1    0   37    0    0    0    0    0    0    0]
 [  67    0    0    1    0    0    0    1    0    0    0    0    0    0   10    0    0    0    0  243    7    0    3    0    0    0    0]
 [   1    0    0    0    0    0    0    0    0    0    0    0    0    0    0    0    0    0    0    0  592    0    3    0    0    0    0]
 [   0    0    0    0    0    0    0    6    0    0    0    0    0    0    0    0    1    0    0    0   28   73    3    0    0    0    0]
 [   0    0    0    0    3    0    0    0    0    0    0    0    0    0    0    0    0    0    0    0    0    0 1148    0    0    0    0]
 [  32    0    0    0    0    0    0    0    0    0    0    0    0    0    0    0    0    0    0    0    0    0    0    0    0    0    0]
 [  18    0    0    0    0    0    0    0    0    0    0    0    0    0    0    0    0    0    0    0    0    0    0    0    3    0    0]
 [   0    0    0    0    2    0    0   19    0    0    0    0    0    0    0    0    0    0    0    0    0    0    5    0    0    6    0]
 [  11    0   12    0    5    0    0    5    0    0    0    0    0    0    0    0    0    0    0    0    6    0    0    0    0    0   71]]

