Classifier: LogisticRegression
Params: {'C': 1.0, 'class_weight': None, 'dual': False, 'fit_intercept': True, 'intercept_scaling': 1, 'max_iter': 100, 'multi_class': 'multinomial', 'n_jobs': 1, 'penalty': 'l2', 'random_state': None, 'solver': 'newton-cg', 'tol': 0.0001, 'verbose': 0, 'warm_start': False}

Labels: None

Training accuracy: 0.989705499087829
Training confusion matrix:
[[14677     1     1     4     0     0     0     5     0     0     0     0     0     0     0     0     5     0     0     0     0     1     1     1     2     0     0]
 [    1   242     0     0     0     0     0     0     0     0     0     0     0     0     0     0     0     0     0     0     0     0     0     0     0     0     0]
 [    2     0   288     0     0     0     0     0     0     0     0     0     0     0     0     0     0     0     0     0     0     0     0     0     0     0     0]
 [    2     0     0   195     0     0     0     0     0     0     0     0     0     0     0     0     0     0     0     0     0     0     0     0     0     0     0]
 [    0     0     0     0   207     0     0     0     0     0     0     0     0     0     0     0     0     0     0     0     0     0     0     0     0     0     0]
 [    0     0     0     0     0    95     0     0     0     0     0     0     6     2     2     0     0     3     3    29     0     0     0     0     0     0     0]
 [    0     0     0     0     0     0   127     0     0     0     0     0     0     0     0     0     0     0     0     0     0     0     0     0     0     0     0]
 [    0     0     0     0     0     0     0   970     0     0     0     0     0     0     0     0     0     0     0     0     3     0     0     0     0     0     0]
 [    0     0     0     0     0     0     0     0   185     0     0     0     0     0     0     0     0     0     0     0     0     0     0     0     0     0     0]
 [    1     0     0     0     0     0     0     0     0  6864     0     0     0     0     0     0     0     0     0     0     0     0     0     0     0     0     0]
 [    0     0     0     0     0     0     0     0     0     0   216     0     0     0     0     0     0     0     0     0     0     0     0     0     0     0     0]
 [    0     0     0     0     0     0     0     0     0     0     0  1188     0     0     0     0     0     0     0     0     0     0     0     0     0     0     0]
 [    0     0     0     0     0     0     0     0     0     0     0     0    82     6     0     0     0     4     1    12     0     0     0     0     0     0     0]
 [    0     0     0     0     0     3     0     0     0     0     0     0     5    65     0     0     0     3     0    11     0     0     0     0     0     0     0]
 [    0     0     0     0     0     2     0     0     0     0     0     0     1     1   304     0     0     0     6     7     0     0     0     0     0     0     0]
 [    1     0     0     0     0     0     0     0     0     0     0     0     0     0     0    51     0     0     0     0     0     0     0     0     0     0     0]
 [    1     0     0     0     0     0     0     0     0     0     0     0     0     0     0     0   406     0     0     0     0     0     0     0     0     0     0]
 [    0     0     0     0     0    10     0     0     0     0     0     0    11     8     0     0     0   215     0    39     0     0     0     0     0     0     0]
 [    0     0     0     0     0     3     0     0     0     0     0     0     2     1    12     0     0     0    93    10     0     0     0     0     0     0     0]
 [    0     0     0     0     0     6     0     0     0     0     0     0    18     7     4     0     0    36     2   298     0     0     0     0     0     0     0]
 [    3     0     0     0     0     0     0     0     0     0     0     0     0     0     0     0     0     0     0     0  1000     0     0     0     0     0     0]
 [    1     0     0     0     0     0     0     0     0     0     0     0     0     0     0     0     0     0     0     0     0   210     0     0     0     0     0]
 [    0     0     0     0     0     0     0     0     0     0     0     0     0     0     0     0     0     0     0     0     0     0  2092     0     0     0     0]
 [    1     0     0     0     0     0     0     0     0     1     0     0     0     0     0     0     0     0     0     0     0     0     0    32     0     0     0]
 [    1     0     0     0     0     0     0     0     0     0     0     0     0     0     0     0     0     0     0     0     0     0     0     0    29     0     0]
 [    0     0     0     0     0     0     0     1     0     0     0     0     0     0     0     0     0     0     0     0     0     0     0     0     0    60     0]
 [    0     0     0     0     0     0     0     0     0     0     0     0     0     0     0     0     0     0     0     0     0     0     0     0     0     0   189]]

Accuracy: 0.9790200677612718

Precision: [0.9932 0.9298 1.0000 0.9184 1.0000 0.7568 1.0000 1.0000 0.9750 0.9988 0.9811 1.0000 0.5526 0.5500 0.8421 1.0000 0.9904 0.7183 0.6923 0.6422 0.9879 0.9365 1.0000 1.0000 0.8750 1.0000 0.9773]
Mean: 0.9006535707945723
Std: 0.143414432617025

Recall: [0.9954 0.9636 0.9714 0.9574 1.0000 0.5385 1.0000 0.9779 1.0000 0.9976 0.9811 1.0000 0.7000 0.5238 0.8312 1.0000 0.9717 0.7391 0.4865 0.7368 0.9959 1.0000 0.9964 0.9091 0.8750 0.9286 1.0000]
Mean: 0.8917456171074917
Std: 0.1584073925138661

F1 score: [0.9943 0.9464 0.9855 0.9375 1.0000 0.6292 1.0000 0.9888 0.9873 0.9982 0.9811 1.0000 0.6176 0.5366 0.8366 1.0000 0.9810 0.7286 0.5714 0.6863 0.9919 0.9672 0.9982 0.9524 0.8750 0.9630 0.9885]
Mean: 0.894171802524155
Std: 0.1499476903631131

Cohen Kappa score: 0.9706319020784819
Confusion matrix:
[[3639    4    0    4    0    0    0    0    0    1    1    0    0    0    1    0    1    0    0    0    2    2    0    0    0    0    1]
 [   2   53    0    0    0    0    0    0    0    0    0    0    0    0    0    0    0    0    0    0    0    0    0    0    0    0    0]
 [   2    0   68    0    0    0    0    0    0    0    0    0    0    0    0    0    0    0    0    0    0    0    0    0    0    0    0]
 [   2    0    0   45    0    0    0    0    0    0    0    0    0    0    0    0    0    0    0    0    0    0    0    0    0    0    0]
 [   0    0    0    0   45    0    0    0    0    0    0    0    0    0    0    0    0    0    0    0    0    0    0    0    0    0    0]
 [   0    0    0    0    0   28    0    0    0    0    0    0    4    2    3    0    0    0    1   14    0    0    0    0    0    0    0]
 [   0    0    0    0    0    0   24    0    0    0    0    0    0    0    0    0    0    0    0    0    0    0    0    0    0    0    0]
 [   3    0    0    0    0    0    0  266    0    0    0    0    0    0    0    0    0    0    0    0    1    2    0    0    0    0    0]
 [   0    0    0    0    0    0    0    0   39    0    0    0    0    0    0    0    0    0    0    0    0    0    0    0    0    0    0]
 [   4    0    0    0    0    0    0    0    0 1683    0    0    0    0    0    0    0    0    0    0    0    0    0    0    0    0    0]
 [   1    0    0    0    0    0    0    0    0    0   52    0    0    0    0    0    0    0    0    0    0    0    0    0    0    0    0]
 [   0    0    0    0    0    0    0    0    0    0    0  289    0    0    0    0    0    0    0    0    0    0    0    0    0    0    0]
 [   1    0    0    0    0    1    0    0    0    0    0    0   21    1    0    0    0    3    0    3    0    0    0    0    0    0    0]
 [   0    0    0    0    0    3    0    0    0    0    0    0    1   11    1    0    0    0    0    5    0    0    0    0    0    0    0]
 [   3    0    0    0    0    0    0    0    0    0    0    0    1    1   64    0    0    1    7    0    0    0    0    0    0    0    0]
 [   0    0    0    0    0    0    0    0    0    0    0    0    0    0    0   16    0    0    0    0    0    0    0    0    0    0    0]
 [   2    0    0    0    0    0    0    0    0    0    0    0    0    0    0    0  103    0    0    0    0    0    0    0    1    0    0]
 [   0    0    0    0    0    1    0    0    0    0    0    0    2    2    0    0    0   51    0   13    0    0    0    0    0    0    0]
 [   1    0    0    0    0    1    0    0    0    0    0    0    1    1    7    0    0    4   18    4    0    0    0    0    0    0    0]
 [   0    0    0    0    0    3    0    0    0    0    0    0    8    2    0    0    0   12    0   70    0    0    0    0    0    0    0]
 [   1    0    0    0    0    0    0    0    0    0    0    0    0    0    0    0    0    0    0    0  244    0    0    0    0    0    0]
 [   0    0    0    0    0    0    0    0    0    0    0    0    0    0    0    0    0    0    0    0    0   59    0    0    0    0    0]
 [   1    0    0    0    0    0    0    0    1    0    0    0    0    0    0    0    0    0    0    0    0    0  552    0    0    0    0]
 [   0    0    0    0    0    0    0    0    0    1    0    0    0    0    0    0    0    0    0    0    0    0    0   10    0    0    0]
 [   1    0    0    0    0    0    0    0    0    0    0    0    0    0    0    0    0    0    0    0    0    0    0    0    7    0    0]
 [   1    0    0    0    0    0    0    0    0    0    0    0    0    0    0    0    0    0    0    0    0    0    0    0    0   13    0]
 [   0    0    0    0    0    0    0    0    0    0    0    0    0    0    0    0    0    0    0    0    0    0    0    0    0    0   43]]

