Classifier: LinearSVC
Params: {'C': 1.0, 'class_weight': None, 'dual': False, 'fit_intercept': True, 'intercept_scaling': 1, 'loss': 'squared_hinge', 'max_iter': 1000, 'multi_class': 'ovr', 'penalty': 'l1', 'random_state': None, 'tol': 0.0001, 'verbose': 0}

Labels: None

Training accuracy: 0.9899009642950222
Training confusion matrix:
[[14665     0     1     6     0     0     0     3     0     0     0     0     0     0     1     0     5     0     0     0     0     0     1     1     1     0     1]
 [    0   236     0     0     0     0     0     0     0     0     0     0     0     0     0     0     0     0     0     0     0     0     0     0     0     0     0]
 [    2     0   278     0     0     0     0     0     0     0     0     0     0     0     0     0     0     0     0     0     0     0     0     0     0     0     0]
 [    2     0     0   198     0     0     0     0     0     0     0     0     0     0     0     0     0     0     0     0     0     0     0     0     0     0     0]
 [    0     0     0     0   210     0     0     0     0     0     0     0     0     0     0     0     0     0     0     0     0     0     0     0     0     0     0]
 [    0     0     0     0     0   108     0     0     0     0     0     0     7     4     4     0     0     2     5    22     0     0     0     0     0     0     0]
 [    0     0     0     0     0     0   117     0     0     0     0     0     0     0     0     0     0     0     0     0     0     0     0     0     0     0     0]
 [    1     0     0     0     0     0     0   996     0     0     0     0     0     0     0     0     0     0     0     0     0     0     0     0     0     0     0]
 [    0     0     0     0     0     0     0     0   181     0     0     0     0     0     0     0     0     0     0     0     0     0     0     0     0     0     0]
 [    0     0     0     0     0     0     0     0     0  6813     0     0     0     0     0     0     0     0     0     0     0     0     0     0     0     0     0]
 [    0     0     0     0     0     0     0     0     0     0   215     0     0     0     0     0     0     0     0     0     0     0     0     0     0     0     0]
 [    0     0     0     0     0     0     0     0     0     0     0  1198     0     0     0     0     0     0     0     0     0     0     0     0     0     0     0]
 [    0     0     0     0     0     3     0     0     0     0     0     0    92     6     0     0     0     5     0     4     0     0     0     0     0     0     0]
 [    0     0     0     0     0     2     0     0     0     0     0     0     1    76     1     0     0     2     0     4     0     0     0     0     0     0     0]
 [    1     0     0     0     0     0     0     0     0     0     0     0     1     2   293     0     0     1     7     3     0     0     0     0     0     0     0]
 [    0     0     0     0     0     0     0     0     0     0     0     0     0     0     0    54     0     0     0     0     0     0     0     0     0     0     0]
 [    3     0     0     0     0     0     0     0     0     0     0     0     0     0     0     0   421     0     0     0     0     0     0     0     0     0     0]
 [    0     0     0     0     0    12     0     0     0     0     0     0    15     7     1     0     0   221     1    21     0     0     0     0     0     0     0]
 [    0     0     0     0     0     0     0     0     0     0     0     0     2     1    13     0     0     4   103     6     0     0     0     0     0     0     0]
 [    1     0     0     0     0    14     0     0     0     0     0     0    33    10     3     0     0    46     3   245     0     0     0     0     0     0     0]
 [    1     0     0     0     0     0     0     1     0     0     0     0     0     0     0     0     0     0     0     0  1011     0     0     0     0     0     0]
 [    0     0     0     0     0     0     0     0     0     0     0     0     0     0     0     0     0     0     0     0     0   217     0     0     0     0     0]
 [    0     0     0     0     0     0     0     0     0     0     0     0     0     0     0     0     0     0     0     0     0     0  2111     0     0     0     0]
 [    0     0     0     0     0     0     0     0     0     0     0     0     0     0     0     0     0     0     0     0     0     0     0    36     0     0     0]
 [    0     0     0     0     0     0     0     0     0     0     0     0     0     0     0     0     0     0     0     0     0     0     0     0    33     0     0]
 [    0     0     0     0     0     0     0     0     0     0     0     0     0     0     0     0     0     0     0     0     0     0     0     0     0    56     0]
 [    0     0     0     0     0     0     0     0     0     0     0     0     0     0     0     0     0     0     0     0     0     0     0     0     0     0   202]]

Accuracy: 0.9818868908001043

Precision: [0.9943 1.0000 0.9875 1.0000 1.0000 0.6571 1.0000 0.9879 1.0000 0.9994 1.0000 1.0000 0.5263 0.5455 0.8913 1.0000 0.9889 0.7742 0.7097 0.6907 1.0000 1.0000 0.9963 0.9000 1.0000 1.0000 0.9677]
Mean: 0.9117346401965795
Std: 0.1481297498627864

Recall: [0.9981 0.9516 0.9875 0.9545 1.0000 0.5750 1.0000 0.9879 0.9767 0.9983 0.9815 1.0000 0.8000 0.8182 0.9111 0.9286 1.0000 0.6486 0.7586 0.6036 0.9872 0.9811 0.9981 1.0000 1.0000 0.9474 1.0000]
Mean: 0.918287293514301
Std: 0.12680443075382392

F1 score: [0.9962 0.9752 0.9875 0.9767 1.0000 0.6133 1.0000 0.9879 0.9882 0.9988 0.9907 1.0000 0.6349 0.6545 0.9011 0.9630 0.9944 0.7059 0.7333 0.6442 0.9936 0.9905 0.9972 0.9474 1.0000 0.9730 0.9836]
Mean: 0.9122668324601787
Std: 0.13544059812814171

Cohen Kappa score: 0.9744913520315668
Confusion matrix:
[[3662    0    0    0    0    0    0    3    0    1    0    0    0    0    0    0    1    0    0    0    0    0    1    1    0    0    0]
 [   3   59    0    0    0    0    0    0    0    0    0    0    0    0    0    0    0    0    0    0    0    0    0    0    0    0    0]
 [   1    0   79    0    0    0    0    0    0    0    0    0    0    0    0    0    0    0    0    0    0    0    0    0    0    0    0]
 [   2    0    0   42    0    0    0    0    0    0    0    0    0    0    0    0    0    0    0    0    0    0    0    0    0    0    0]
 [   0    0    0    0   42    0    0    0    0    0    0    0    0    0    0    0    0    0    0    0    0    0    0    0    0    0    0]
 [   0    0    0    0    0   23    0    0    0    0    0    0    3    3    4    0    0    0    2    5    0    0    0    0    0    0    0]
 [   0    0    0    0    0    0   34    0    0    0    0    0    0    0    0    0    0    0    0    0    0    0    0    0    0    0    0]
 [   2    0    1    0    0    0    0  245    0    0    0    0    0    0    0    0    0    0    0    0    0    0    0    0    0    0    0]
 [   0    0    0    0    0    0    0    0   42    0    0    0    0    0    0    0    0    0    0    0    0    0    1    0    0    0    0]
 [   3    0    0    0    0    0    0    0    0 1736    0    0    0    0    0    0    0    0    0    0    0    0    0    0    0    0    0]
 [   1    0    0    0    0    0    0    0    0    0   53    0    0    0    0    0    0    0    0    0    0    0    0    0    0    0    0]
 [   0    0    0    0    0    0    0    0    0    0    0  279    0    0    0    0    0    0    0    0    0    0    0    0    0    0    0]
 [   0    0    0    0    0    1    0    0    0    0    0    0   20    3    0    0    0    1    0    0    0    0    0    0    0    0    0]
 [   0    0    0    0    0    0    0    0    0    0    0    0    1   18    0    0    0    1    0    2    0    0    0    0    0    0    0]
 [   1    0    0    0    0    0    0    0    0    0    0    0    1    0   82    0    0    0    3    3    0    0    0    0    0    0    0]
 [   1    0    0    0    0    0    0    0    0    0    0    0    0    0    0   13    0    0    0    0    0    0    0    0    0    0    0]
 [   0    0    0    0    0    0    0    0    0    0    0    0    0    0    0    0   89    0    0    0    0    0    0    0    0    0    0]
 [   0    0    0    0    0    1    0    0    0    0    0    0    2    4    0    0    0   48    1   18    0    0    0    0    0    0    0]
 [   0    0    0    0    0    1    0    0    0    0    0    0    0    1    2    0    0    1   22    2    0    0    0    0    0    0    0]
 [   2    0    0    0    0    9    0    0    0    0    0    0   11    4    4    0    0   11    3   67    0    0    0    0    0    0    0]
 [   2    0    0    0    0    0    0    0    0    0    0    0    0    0    0    0    0    0    0    0  232    0    0    0    0    0    1]
 [   1    0    0    0    0    0    0    0    0    0    0    0    0    0    0    0    0    0    0    0    0   52    0    0    0    0    0]
 [   1    0    0    0    0    0    0    0    0    0    0    0    0    0    0    0    0    0    0    0    0    0  534    0    0    0    0]
 [   0    0    0    0    0    0    0    0    0    0    0    0    0    0    0    0    0    0    0    0    0    0    0    9    0    0    0]
 [   0    0    0    0    0    0    0    0    0    0    0    0    0    0    0    0    0    0    0    0    0    0    0    0    5    0    0]
 [   1    0    0    0    0    0    0    0    0    0    0    0    0    0    0    0    0    0    0    0    0    0    0    0    0   18    0]
 [   0    0    0    0    0    0    0    0    0    0    0    0    0    0    0    0    0    0    0    0    0    0    0    0    0    0   30]]

