Classifier: LogisticRegression
Params: {'C': 1.0, 'class_weight': None, 'dual': False, 'fit_intercept': True, 'intercept_scaling': 1, 'max_iter': 100, 'multi_class': 'ovr', 'n_jobs': 1, 'penalty': 'l1', 'random_state': None, 'solver': 'liblinear', 'tol': 0.0001, 'verbose': 0, 'warm_start': False}

Labels: None

Training accuracy: 0.9870341412561897
Training confusion matrix:
[[14641     5     3     6     1     0     0     5     0     1     1     0     0     0     3     0     8     0     0     0     2     3     3     0     2     0     1]
 [    2   234     0     0     0     0     0     0     0     0     0     0     0     0     0     0     0     0     0     0     0     0     0     0     0     0     0]
 [    2     0   278     0     0     0     0     0     0     0     0     0     0     0     0     0     0     0     0     0     0     0     0     0     0     0     0]
 [    6     0     0   194     0     0     0     0     0     0     0     0     0     0     0     0     0     0     0     0     0     0     0     0     0     0     0]
 [    3     0     0     0   207     0     0     0     0     0     0     0     0     0     0     0     0     0     0     0     0     0     0     0     0     0     0]
 [    0     0     0     0     0   108     0     0     0     0     0     0     6     5     5     0     0     2     3    23     0     0     0     0     0     0     0]
 [    0     0     0     0     0     0   117     0     0     0     0     0     0     0     0     0     0     0     0     0     0     0     0     0     0     0     0]
 [    3     0     0     0     0     0     0   991     0     0     0     0     0     0     0     0     0     0     0     0     3     0     0     0     0     0     0]
 [    0     0     0     0     0     0     0     0   181     0     0     0     0     0     0     0     0     0     0     0     0     0     0     0     0     0     0]
 [    6     0     0     0     0     0     0     0     0  6807     0     0     0     0     0     0     0     0     0     0     0     0     0     0     0     0     0]
 [    3     0     0     0     0     0     0     0     0     0   212     0     0     0     0     0     0     0     0     0     0     0     0     0     0     0     0]
 [    0     0     0     0     0     0     0     0     0     1     0  1197     0     0     0     0     0     0     0     0     0     0     0     0     0     0     0]
 [    0     0     0     0     0     3     0     0     0     0     0     0    90     6     0     0     0     5     1     5     0     0     0     0     0     0     0]
 [    0     0     0     0     0     1     0     0     0     0     0     0     2    74     1     0     0     2     1     5     0     0     0     0     0     0     0]
 [    4     0     0     0     0     1     0     0     0     0     0     0     1     2   290     0     0     1     6     3     0     0     0     0     0     0     0]
 [    0     0     0     0     0     0     0     0     0     0     0     0     0     0     0    54     0     0     0     0     0     0     0     0     0     0     0]
 [    4     0     0     0     0     0     0     0     0     0     0     0     0     0     0     0   419     0     0     0     0     0     0     0     1     0     0]
 [    1     0     0     0     0    13     0     0     0     0     0     0    15     7     3     0     0   214     1    24     0     0     0     0     0     0     0]
 [    2     0     0     0     0     2     0     0     0     0     0     0     1     1    17     0     0     3    95     8     0     0     0     0     0     0     0]
 [    0     0     0     0     0    16     0     0     0     0     0     0    33    11     4     0     0    48     4   239     0     0     0     0     0     0     0]
 [    4     0     0     0     0     0     0     0     0     0     0     0     0     0     0     0     0     0     0     0  1009     0     0     0     0     0     0]
 [    1     0     0     0     0     0     0     1     0     0     0     0     0     0     0     0     0     0     0     0     0   215     0     0     0     0     0]
 [    1     0     0     0     0     0     0     0     1     0     0     0     0     0     0     0     0     0     0     0     0     0  2109     0     0     0     0]
 [    1     0     0     0     0     0     0     0     0     0     0     0     0     0     0     0     0     0     0     0     0     0     0    35     0     0     0]
 [    1     0     0     1     0     0     0     0     0     0     0     0     0     0     0     0     0     0     0     0     0     0     0     0    31     0     0]
 [    0     0     0     0     0     0     0     1     0     0     0     0     0     0     0     0     0     0     0     0     0     0     0     0     0    55     0]
 [    0     0     0     0     0     0     0     0     0     0     0     0     0     0     0     0     0     0     0     0     0     0     0     0     0     0   202]]

Accuracy: 0.9807140995569456

Precision: [0.9932 1.0000 0.9875 0.9767 1.0000 0.6053 1.0000 0.9880 1.0000 0.9983 1.0000 1.0000 0.4737 0.5769 0.8989 1.0000 0.9889 0.8136 0.7241 0.6636 1.0000 1.0000 0.9963 0.9000 1.0000 1.0000 0.9677]
Mean: 0.9093548369128063
Std: 0.15351748541383253

Recall: [0.9975 0.9516 0.9875 0.9545 1.0000 0.5750 1.0000 0.9919 1.0000 0.9977 0.9815 0.9857 0.7200 0.6818 0.8889 0.9286 1.0000 0.6486 0.7241 0.6396 0.9872 0.9811 0.9981 1.0000 1.0000 0.9474 1.0000]
Mean: 0.9099464943475518
Std: 0.13562483193522074

F1 score: [0.9954 0.9752 0.9875 0.9655 1.0000 0.5897 1.0000 0.9899 1.0000 0.9980 0.9907 0.9928 0.5714 0.6250 0.8939 0.9630 0.9944 0.7218 0.7241 0.6514 0.9936 0.9905 0.9972 0.9474 1.0000 0.9730 0.9836]
Mean: 0.9079585860727588
Std: 0.14372185222871903

Cohen Kappa score: 0.972833981776615
Confusion matrix:
[[3660    0    0    1    0    0    0    3    0    1    0    0    0    0    0    0    1    0    0    1    0    0    1    1    0    0    0]
 [   3   59    0    0    0    0    0    0    0    0    0    0    0    0    0    0    0    0    0    0    0    0    0    0    0    0    0]
 [   1    0   79    0    0    0    0    0    0    0    0    0    0    0    0    0    0    0    0    0    0    0    0    0    0    0    0]
 [   2    0    0   42    0    0    0    0    0    0    0    0    0    0    0    0    0    0    0    0    0    0    0    0    0    0    0]
 [   0    0    0    0   42    0    0    0    0    0    0    0    0    0    0    0    0    0    0    0    0    0    0    0    0    0    0]
 [   0    0    0    0    0   23    0    0    0    0    0    0    3    3    4    0    0    0    1    6    0    0    0    0    0    0    0]
 [   0    0    0    0    0    0   34    0    0    0    0    0    0    0    0    0    0    0    0    0    0    0    0    0    0    0    0]
 [   1    0    1    0    0    0    0  246    0    0    0    0    0    0    0    0    0    0    0    0    0    0    0    0    0    0    0]
 [   0    0    0    0    0    0    0    0   43    0    0    0    0    0    0    0    0    0    0    0    0    0    0    0    0    0    0]
 [   4    0    0    0    0    0    0    0    0 1735    0    0    0    0    0    0    0    0    0    0    0    0    0    0    0    0    0]
 [   1    0    0    0    0    0    0    0    0    0   53    0    0    0    0    0    0    0    0    0    0    0    0    0    0    0    0]
 [   2    0    0    0    0    0    0    0    0    2    0  275    0    0    0    0    0    0    0    0    0    0    0    0    0    0    0]
 [   1    0    0    0    0    2    0    0    0    0    0    0   18    2    0    0    0    1    0    1    0    0    0    0    0    0    0]
 [   0    0    0    0    0    0    0    0    0    0    0    0    2   15    0    0    0    1    1    3    0    0    0    0    0    0    0]
 [   2    0    0    0    0    0    0    0    0    0    0    0    1    0   80    0    0    0    4    3    0    0    0    0    0    0    0]
 [   1    0    0    0    0    0    0    0    0    0    0    0    0    0    0   13    0    0    0    0    0    0    0    0    0    0    0]
 [   0    0    0    0    0    0    0    0    0    0    0    0    0    0    0    0   89    0    0    0    0    0    0    0    0    0    0]
 [   0    0    0    0    0    1    0    0    0    0    0    0    2    3    0    0    0   48    1   19    0    0    0    0    0    0    0]
 [   0    0    0    0    0    2    0    0    0    0    0    0    1    0    2    0    0    0   21    3    0    0    0    0    0    0    0]
 [   2    0    0    0    0   10    0    0    0    0    0    0   11    3    3    0    0    9    1   71    0    0    1    0    0    0    0]
 [   2    0    0    0    0    0    0    0    0    0    0    0    0    0    0    0    0    0    0    0  232    0    0    0    0    0    1]
 [   1    0    0    0    0    0    0    0    0    0    0    0    0    0    0    0    0    0    0    0    0   52    0    0    0    0    0]
 [   1    0    0    0    0    0    0    0    0    0    0    0    0    0    0    0    0    0    0    0    0    0  534    0    0    0    0]
 [   0    0    0    0    0    0    0    0    0    0    0    0    0    0    0    0    0    0    0    0    0    0    0    9    0    0    0]
 [   0    0    0    0    0    0    0    0    0    0    0    0    0    0    0    0    0    0    0    0    0    0    0    0    5    0    0]
 [   1    0    0    0    0    0    0    0    0    0    0    0    0    0    0    0    0    0    0    0    0    0    0    0    0   18    0]
 [   0    0    0    0    0    0    0    0    0    0    0    0    0    0    0    0    0    0    0    0    0    0    0    0    0    0   30]]

