Classifier: LinearSVC
Params: {'C': 1.0, 'class_weight': None, 'dual': True, 'fit_intercept': True, 'intercept_scaling': 1, 'loss': 'squared_hinge', 'max_iter': 1000, 'multi_class': 'ovr', 'penalty': 'l2', 'random_state': None, 'tol': 0.0001, 'verbose': 0}

Labels: None

Training accuracy: 1.0
Training confusion matrix:
[[188   0   0   0   0   0   0   0   0   0   0   0   0   0   0   0   0   0   0   0]
 [  0   1   0   0   0   0   0   0   0   0   0   0   0   0   0   0   0   0   0   0]
 [  0   0   1   0   0   0   0   0   0   0   0   0   0   0   0   0   0   0   0   0]
 [  0   0   0   5   0   0   0   0   0   0   0   0   0   0   0   0   0   0   0   0]
 [  0   0   0   0   5   0   0   0   0   0   0   0   0   0   0   0   0   0   0   0]
 [  0   0   0   0   0   2   0   0   0   0   0   0   0   0   0   0   0   0   0   0]
 [  0   0   0   0   0   0   1   0   0   0   0   0   0   0   0   0   0   0   0   0]
 [  0   0   0   0   0   0   0  14   0   0   0   0   0   0   0   0   0   0   0   0]
 [  0   0   0   0   0   0   0   0   1   0   0   0   0   0   0   0   0   0   0   0]
 [  0   0   0   0   0   0   0   0   0  95   0   0   0   0   0   0   0   0   0   0]
 [  0   0   0   0   0   0   0   0   0   0   1   0   0   0   0   0   0   0   0   0]
 [  0   0   0   0   0   0   0   0   0   0   0  14   0   0   0   0   0   0   0   0]
 [  0   0   0   0   0   0   0   0   0   0   0   0   4   0   0   0   0   0   0   0]
 [  0   0   0   0   0   0   0   0   0   0   0   0   0   7   0   0   0   0   0   0]
 [  0   0   0   0   0   0   0   0   0   0   0   0   0   0   2   0   0   0   0   0]
 [  0   0   0   0   0   0   0   0   0   0   0   0   0   0   0   5   0   0   0   0]
 [  0   0   0   0   0   0   0   0   0   0   0   0   0   0   0   0  12   0   0   0]
 [  0   0   0   0   0   0   0   0   0   0   0   0   0   0   0   0   0   1   0   0]
 [  0   0   0   0   0   0   0   0   0   0   0   0   0   0   0   0   0   0  22   0]
 [  0   0   0   0   0   0   0   0   0   0   0   0   0   0   0   0   0   0   0   2]]

Accuracy: 0.9151288598731145

Precision: [0.9464 0.8615 0.9618 0.6028 0.5890 0.4375 1.0000 0.9041 0.9950 0.9943 0.4507 0.9993 0.0000 0.0000 0.0000 0.8657 0.9814 0.2627 0.0000 0.2374 0.8924 0.9752 0.9864 0.0000 0.0000 0.0000 0.6195]
Mean: 0.576419918952682
Std: 0.4052395159812871

Recall: [0.9795 0.3771 0.3510 0.7113 0.9109 0.2947 0.8000 0.9578 0.9013 0.9766 0.6828 0.9522 0.0000 0.0000 0.0000 0.9062 0.8320 0.3257 0.0000 0.5727 0.9798 0.4387 0.9981 0.0000 0.0000 0.0000 0.6087]
Mean: 0.5391525818606685
Std: 0.3830638233710094

F1 score: [0.9627 0.5246 0.5143 0.6526 0.7154 0.3522 0.8889 0.9302 0.9459 0.9854 0.5430 0.9751 0.0000 0.0000 0.0000 0.8855 0.9005 0.2908 0.0000 0.3357 0.9341 0.6051 0.9922 0.0000 0.0000 0.0000 0.6140]
Mean: 0.5388243060343513
Std: 0.3775456383030488

Cohen Kappa score: 0.8796394420115272
Confusion matrix:
[[17794    18     0    84     9     3     0    43     0    28    38     1     0     0     0     0     2    13     0    95    16     3    18     0     0     0     1]
 [   87   112     0     0     0     0     0     0     0     0    98     0     0     0     0     0     0     0     0     0     0     0     0     0     0     0     0]
 [   21     0   126     0    81     0     0    48     0     0    40     0     0     0     0     1     0     0     0     0     8     0     0     0     0     0    34]
 [   69     0     0   170     0     0     0     0     0     0     0     0     0     0     0     0     0     0     0     0     0     0     0     0     0     0     0]
 [   14     0     0     4   225     0     0     0     0     0     0     0     0     0     0     2     1     0     0     0     1     0     0     0     0     0     0]
 [    4     0     0     0     0    56     0     0     0     0     1     0     0     0     0     0     0    19     0   110     0     0     0     0     0     0     0]
 [    4     0     0     1    21     0   120     0     0     0     0     0     0     0     0     0     0     0     0     0     0     0     0     0     0     0     4]
 [   22     0     0     2    13     0     0  1179     0     0     0     0     0     0     0     0     0     0     0     0    15     0     0     0     0     0     0]
 [   14     0     0     0     6     0     0     0   201     0     0     0     0     0     0     0     0     0     0     0     0     0     2     0     0     0     0]
 [  198     0     0     0     0     0     0     0     0  8259     0     0     0     0     0     0     0     0     0     0     0     0     0     0     0     0     0]
 [   80     0     0     0     0     0     0     0     0     5   183     0     0     0     0     0     0     0     0     0     0     0     0     0     0     0     0]
 [   66     0     0     0     0     0     0     0     0     4     0  1393     0     0     0     0     0     0     0     0     0     0     0     0     0     0     0]
 [    2     0     0     0     0    15     0     0     0     0     0     0     0     0     0     0     0    44     0    74     0     0     0     0     0     0     0]
 [    1     0     0     0     0     9     0     0     0     0     0     0     0     0     0     0     0    19     0    79     0     0     0     0     0     0     0]
 [  105     0     0     4     0    22     0     0     0     4    24     0     0     0     0     0     0    41     0   197     1     0     0     0     0     0     0]
 [    1     0     0     0     5     0     0     0     0     0     0     0     0     0     0    58     0     0     0     0     0     0     0     0     0     0     0]
 [   73     0     0     6     6     0     0     0     0     0     0     0     0     0     0     0   421     0     0     0     0     0     0     0     0     0     0]
 [   24     0     0     1     0    10     0     0     0     0     1     0     0     0     0     0     0   114     0   200     0     0     0     0     0     0     0]
 [    5     0     0     0     0     7     0     0     0     0     1     0     0     0     0     0     0    52     0    93     0     0     0     0     0     0     0]
 [   26     0     1     5     0     6     0     3     0     6     7     0     0     0     0     0     0   132     0   264     0     0     5     0     0     0     6]
 [   16     0     0     1     0     0     0     3     0     0     0     0     0     0     0     1     0     0     0     0  1211     0     4     0     0     0     0]
 [   15     0     4     1     3     0     0    21     0     0     2     0     0     0     0     0     0     0     0     0   103   118     2     0     0     0     0]
 [    1     0     0     1     2     0     0     0     1     0     0     0     0     0     0     0     0     0     0     0     0     0  2619     0     0     0     0]
 [   34     0     0     0     0     0     0     0     0     0    11     0     0     0     0     0     0     0     0     0     0     0     0     0     0     0     0]
 [   38     0     0     0     0     0     0     0     0     0     0     0     0     0     0     0     0     0     0     0     0     0     0     0     0     0     0]
 [    9     0     0     2     7     0     0     2     0     0     0     0     0     0     0     4     5     0     0     0     0     0     5     0     0     0    41]
 [   78     0     0     0     4     0     0     5     0     0     0     0     0     0     0     1     0     0     0     0     2     0     0     0     0     0   140]]

