Classifier: LogisticRegression
Params: {'C': 1.0, 'class_weight': None, 'dual': False, 'fit_intercept': True, 'intercept_scaling': 1, 'max_iter': 100, 'multi_class': 'ovr', 'n_jobs': 1, 'penalty': 'l2', 'random_state': None, 'solver': 'liblinear', 'tol': 0.0001, 'verbose': 0, 'warm_start': False}

Labels: None

Training accuracy: 1.0
Training confusion matrix:
[[188   0   0   0   0   0   0   0   0   0   0   0   0   0   0   0   0   0   0   0]
 [  0   1   0   0   0   0   0   0   0   0   0   0   0   0   0   0   0   0   0   0]
 [  0   0   1   0   0   0   0   0   0   0   0   0   0   0   0   0   0   0   0   0]
 [  0   0   0   5   0   0   0   0   0   0   0   0   0   0   0   0   0   0   0   0]
 [  0   0   0   0   5   0   0   0   0   0   0   0   0   0   0   0   0   0   0   0]
 [  0   0   0   0   0   2   0   0   0   0   0   0   0   0   0   0   0   0   0   0]
 [  0   0   0   0   0   0   1   0   0   0   0   0   0   0   0   0   0   0   0   0]
 [  0   0   0   0   0   0   0  14   0   0   0   0   0   0   0   0   0   0   0   0]
 [  0   0   0   0   0   0   0   0   1   0   0   0   0   0   0   0   0   0   0   0]
 [  0   0   0   0   0   0   0   0   0  95   0   0   0   0   0   0   0   0   0   0]
 [  0   0   0   0   0   0   0   0   0   0   1   0   0   0   0   0   0   0   0   0]
 [  0   0   0   0   0   0   0   0   0   0   0  14   0   0   0   0   0   0   0   0]
 [  0   0   0   0   0   0   0   0   0   0   0   0   4   0   0   0   0   0   0   0]
 [  0   0   0   0   0   0   0   0   0   0   0   0   0   7   0   0   0   0   0   0]
 [  0   0   0   0   0   0   0   0   0   0   0   0   0   0   2   0   0   0   0   0]
 [  0   0   0   0   0   0   0   0   0   0   0   0   0   0   0   5   0   0   0   0]
 [  0   0   0   0   0   0   0   0   0   0   0   0   0   0   0   0  12   0   0   0]
 [  0   0   0   0   0   0   0   0   0   0   0   0   0   0   0   0   0   1   0   0]
 [  0   0   0   0   0   0   0   0   0   0   0   0   0   0   0   0   0   0  22   0]
 [  0   0   0   0   0   0   0   0   0   0   0   0   0   0   0   0   0   0   0   2]]

Accuracy: 0.9052833864216706

Precision: [0.9173 0.8182 0.8824 0.7790 0.4506 0.5104 1.0000 0.9203 0.9904 0.9911 0.6169 1.0000 0.0000 0.0000 0.0000 0.8615 0.9412 0.2587 0.0000 0.2520 0.8811 0.9892 0.9779 0.0000 0.0000 0.0000 0.6122]
Mean: 0.5796482671566052
Std: 0.4001522943312237

Recall: [0.9889 0.0909 0.1671 0.5900 0.8502 0.2579 0.6600 0.9196 0.4619 0.9772 0.4627 0.9528 0.0000 0.0000 0.0000 0.8750 0.8221 0.2343 0.0000 0.6009 0.9709 0.3420 0.9943 0.0000 0.0000 0.0000 0.3913]
Mean: 0.4670331632372482
Std: 0.3796882779507776

F1 score: [0.9517 0.1636 0.2810 0.6714 0.5891 0.3427 0.7952 0.9200 0.6300 0.9841 0.5288 0.9758 0.0000 0.0000 0.0000 0.8682 0.8776 0.2459 0.0000 0.3551 0.9238 0.5083 0.9860 0.0000 0.0000 0.0000 0.4775]
Mean: 0.48428851284997526
Std: 0.3698201505475942

Cohen Kappa score: 0.8637709662948287
Confusion matrix:
[[17964     6     0    32     4     2     0    24     0    43     8     0     0     0     0     0     0     0     0    55    17     1     9     0     0     0     1]
 [  259    27     0     0     0     0     0     0     0     2     8     0     0     0     0     0     1     0     0     0     0     0     0     0     0     0     0]
 [   40     0    60     0   147     0     0    50     0     0    34     0     0     0     0     0     2     0     0     0     7     0     1     0     0     0    18]
 [   98     0     0   141     0     0     0     0     0     0     0     0     0     0     0     0     0     0     0     0     0     0     0     0     0     0     0]
 [   26     0     0     2   210     0     0     2     0     0     0     0     0     0     0     3     1     0     0     0     1     0     2     0     0     0     0]
 [   11     0     0     0     0    49     0     0     0     0     0     0     0     0     0     0     0     8     0   122     0     0     0     0     0     0     0]
 [    5     0     0     1    25     0    99     0     0     0     0     0     0     0     0     0     1     0     0     0     0     0    16     0     0     0     3]
 [   55     0     1     0    30     0     0  1132     0     0     0     0     0     0     0     0     0     0     0     0    13     0     0     0     0     0     0]
 [   84     0     0     0    15     0     0     0   103     0     0     0     0     0     0     0    11     0     0     0     1     0     9     0     0     0     0]
 [  193     0     0     0     0     0     0     0     0  8264     0     0     0     0     0     0     0     0     0     0     0     0     0     0     0     0     0]
 [  133     0     0     0     0     0     0     0     0     6   124     0     0     0     0     0     0     5     0     0     0     0     0     0     0     0     0]
 [   65     0     0     0     0     0     0     0     0     4     0  1394     0     0     0     0     0     0     0     0     0     0     0     0     0     0     0]
 [    4     0     0     0     0    10     0     0     0     0     0     0     0     0     0     0     0    36     0    85     0     0     0     0     0     0     0]
 [    6     0     0     0     0     5     0     0     0     0     0     0     0     0     0     0     0    11     0    86     0     0     0     0     0     0     0]
 [  145     0     0     1     0     9     0     0     0     6    20     0     0     0     0     0     0    40     0   174     0     0     3     0     0     0     0]
 [    1     0     0     0     6     0     0     0     0     0     0     0     0     0     0    56     0     0     0     0     0     0     1     0     0     0     0]
 [   81     0     0     4     5     0     0     0     0     0     0     0     0     0     0     0   416     0     0     0     0     0     0     0     0     0     0]
 [   53     0     0     0     0     5     0     0     0     0     1     0     0     0     0     0     0    82     0   209     0     0     0     0     0     0     0]
 [   21     0     0     0     0     5     0     0     0     3     0     0     0     0     0     0     0    38     0    91     0     0     0     0     0     0     0]
 [   60     0     0     0     0    11     0     0     0    10     2     0     0     0     0     0     3    97     0   277     0     0     1     0     0     0     0]
 [   32     0     0     0     0     0     0     0     0     0     0     0     0     0     0     0     0     0     0     0  1200     0     4     0     0     0     0]
 [   26     0     3     0     4     0     0    16     0     0     0     0     0     0     0     0     0     0     0     0   119    92     3     0     0     0     6]
 [   11     0     0     0     3     0     0     0     1     0     0     0     0     0     0     0     0     0     0     0     0     0  2609     0     0     0     0]
 [   41     0     0     0     0     0     0     0     0     0     4     0     0     0     0     0     0     0     0     0     0     0     0     0     0     0     0]
 [   38     0     0     0     0     0     0     0     0     0     0     0     0     0     0     0     0     0     0     0     0     0     0     0     0     0     0]
 [   16     0     0     0    11     0     0     2     0     0     0     0     0     0     0     0     7     0     0     0     1     0     9     0     0     0    29]
 [  116     0     4     0     6     0     0     4     0     0     0     0     0     0     0     6     0     0     0     0     3     0     1     0     0     0    90]]

