Classifier: MLPClassifier
Params: {'activation': 'relu', 'alpha': 0.0001, 'batch_size': 'auto', 'beta_1': 0.9, 'beta_2': 0.999, 'early_stopping': False, 'epsilon': 1e-08, 'hidden_layer_sizes': (100,), 'learning_rate': 'constant', 'learning_rate_init': 0.001, 'max_iter': 200, 'momentum': 0.9, 'nesterovs_momentum': True, 'power_t': 0.5, 'random_state': None, 'shuffle': True, 'solver': 'adam', 'tol': 0.0001, 'validation_fraction': 0.1, 'verbose': False, 'warm_start': False}

Labels: None

Training accuracy: 1.0
Training confusion matrix:
[[188   0   0   0   0   0   0   0   0   0   0   0   0   0   0   0   0   0   0   0]
 [  0   1   0   0   0   0   0   0   0   0   0   0   0   0   0   0   0   0   0   0]
 [  0   0   1   0   0   0   0   0   0   0   0   0   0   0   0   0   0   0   0   0]
 [  0   0   0   5   0   0   0   0   0   0   0   0   0   0   0   0   0   0   0   0]
 [  0   0   0   0   5   0   0   0   0   0   0   0   0   0   0   0   0   0   0   0]
 [  0   0   0   0   0   2   0   0   0   0   0   0   0   0   0   0   0   0   0   0]
 [  0   0   0   0   0   0   1   0   0   0   0   0   0   0   0   0   0   0   0   0]
 [  0   0   0   0   0   0   0  14   0   0   0   0   0   0   0   0   0   0   0   0]
 [  0   0   0   0   0   0   0   0   1   0   0   0   0   0   0   0   0   0   0   0]
 [  0   0   0   0   0   0   0   0   0  95   0   0   0   0   0   0   0   0   0   0]
 [  0   0   0   0   0   0   0   0   0   0   1   0   0   0   0   0   0   0   0   0]
 [  0   0   0   0   0   0   0   0   0   0   0  14   0   0   0   0   0   0   0   0]
 [  0   0   0   0   0   0   0   0   0   0   0   0   4   0   0   0   0   0   0   0]
 [  0   0   0   0   0   0   0   0   0   0   0   0   0   7   0   0   0   0   0   0]
 [  0   0   0   0   0   0   0   0   0   0   0   0   0   0   2   0   0   0   0   0]
 [  0   0   0   0   0   0   0   0   0   0   0   0   0   0   0   5   0   0   0   0]
 [  0   0   0   0   0   0   0   0   0   0   0   0   0   0   0   0  12   0   0   0]
 [  0   0   0   0   0   0   0   0   0   0   0   0   0   0   0   0   0   1   0   0]
 [  0   0   0   0   0   0   0   0   0   0   0   0   0   0   0   0   0   0  22   0]
 [  0   0   0   0   0   0   0   0   0   0   0   0   0   0   0   0   0   0   0   2]]

Accuracy: 0.8988864611577645

Precision: [0.9213 0.8421 0.7069 0.7592 0.5243 0.5119 1.0000 0.9097 0.9943 0.9923 0.4080 1.0000 0.0000 0.0000 0.0000 0.9630 1.0000 0.2563 0.0000 0.2262 0.8564 0.9903 0.9330 0.0000 0.0000 0.0000 0.5372]
Mean: 0.5678683494758074
Std: 0.4013343086412384

Recall: [0.9827 0.0539 0.1142 0.6067 0.8300 0.2263 0.2467 0.8920 0.7848 0.9747 0.4552 0.9515 0.0000 0.0000 0.0000 0.8125 0.8083 0.3200 0.0000 0.5575 0.9215 0.3792 0.9931 0.0000 0.0000 0.0000 0.4391]
Mean: 0.4573975084112938
Std: 0.378819864177141

F1 score: [0.9510 0.1013 0.1966 0.6744 0.6426 0.3139 0.3957 0.9007 0.8772 0.9834 0.4303 0.9751 0.0000 0.0000 0.0000 0.8814 0.8940 0.2846 0.0000 0.3219 0.8878 0.5484 0.9622 0.0000 0.0000 0.0000 0.4833]
Mean: 0.47058286087310713
Std: 0.37465233460897557

Cohen Kappa score: 0.8551080378721485
Confusion matrix:
[[17851     3     0    38     2     2     0    36     0    42    50     0     0     0     0     0     0    26     0    99     5     1    10     0     0     0     1]
 [  246    16     0     0     0     0     0     0     0     1    34     0     0     0     0     0     0     0     0     0     0     0     0     0     0     0     0]
 [   54     0    41     0    60     0     0    47     0     0    46     0     0     0     0     0     0     0     0     0    49     0    16     0     0     0    46]
 [   91     0     0   145     0     0     0     0     0     0     0     0     0     0     0     0     0     0     0     0     0     0     3     0     0     0     0]
 [   37     0     0     0   205     0     0     0     0     0     0     0     0     0     0     0     0     0     0     0     2     0     3     0     0     0     0]
 [    7     0     0     0     0    43     0     0     0     0     2     0     0     0     0     0     0    19     0   119     0     0     0     0     0     0     0]
 [    5     0     0     1    55     0    37     1     0     0     0     0     0     0     0     0     0     0     0     0     2     0    46     0     0     0     3]
 [   73     0     0     0    25     0     0  1098     0     0     0     0     0     0     0     0     0     0     0     0    14     0    21     0     0     0     0]
 [   32     0     0     0    13     0     0     0   175     0     0     0     0     0     0     0     0     0     0     0     0     0     3     0     0     0     0]
 [  213     0     0     0     0     0     0     0     0  8243     0     0     0     0     0     0     0     0     0     0     0     0     1     0     0     0     0]
 [  144     0     0     0     1     0     0     0     0     1   122     0     0     0     0     0     0     0     0     0     0     0     0     0     0     0     0]
 [   67     0     0     0     0     0     0     0     0     4     0  1392     0     0     0     0     0     0     0     0     0     0     0     0     0     0     0]
 [    3     0     0     0     0    11     0     0     0     0     0     0     0     0     0     0     0    41     0    80     0     0     0     0     0     0     0]
 [    4     0     0     0     0     5     0     0     0     0     0     0     0     0     0     0     0    18     0    81     0     0     0     0     0     0     0]
 [   67     0     0     0     0     9     0     2     0     8    28     0     0     0     0     0     0    35     0   196     2     0    47     0     0     0     4]
 [    1     0     0     0     5     0     0     0     0     0     0     0     0     0     0    52     0     0     0     0     0     0     3     0     0     0     3]
 [   86     0     0     4     7     0     0     0     0     0     0     0     0     0     0     0   409     0     0     0     0     0     0     0     0     0     0]
 [   16     0     0     0     0     4     0     0     0     0     1     0     0     0     0     0     0   112     0   217     0     0     0     0     0     0     0]
 [    9     0     0     0     0     5     0     0     0     1     0     0     0     0     0     0     0    56     0    87     0     0     0     0     0     0     0]
 [   39     0     0     0     0     5     0     0     0     7    10     0     0     0     0     0     0   130     0   257     2     0     7     0     0     0     4]
 [   71     0    12     1     2     0     0     1     0     0     0     0     0     0     0     0     0     0     0     0  1139     0    10     0     0     0     0]
 [   29     0     4     0     3     0     0    19     0     0     0     0     0     0     0     0     0     0     0     0   103   102     9     0     0     0     0]
 [   14     0     0     0     3     0     0     0     1     0     0     0     0     0     0     0     0     0     0     0     0     0  2606     0     0     0     0]
 [   39     0     0     0     0     0     0     0     0     0     6     0     0     0     0     0     0     0     0     0     0     0     0     0     0     0     0]
 [   38     0     0     0     0     0     0     0     0     0     0     0     0     0     0     0     0     0     0     0     0     0     0     0     0     0     0]
 [   21     0     0     2     5     0     0     1     0     0     0     0     0     0     0     2     0     0     0     0    10     0     8     0     0     0    26]
 [  119     0     1     0     5     0     0     2     0     0     0     0     0     0     0     0     0     0     0     0     2     0     0     0     0     0   101]]

