Classifier: MultinomialNB
Params: {'alpha': 1.0, 'class_prior': None, 'fit_prior': True}

Labels: None

Training accuracy: 0.9451697127937336
Training confusion matrix:
[[182   0   0   1   0   0   0   1   0   2   0   0   0   0   0   1   0   0   1   0]
 [  1   0   0   0   0   0   0   0   0   0   0   0   0   0   0   0   0   0   0   0]
 [  0   0   0   0   0   0   0   0   0   0   0   0   0   0   0   0   1   0   0   0]
 [  0   0   0   3   0   0   0   0   0   0   0   0   0   0   0   0   0   0   2   0]
 [  0   0   0   0   5   0   0   0   0   0   0   0   0   0   0   0   0   0   0   0]
 [  0   0   0   0   0   0   0   0   0   0   0   0   0   0   0   2   0   0   0   0]
 [  0   0   0   0   0   0   0   0   0   0   0   0   0   0   0   0   0   0   1   0]
 [  0   0   0   0   0   0   0  14   0   0   0   0   0   0   0   0   0   0   0   0]
 [  0   0   0   0   0   0   0   0   0   0   0   0   0   1   0   0   0   0   0   0]
 [  0   0   0   0   0   0   0   0   0  95   0   0   0   0   0   0   0   0   0   0]
 [  0   0   0   0   0   0   0   0   0   0   0   0   0   0   0   1   0   0   0   0]
 [  0   0   0   0   0   0   0   0   0   0   0  14   0   0   0   0   0   0   0   0]
 [  0   0   0   0   0   0   0   0   0   0   0   0   3   0   0   0   0   0   1   0]
 [  0   0   0   0   0   0   0   0   0   0   0   0   0   7   0   0   0   0   0   0]
 [  0   0   0   0   0   0   0   0   0   0   0   0   0   0   0   2   0   0   0   0]
 [  0   0   0   0   0   0   0   0   0   0   0   0   0   0   0   5   0   0   0   0]
 [  0   0   0   0   0   0   0   0   0   0   0   0   0   0   0   0  12   0   0   0]
 [  0   0   0   0   0   0   0   0   0   0   0   0   0   0   0   0   1   0   0   0]
 [  0   0   0   0   0   0   0   0   0   0   0   0   0   0   0   0   0   0  22   0]
 [  0   0   0   0   0   0   0   0   0   0   0   0   0   0   0   0   1   0   1   0]]

Accuracy: 0.8671650827914813

Precision: [0.9295 0.0000 0.0000 0.4852 0.6612 0.0000 0.0000 0.7625 1.0000 0.9784 0.0000 0.9922 0.0000 0.0000 0.0000 0.3978 0.8360 0.0000 0.0000 0.2039 0.7961 0.0000 0.7224 0.0000 0.0000 0.0000 0.0000]
Mean: 0.3246391158456276
Std: 0.3976077891410509

Recall: [0.9592 0.0000 0.0000 0.3431 0.4899 0.0000 0.0000 0.8895 0.0045 0.9735 0.0000 0.9542 0.0000 0.0000 0.0000 0.5781 0.8360 0.0000 0.0000 0.8980 0.8908 0.0000 0.9958 0.0000 0.0000 0.0000 0.0000]
Mean: 0.3263937701365473
Std: 0.41613603025462464

F1 score: [0.9441 0.0000 0.0000 0.4020 0.5628 0.0000 0.0000 0.8211 0.0089 0.9759 0.0000 0.9728 0.0000 0.0000 0.0000 0.4713 0.8360 0.0000 0.0000 0.3324 0.8408 0.0000 0.8374 0.0000 0.0000 0.0000 0.0000]
Mean: 0.2965016785143463
Std: 0.38532207440727473

Cohen Kappa score: 0.8111463101331289
Confusion matrix:
[[17425     0     0    84     0     0     0    77     0   160     0     5     0     0     0     0     4     0     0   312    40     0    59     0     0     0     0]
 [  293     0     0     0     0     0     0     0     0     0     0     0     0     0     0     0     2     0     0     1     0     0     1     0     0     0     0]
 [   48     0     0     0    27     0     0   124     0     0     0     0     0     0     0     0     5     0     0     0    42     0   113     0     0     0     0]
 [   81     0     0    82     0     0     0     0     0     0     0     0     0     0     0     0     3     0     0     0     0     0    73     0     0     0     0]
 [    6     0     0     0   121     0     0    42     0     0     0     0     0     0     0     6     0     0     0     0     1     0    71     0     0     0     0]
 [    4     0     0     0     0     0     0     0     0     0     0     0     0     0     0     0     0     0     0   186     0     0     0     0     0     0     0]
 [    3     0     0     0     2     0     0    12     0     0     0     0     0     0     0     0     2     0     0     0     0     0   131     0     0     0     0]
 [   50     0     0     0    16     0     0  1095     0     0     0     0     0     0     0     0     4     0     0     0    28     0    38     0     0     0     0]
 [    6     0     0     0     5     0     0     3     1     0     0     0     0     0     0     0    52     0     0     0     1     0   155     0     0     0     0]
 [  173     0     0     3     0     0     0     1     0  8233     0     6     0     0     0     0     0     0     0     2     1     0    38     0     0     0     0]
 [  193     0     0     0     0     0     0     0     0     0     0     0     0     0     0     0     0     0     0    75     0     0     0     0     0     0     0]
 [   45     0     0     0     0     0     0     0     0    22     0  1396     0     0     0     0     0     0     0     0     0     0     0     0     0     0     0]
 [    0     0     0     0     0     0     0     0     0     0     0     0     0     0     0     0     0     0     0   135     0     0     0     0     0     0     0]
 [    1     0     0     0     0     0     0     0     0     0     0     0     0     0     0     0     0     0     0   107     0     0     0     0     0     0     0]
 [   31     0     0     0     0     0     0     3     0     0     0     0     0     0     0     0     3     0     0   317     3     0    41     0     0     0     0]
 [    1     0     0     0     0     0     0     4     0     0     0     0     0     0     0    37     0     0     0     0     0     0    22     0     0     0     0]
 [   75     0     0     0     3     0     0     3     0     0     0     0     0     0     0     0   423     0     0     0     0     0     2     0     0     0     0]
 [   21     0     0     0     0     0     0     2     0     0     0     0     0     0     0     0     0     0     0   324     0     0     3     0     0     0     0]
 [    6     0     0     0     0     0     0     0     0     0     0     0     0     0     0     0     0     0     0   152     0     0     0     0     0     0     0]
 [   29     0     0     0     0     0     0     5     0     0     0     0     0     0     0     0     5     0     0   414     0     0     8     0     0     0     0]
 [   77     0     0     0     2     0     0     1     0     0     0     0     0     0     0     0     0     0     0     0  1101     0    55     0     0     0     0]
 [   11     0     0     0     0     0     0    54     0     0     0     0     0     0     0     0     1     0     0     0   149     0    54     0     0     0     0]
 [    9     0     0     0     1     0     0     0     0     0     0     0     0     0     0     1     0     0     0     0     0     0  2613     0     0     0     0]
 [   40     0     0     0     0     0     0     0     0     0     0     0     0     0     0     0     0     0     0     5     0     0     0     0     0     0     0]
 [   38     0     0     0     0     0     0     0     0     0     0     0     0     0     0     0     0     0     0     0     0     0     0     0     0     0     0]
 [    2     0     0     0     4     0     0     7     0     0     0     0     0     0     0     0     2     0     0     0     7     0    53     0     0     0     0]
 [   79     0     0     0     2     0     0     3     0     0     0     0     0     0     0    49     0     0     0     0    10     0    87     0     0     0     0]]

