Classifier: RandomForestClassifier
Params: {'bootstrap': True, 'class_weight': None, 'criterion': 'gini', 'max_depth': None, 'max_features': 'auto', 'max_leaf_nodes': None, 'min_impurity_decrease': 0.0, 'min_impurity_split': None, 'min_samples_leaf': 1, 'min_samples_split': 2, 'min_weight_fraction_leaf': 0.0, 'n_estimators': 100, 'n_jobs': 1, 'oob_score': False, 'random_state': None, 'verbose': 0, 'warm_start': False}

Labels: None

Training accuracy: 1.0
Training confusion matrix:
[[188   0   0   0   0   0   0   0   0   0   0   0   0   0   0   0   0   0   0   0]
 [  0   1   0   0   0   0   0   0   0   0   0   0   0   0   0   0   0   0   0   0]
 [  0   0   1   0   0   0   0   0   0   0   0   0   0   0   0   0   0   0   0   0]
 [  0   0   0   5   0   0   0   0   0   0   0   0   0   0   0   0   0   0   0   0]
 [  0   0   0   0   5   0   0   0   0   0   0   0   0   0   0   0   0   0   0   0]
 [  0   0   0   0   0   2   0   0   0   0   0   0   0   0   0   0   0   0   0   0]
 [  0   0   0   0   0   0   1   0   0   0   0   0   0   0   0   0   0   0   0   0]
 [  0   0   0   0   0   0   0  14   0   0   0   0   0   0   0   0   0   0   0   0]
 [  0   0   0   0   0   0   0   0   1   0   0   0   0   0   0   0   0   0   0   0]
 [  0   0   0   0   0   0   0   0   0  95   0   0   0   0   0   0   0   0   0   0]
 [  0   0   0   0   0   0   0   0   0   0   1   0   0   0   0   0   0   0   0   0]
 [  0   0   0   0   0   0   0   0   0   0   0  14   0   0   0   0   0   0   0   0]
 [  0   0   0   0   0   0   0   0   0   0   0   0   4   0   0   0   0   0   0   0]
 [  0   0   0   0   0   0   0   0   0   0   0   0   0   7   0   0   0   0   0   0]
 [  0   0   0   0   0   0   0   0   0   0   0   0   0   0   2   0   0   0   0   0]
 [  0   0   0   0   0   0   0   0   0   0   0   0   0   0   0   5   0   0   0   0]
 [  0   0   0   0   0   0   0   0   0   0   0   0   0   0   0   0  12   0   0   0]
 [  0   0   0   0   0   0   0   0   0   0   0   0   0   0   0   0   0   1   0   0]
 [  0   0   0   0   0   0   0   0   0   0   0   0   0   0   0   0   0   0  22   0]
 [  0   0   0   0   0   0   0   0   0   0   0   0   0   0   0   0   0   0   0   2]]

Accuracy: 0.8850659436122884

Precision: [0.8764 0.7500 1.0000 0.6810 0.4603 0.5800 1.0000 0.8700 0.9938 0.9985 0.8919 1.0000 0.0000 0.0000 0.0000 0.6727 0.9948 0.2300 0.0000 0.3276 0.7869 1.0000 0.9392 0.0000 0.0000 0.0000 0.3994]
Mean: 0.5723136479845906
Std: 0.39903097170491275

Recall: [0.9912 0.0101 0.0418 0.4644 0.6802 0.1526 0.4133 0.7880 0.7130 0.9599 0.1231 0.9501 0.0000 0.0000 0.0000 0.5781 0.7609 0.2057 0.0000 0.4967 0.8722 0.0929 0.9889 0.0000 0.0000 0.0000 0.5870]
Mean: 0.4026033859870566
Std: 0.3723358967510954

F1 score: [0.9303 0.0199 0.0802 0.5522 0.5490 0.2417 0.5849 0.8269 0.8303 0.9788 0.2164 0.9744 0.0000 0.0000 0.0000 0.6218 0.8623 0.2172 0.0000 0.3948 0.8273 0.1701 0.9634 0.0000 0.0000 0.0000 0.4754]
Mean: 0.4191652235804651
Std: 0.36836756995588255

Cohen Kappa score: 0.8320923729750019
Confusion matrix:
[[18007     1     0    48     2     0     0     5     0     8     4     0     0     0     0     0     1     8     0    43    16     0     7     0     0     0    16]
 [  293     3     0     0     0     0     0     0     0     0     0     0     0     0     0     0     0     0     0     0     0     0     0     0     0     0     1]
 [  131     0    15     0    62     0     0   112     0     0     0     0     0     0     0     0     0     0     0     0     8     0     1     0     0     0    30]
 [  109     0     0   111     0     0     0     0     0     0     0     0     0     0     0     0     0     0     0     0     1     0    18     0     0     0     0]
 [   28     0     0     0   168     0     0     0     0     0     0     0     0     0     0     0     0     0     0     0     4     0    15     0     0     0    32]
 [   46     0     0     0     0    29     0     0     0     0     0     0     0     0     0     0     0    24     0    91     0     0     0     0     0     0     0]
 [    4     0     0     0    25     0    62     3     0     0     0     0     0     0     0     4     0     0     0     0     1     0    44     0     0     0     7]
 [  127     0     0     0    44     0     0   970     0     0     0     0     0     0     0     1     0     0     0     0    70     0    19     0     0     0     0]
 [   10     0     0     0    24     0     0     0   159     0     0     0     0     0     0     0     0     0     0     0     9     0    12     0     0     0     9]
 [  338     0     0     0     0     0     0     0     0  8118     0     0     0     0     0     0     0     0     0     0     0     0     1     0     0     0     0]
 [  235     0     0     0     0     0     0     0     0     0    33     0     0     0     0     0     0     0     0     0     0     0     0     0     0     0     0]
 [   69     0     0     0     0     0     0     0     0     4     0  1390     0     0     0     0     0     0     0     0     0     0     0     0     0     0     0]
 [   32     0     0     0     0     6     0     0     0     0     0     0     0     0     0     0     0    30     0    67     0     0     0     0     0     0     0]
 [   28     0     0     0     0     1     0     0     0     0     0     0     0     0     0     0     0    13     0    66     0     0     0     0     0     0     0]
 [  334     0     0     0     0     7     0     0     0     0     0     0     0     0     0     0     0    15     0    40     0     0     2     0     0     0     0]
 [    1     0     0     0     6     0     0     1     0     0     0     0     0     0     0    37     0     0     0     0     0     0    11     0     0     0     8]
 [   89     0     0     4     6     0     0     6     0     0     0     0     0     0     0     0   385     0     0     0     1     0     3     0     0     0    12]
 [  133     0     0     0     0     2     0     0     0     0     0     0     0     0     0     0     0    72     0   143     0     0     0     0     0     0     0]
 [  104     0     0     0     0     5     0     0     0     0     0     0     0     0     0     0     0    29     0    20     0     0     0     0     0     0     0]
 [  109     0     0     0     0     0     0     0     0     0     0     0     0     0     0     0     0   122     0   229     0     0     1     0     0     0     0]
 [  116     0     0     0     0     0     0     0     0     0     0     0     0     0     0     0     0     0     0     0  1078     0    12     0     0     0    30]
 [   28     0     0     0     3     0     0    15     0     0     0     0     0     0     0     5     0     0     0     0   180    25     5     0     0     0     8]
 [   15     0     0     0    13     0     0     0     1     0     0     0     0     0     0     0     0     0     0     0     0     0  2595     0     0     0     0]
 [   45     0     0     0     0     0     0     0     0     0     0     0     0     0     0     0     0     0     0     0     0     0     0     0     0     0     0]
 [   38     0     0     0     0     0     0     0     0     0     0     0     0     0     0     0     0     0     0     0     0     0     0     0     0     0     0]
 [    3     0     0     0     5     0     0     1     0     0     0     0     0     0     0     5     1     0     0     0     0     0    10     0     0     0    50]
 [   74     0     0     0     7     0     0     2     0     0     0     0     0     0     0     3     0     0     0     0     2     0     7     0     0     0   135]]

