Classifier: MultinomialNB
Params: {'alpha': 1.0, 'class_prior': None, 'fit_prior': True}

Labels: None

Training accuracy: 0.9820278568219261
Training confusion matrix:
[[12313   105    29    59     6     0]
 [    0    12     0     0     0     0]
 [   20     0    19     0     2     0]
 [   10     0     0    25     0     0]
 [    3     0     2     0   744     0]
 [    4     0     0     0     0     1]]

Accuracy: 0.6282505399568035

Precision: [0.7227 0.0000 0.0767 0.0000 0.8835 0.0091 0.2432 0.0000 0.0000 0.0000 0.0000 0.0000 0.0000 0.0000 0.0000 0.0000]
Mean: 0.12094828056316739
Std: 0.2662166435034671

Recall: [0.4229 0.0000 0.6388 0.0000 0.8862 0.0649 0.5000 0.0000 0.0000 0.0000 0.0000 0.0000 0.0000 0.0000 0.0000 0.0000]
Mean: 0.15704610470205552
Std: 0.2774704634541605

F1 score: [0.5335 0.0000 0.1369 0.0000 0.8849 0.0159 0.3273 0.0000 0.0000 0.0000 0.0000 0.0000 0.0000 0.0000 0.0000 0.0000]
Mean: 0.11865690219141176
Std: 0.24603256145848582

Cohen Kappa score: 0.39655363861779513
Confusion matrix:
[[ 998    0  515    0  305  527   14    0    0    0    0    0    0    0    1    0]
 [  36    0  165    0    4   41    0    0    0    0    0    0    0    0    0    0]
 [  62    0  145    0    4   16    0    0    0    0    0    0    0    0    0    0]
 [  53    0  104    0   33    0    2    0    0    0    0    0    0    0    0    0]
 [  41    0   27    0 6099  714    1    0    0    0    0    0    0    0    0    0]
 [   0    0   70    0  103   12    0    0    0    0    0    0    0    0    0    0]
 [  15    0    2    0    1    0   18    0    0    0    0    0    0    0    0    0]
 [  32    0   83    0   13    0    7    0    0    0    0    0    0    0    0    0]
 [  15    0   71    0   20    0    2    0    0    0    0    0    0    0    0    0]
 [  13    0  125    0  125    5   12    0    0    0    0    0    0    0    0    0]
 [  37    0   12    0    3    0    2    0    0    0    0    0    0    0    0    0]
 [  21    0  178    0   69    1   13    0    0    0    0    0    0    0    0    0]
 [   9    0   66    0   57    0    3    0    0    0    0    0    0    0    0    0]
 [  46    0  305    0   67    9    0    0    0    0    0    0    0    0    0    0]
 [   1    0   23    0    0    0    0    0    0    0    0    0    0    0    0    0]
 [   2    0    0    0    0    0    0    0    0    0    0    0    0    0    0    0]]

