Classifier: LinearSVC
Params: {'C': 1.0, 'class_weight': 'balanced', 'dual': True, 'fit_intercept': True, 'intercept_scaling': 1, 'loss': 'squared_hinge', 'max_iter': 1000, 'multi_class': 'ovr', 'penalty': 'l2', 'random_state': None, 'tol': 0.0001, 'verbose': 0}

Labels: None

Training accuracy: 0.9893145686734428
Training confusion matrix:
[[14687     1     3     5     0     0     0     6     0     0     1     0     0     0     1     0     5     1     1     0     4     2     2     0     1     0     0]
 [    0   227     0     0     0     0     0     0     0     0     0     0     0     0     0     0     0     0     0     0     0     0     0     0     0     0     0]
 [    0     0   305     0     0     0     0     0     0     0     0     0     0     0     0     0     0     0     0     0     0     0     0     0     0     0     0]
 [    0     0     0   191     0     0     0     0     0     0     0     0     0     0     0     0     0     0     0     0     0     0     0     0     0     0     0]
 [    0     0     0     0   195     0     0     0     0     0     0     0     0     0     0     0     0     0     0     0     0     0     0     0     0     0     0]
 [    0     0     0     0     0   127     0     0     0     0     0     0    11     0     1     0     0     3     4    13     0     0     0     0     0     0     0]
 [    0     0     0     0     0     0   122     0     0     0     0     0     0     0     0     0     0     0     0     0     0     0     0     0     0     0     0]
 [    0     0     0     0     0     0     0   981     0     0     0     0     0     0     0     0     0     0     0     0     0     0     0     0     0     0     0]
 [    0     0     0     0     0     0     0     0   178     0     0     0     0     0     0     0     0     0     0     0     0     0     0     0     0     0     0]
 [    0     0     0     0     0     0     0     0     0  6904     0     0     0     0     0     0     0     0     0     0     0     0     0     0     0     0     0]
 [    0     0     0     0     0     0     0     0     0     0   202     0     0     0     0     0     0     0     0     0     0     0     0     0     0     0     0]
 [    0     0     0     0     0     0     0     0     0     0     0  1150     0     0     0     0     0     0     0     0     0     0     0     0     0     0     0]
 [    0     0     0     0     0     0     0     0     0     0     0     0   112     0     0     0     0     1     0     2     0     0     0     0     0     0     0]
 [    0     0     0     0     0     5     0     0     0     0     0     0     9    67     1     0     0     1     0     1     0     0     0     0     0     0     0]
 [    0     0     0     0     0     2     0     0     0     0     0     0     1     2   296     0     0     1     8     2     0     0     0     0     0     0     0]
 [    0     0     0     0     0     0     0     0     0     0     0     0     0     0     0    54     0     0     0     0     0     0     0     0     0     0     0]
 [    1     0     0     0     0     0     0     0     0     0     0     0     0     0     0     0   409     0     0     0     0     0     0     0     0     0     0]
 [    0     0     0     0     0    12     0     0     0     0     0     0    18     8     0     0     0   221     7     9     0     0     0     0     0     0     0]
 [    0     0     0     0     0     0     0     0     0     0     0     0     2     1     9     0     0     1   111     4     0     0     0     0     0     0     0]
 [    0     0     0     0     0    27     0     0     0     0     0     0    39    17     4     0     0    56    11   213     0     0     0     0     0     0     0]
 [    0     0     0     0     0     0     0     1     0     0     0     0     0     0     0     0     0     0     0     0   982     0     0     0     0     0     0]
 [    0     0     0     0     0     0     0     0     0     0     0     0     0     0     0     0     0     0     0     0     0   211     0     0     0     0     0]
 [    0     0     0     0     0     0     0     0     0     0     0     0     0     0     0     0     0     0     0     0     0     0  2109     0     0     0     0]
 [    0     0     0     0     0     0     0     0     0     0     0     0     0     0     0     0     0     0     0     0     0     0     0    33     0     0     0]
 [    0     0     0     0     0     0     0     0     0     0     0     0     0     0     0     0     0     0     0     0     0     0     0     0    29     0     0]
 [    0     0     0     0     0     0     0     0     0     0     0     0     0     0     0     0     0     0     0     0     0     0     0     0     0    69     0]
 [    0     0     0     0     0     0     0     0     0     0     0     0     0     0     0     0     0     0     0     0     0     0     0     0     0     0   183]]

Accuracy: 0.9784988272087568

Precision: [0.9970 0.9726 0.9483 0.9636 0.9828 0.5882 1.0000 0.9849 0.9574 0.9994 1.0000 1.0000 0.4082 0.6538 0.8462 1.0000 0.9364 0.7027 0.5294 0.7424 0.9813 0.9825 0.9981 1.0000 0.8182 1.0000 0.9608]
Mean: 0.8871891318210815
Std: 0.16580750255504537

Recall: [0.9917 1.0000 1.0000 1.0000 1.0000 0.6061 1.0000 0.9886 0.9783 0.9982 0.9552 1.0000 1.0000 0.7083 0.8953 1.0000 1.0000 0.6753 0.6000 0.4949 0.9887 0.9492 0.9963 0.9167 1.0000 1.0000 1.0000]
Mean: 0.9164013468842711
Std: 0.1484929007673879

F1 score: [0.9943 0.9861 0.9735 0.9815 0.9913 0.5970 1.0000 0.9868 0.9677 0.9988 0.9771 1.0000 0.5797 0.6800 0.8701 1.0000 0.9671 0.6887 0.5625 0.5939 0.9850 0.9655 0.9972 0.9565 0.9000 1.0000 0.9800]
Mean: 0.8955700357352874
Std: 0.15334910917390435

Cohen Kappa score: 0.970166065461007
Confusion matrix:
[[3604    2    2    2    1    0    0    3    0    1    0    0    0    0    1    0    5    0    3    2    4    1    0    0    2    0    1]
 [   0   71    0    0    0    0    0    0    0    0    0    0    0    0    0    0    0    0    0    0    0    0    0    0    0    0    0]
 [   0    0   55    0    0    0    0    0    0    0    0    0    0    0    0    0    0    0    0    0    0    0    0    0    0    0    0]
 [   0    0    0   53    0    0    0    0    0    0    0    0    0    0    0    0    0    0    0    0    0    0    0    0    0    0    0]
 [   0    0    0    0   57    0    0    0    0    0    0    0    0    0    0    0    0    0    0    0    0    0    0    0    0    0    0]
 [   0    0    0    0    0   20    0    0    0    0    0    0    4    0    1    0    0    0    3    5    0    0    0    0    0    0    0]
 [   0    0    0    0    0    0   29    0    0    0    0    0    0    0    0    0    0    0    0    0    0    0    0    0    0    0    0]
 [   1    0    0    0    0    0    0  261    1    0    0    0    0    0    0    0    0    0    0    0    1    0    0    0    0    0    0]
 [   0    0    0    0    0    0    0    0   45    0    0    0    0    0    0    0    0    0    0    0    0    0    1    0    0    0    0]
 [   2    0    0    0    0    0    0    0    0 1645    0    0    0    0    0    0    1    0    0    0    0    0    0    0    0    0    0]
 [   3    0    0    0    0    0    0    0    0    0   64    0    0    0    0    0    0    0    0    0    0    0    0    0    0    0    0]
 [   0    0    0    0    0    0    0    0    0    0    0  327    0    0    0    0    0    0    0    0    0    0    0    0    0    0    0]
 [   0    0    0    0    0    0    0    0    0    0    0    0   20    0    0    0    0    0    0    0    0    0    0    0    0    0    0]
 [   0    0    0    0    0    2    0    0    0    0    0    0    4   17    0    0    0    1    0    0    0    0    0    0    0    0    0]
 [   0    0    0    0    0    2    0    0    0    0    0    0    1    0   77    0    0    0    4    2    0    0    0    0    0    0    0]
 [   0    0    0    0    0    0    0    0    0    0    0    0    0    0    0   14    0    0    0    0    0    0    0    0    0    0    0]
 [   0    0    0    0    0    0    0    0    0    0    0    0    0    0    0    0  103    0    0    0    0    0    0    0    0    0    0]
 [   0    0    0    0    0    4    0    0    0    0    0    0    7    4    1    0    0   52    2    7    0    0    0    0    0    0    0]
 [   0    0    0    0    0    1    0    0    0    0    0    0    2    1    7    0    0    0   18    1    0    0    0    0    0    0    0]
 [   1    0    0    0    0    5    0    0    0    0    0    0   11    4    4    0    0   21    4   49    0    0    0    0    0    0    0]
 [   2    0    0    0    0    0    0    0    0    0    0    0    0    0    0    0    0    0    0    0  262    0    0    0    0    0    1]
 [   1    0    1    0    0    0    0    1    0    0    0    0    0    0    0    0    0    0    0    0    0   56    0    0    0    0    0]
 [   0    0    0    0    0    0    0    0    1    0    0    0    0    0    0    0    1    0    0    0    0    0  535    0    0    0    0]
 [   1    0    0    0    0    0    0    0    0    0    0    0    0    0    0    0    0    0    0    0    0    0    0   11    0    0    0]
 [   0    0    0    0    0    0    0    0    0    0    0    0    0    0    0    0    0    0    0    0    0    0    0    0    9    0    0]
 [   0    0    0    0    0    0    0    0    0    0    0    0    0    0    0    0    0    0    0    0    0    0    0    0    0    6    0]
 [   0    0    0    0    0    0    0    0    0    0    0    0    0    0    0    0    0    0    0    0    0    0    0    0    0    0   49]]

