Classifier: LogisticRegression
Params: {'C': 1.0, 'class_weight': 'balanced', 'dual': False, 'fit_intercept': True, 'intercept_scaling': 1, 'max_iter': 100, 'multi_class': 'ovr', 'n_jobs': 1, 'penalty': 'l2', 'random_state': None, 'solver': 'liblinear', 'tol': 0.0001, 'verbose': 0, 'warm_start': False}

Labels: None

Training accuracy: 0.9853726869950482
Training confusion matrix:
[[14603     6     4    13     1     1     0    13     0    11     7     0     4     0     6     4     9     3     1     2    11     7     9     4     1     0     0]
 [    0   227     0     0     0     0     0     0     0     0     0     0     0     0     0     0     0     0     0     0     0     0     0     0     0     0     0]
 [    0     0   305     0     0     0     0     0     0     0     0     0     0     0     0     0     0     0     0     0     0     0     0     0     0     0     0]
 [    0     0     0   191     0     0     0     0     0     0     0     0     0     0     0     0     0     0     0     0     0     0     0     0     0     0     0]
 [    0     0     0     0   195     0     0     0     0     0     0     0     0     0     0     0     0     0     0     0     0     0     0     0     0     0     0]
 [    0     0     0     0     0   131     0     0     0     0     0     0     9     3     0     0     0     2     4    10     0     0     0     0     0     0     0]
 [    0     0     0     0     0     0   122     0     0     0     0     0     0     0     0     0     0     0     0     0     0     0     0     0     0     0     0]
 [    0     0     1     0     0     0     0   976     0     0     0     0     0     0     0     0     0     0     0     0     4     0     0     0     0     0     0]
 [    0     0     0     0     0     0     0     0   178     0     0     0     0     0     0     0     0     0     0     0     0     0     0     0     0     0     0]
 [   14     0     0     0     0     0     0     0     0  6888     0     1     0     0     0     0     1     0     0     0     0     0     0     0     0     0     0]
 [    0     0     0     0     0     0     0     0     0     0   202     0     0     0     0     0     0     0     0     0     0     0     0     0     0     0     0]
 [    0     0     0     0     0     0     0     0     0     0     0  1150     0     0     0     0     0     0     0     0     0     0     0     0     0     0     0]
 [    0     0     0     0     0     1     0     0     0     0     0     0   104     7     0     0     0     1     0     2     0     0     0     0     0     0     0]
 [    0     0     0     0     0     4     0     0     0     0     0     0     3    74     1     0     0     1     0     1     0     0     0     0     0     0     0]
 [    0     0     0     0     0     6     0     0     0     0     0     0     1     2   287     0     0     1    12     3     0     0     0     0     0     0     0]
 [    0     0     0     0     0     0     0     0     0     0     0     0     0     0     0    54     0     0     0     0     0     0     0     0     0     0     0]
 [    1     0     0     0     0     0     0     0     0     0     0     0     0     0     0     0   408     0     0     0     0     0     0     0     1     0     0]
 [    0     0     0     0     0    12     0     0     0     0     0     0    19     8     0     0     0   213     8    15     0     0     0     0     0     0     0]
 [    0     0     0     0     0     0     0     0     0     0     0     0     2     1     8     0     0     1   110     6     0     0     0     0     0     0     0]
 [    0     0     0     0     0    30     0     0     0     0     0     0    39    19     4     0     0    54     7   214     0     0     0     0     0     0     0]
 [    0     0     0     0     0     0     0     1     0     0     0     0     0     0     0     0     0     0     0     0   982     0     0     0     0     0     0]
 [    0     0     0     0     0     0     0     0     0     0     0     0     0     0     0     0     0     0     0     0     0   211     0     0     0     0     0]
 [    1     0     0     0     0     0     0     0     0     0     0     0     0     0     0     0     0     0     0     0     0     0  2108     0     0     0     0]
 [    0     0     0     0     0     0     0     0     0     0     0     0     0     0     0     0     0     0     0     0     0     0     0    33     0     0     0]
 [    0     0     0     0     0     0     0     0     0     0     0     0     0     0     0     0     0     0     0     0     0     0     0     0    29     0     0]
 [    0     0     0     0     0     0     0     0     0     0     0     0     0     0     0     0     0     0     0     0     0     0     0     0     0    69     0]
 [    0     0     0     0     0     0     0     0     0     0     0     0     0     0     0     0     0     0     0     0     0     0     0     0     0     0   183]]

Accuracy: 0.9783685170706281

Precision: [0.9967 0.9861 0.9649 0.9455 0.9500 0.5882 1.0000 0.9887 0.9783 0.9994 0.9848 0.9970 0.4186 0.6897 0.8736 0.8750 0.9364 0.6753 0.5588 0.7403 0.9813 0.9661 0.9981 1.0000 0.9000 1.0000 0.9800]
Mean: 0.887877427815866
Std: 0.159545937922082

Recall: [0.9890 1.0000 1.0000 0.9811 1.0000 0.6061 1.0000 0.9924 0.9783 0.9964 0.9701 1.0000 0.9000 0.8333 0.8837 1.0000 1.0000 0.6753 0.6333 0.5758 0.9925 0.9661 0.9963 0.9167 1.0000 1.0000 1.0000]
Mean: 0.9217165096618438
Std: 0.13206880793757841

F1 score: [0.9928 0.9930 0.9821 0.9630 0.9744 0.5970 1.0000 0.9905 0.9783 0.9979 0.9774 0.9985 0.5714 0.7547 0.8786 0.9333 0.9671 0.6753 0.5938 0.6477 0.9869 0.9661 0.9972 0.9565 0.9474 1.0000 0.9899]
Mean: 0.9004035104764633
Std: 0.14438058249201566

Cohen Kappa score: 0.9700106671929952
Confusion matrix:
[[3594    1    2    3    3    0    0    3    0    1    1    1    0    0    1    1    5    6    3    1    4    2    0    0    1    0    1]
 [   0   71    0    0    0    0    0    0    0    0    0    0    0    0    0    0    0    0    0    0    0    0    0    0    0    0    0]
 [   0    0   55    0    0    0    0    0    0    0    0    0    0    0    0    0    0    0    0    0    0    0    0    0    0    0    0]
 [   1    0    0   52    0    0    0    0    0    0    0    0    0    0    0    0    0    0    0    0    0    0    0    0    0    0    0]
 [   0    0    0    0   57    0    0    0    0    0    0    0    0    0    0    0    0    0    0    0    0    0    0    0    0    0    0]
 [   0    0    0    0    0   20    0    0    0    0    0    0    4    0    1    0    0    0    3    5    0    0    0    0    0    0    0]
 [   0    0    0    0    0    0   29    0    0    0    0    0    0    0    0    0    0    0    0    0    0    0    0    0    0    0    0]
 [   1    0    0    0    0    0    0  262    0    0    0    0    0    0    0    0    0    0    0    0    1    0    0    0    0    0    0]
 [   0    0    0    0    0    0    0    0   45    0    0    0    0    0    0    0    0    0    0    0    0    0    1    0    0    0    0]
 [   4    0    0    0    0    0    0    0    0 1642    0    0    0    0    0    0    1    0    0    1    0    0    0    0    0    0    0]
 [   2    0    0    0    0    0    0    0    0    0   65    0    0    0    0    0    0    0    0    0    0    0    0    0    0    0    0]
 [   0    0    0    0    0    0    0    0    0    0    0  327    0    0    0    0    0    0    0    0    0    0    0    0    0    0    0]
 [   0    0    0    0    0    0    0    0    0    0    0    0   18    1    0    0    0    0    0    1    0    0    0    0    0    0    0]
 [   0    0    0    0    0    2    0    0    0    0    0    0    0   20    0    0    0    1    0    1    0    0    0    0    0    0    0]
 [   0    0    0    0    0    2    0    0    0    0    0    0    1    0   76    0    0    0    5    2    0    0    0    0    0    0    0]
 [   0    0    0    0    0    0    0    0    0    0    0    0    0    0    0   14    0    0    0    0    0    0    0    0    0    0    0]
 [   0    0    0    0    0    0    0    0    0    0    0    0    0    0    0    0  103    0    0    0    0    0    0    0    0    0    0]
 [   0    0    0    0    0    4    0    0    0    0    0    0    7    4    1    0    0   52    2    7    0    0    0    0    0    0    0]
 [   0    0    0    0    0    1    0    0    0    0    0    0    2    1    5    0    0    0   19    2    0    0    0    0    0    0    0]
 [   0    0    0    0    0    5    0    0    0    0    0    0   11    3    3    0    0   18    2   57    0    0    0    0    0    0    0]
 [   2    0    0    0    0    0    0    0    0    0    0    0    0    0    0    0    0    0    0    0  263    0    0    0    0    0    0]
 [   1    0    0    0    0    0    0    0    0    0    0    0    0    0    0    1    0    0    0    0    0   57    0    0    0    0    0]
 [   0    0    0    0    0    0    0    0    1    0    0    0    0    0    0    0    1    0    0    0    0    0  535    0    0    0    0]
 [   1    0    0    0    0    0    0    0    0    0    0    0    0    0    0    0    0    0    0    0    0    0    0   11    0    0    0]
 [   0    0    0    0    0    0    0    0    0    0    0    0    0    0    0    0    0    0    0    0    0    0    0    0    9    0    0]
 [   0    0    0    0    0    0    0    0    0    0    0    0    0    0    0    0    0    0    0    0    0    0    0    0    0    6    0]
 [   0    0    0    0    0    0    0    0    0    0    0    0    0    0    0    0    0    0    0    0    0    0    0    0    0    0   49]]

