Classifier: RandomForestClassifier
Params: {'bootstrap': True, 'class_weight': 'balanced', 'criterion': 'gini', 'max_depth': None, 'max_features': 'auto', 'max_leaf_nodes': None, 'min_impurity_decrease': 0.0, 'min_impurity_split': None, 'min_samples_leaf': 1, 'min_samples_split': 2, 'min_weight_fraction_leaf': 0.0, 'n_estimators': 100, 'n_jobs': 1, 'oob_score': False, 'random_state': None, 'verbose': 0, 'warm_start': False}

Labels: None

Training accuracy: 0.9950156372165755
Training confusion matrix:
[[14711     0     1     4     0     0     0     0     0     0     0     0     0     0     0     0     4     0     0     0     0     0     0     0     0     0     0]
 [    0   227     0     0     0     0     0     0     0     0     0     0     0     0     0     0     0     0     0     0     0     0     0     0     0     0     0]
 [    0     0   305     0     0     0     0     0     0     0     0     0     0     0     0     0     0     0     0     0     0     0     0     0     0     0     0]
 [    0     0     0   191     0     0     0     0     0     0     0     0     0     0     0     0     0     0     0     0     0     0     0     0     0     0     0]
 [    0     0     0     0   195     0     0     0     0     0     0     0     0     0     0     0     0     0     0     0     0     0     0     0     0     0     0]
 [    0     0     0     0     0   151     0     0     0     0     0     0     0     3     1     0     0     0     1     3     0     0     0     0     0     0     0]
 [    0     0     0     0     0     0   122     0     0     0     0     0     0     0     0     0     0     0     0     0     0     0     0     0     0     0     0]
 [    0     0     0     0     0     0     0   981     0     0     0     0     0     0     0     0     0     0     0     0     0     0     0     0     0     0     0]
 [    0     0     0     0     0     0     0     0   178     0     0     0     0     0     0     0     0     0     0     0     0     0     0     0     0     0     0]
 [    0     0     0     0     0     0     0     0     0  6904     0     0     0     0     0     0     0     0     0     0     0     0     0     0     0     0     0]
 [    0     0     0     0     0     0     0     0     0     0   202     0     0     0     0     0     0     0     0     0     0     0     0     0     0     0     0]
 [    0     0     0     0     0     0     0     0     0     0     0  1150     0     0     0     0     0     0     0     0     0     0     0     0     0     0     0]
 [    0     0     0     0     0     1     0     0     0     0     0     0   111     1     0     0     0     2     0     0     0     0     0     0     0     0     0]
 [    0     0     0     0     0     0     0     0     0     0     0     0     0    84     0     0     0     0     0     0     0     0     0     0     0     0     0]
 [    0     0     0     0     0     1     0     0     0     0     0     0     0     1   297     0     0     1     9     3     0     0     0     0     0     0     0]
 [    0     0     0     0     0     0     0     0     0     0     0     0     0     0     0    54     0     0     0     0     0     0     0     0     0     0     0]
 [    0     0     0     0     0     0     0     0     0     0     0     0     0     0     0     0   410     0     0     0     0     0     0     0     0     0     0]
 [    0     0     0     0     0     3     0     0     0     0     0     0     4     3     0     0     0   249     4    12     0     0     0     0     0     0     0]
 [    0     0     0     0     0     0     0     0     0     0     0     0     0     1     4     0     0     0   121     2     0     0     0     0     0     0     0]
 [    0     0     0     0     0    13     0     0     0     0     0     0    27     7     1     0     0    29     6   284     0     0     0     0     0     0     0]
 [    0     0     0     0     0     0     0     1     0     0     0     0     0     0     0     0     0     0     0     0   982     0     0     0     0     0     0]
 [    0     0     0     0     0     0     0     0     0     0     0     0     0     0     0     0     0     0     0     0     0   211     0     0     0     0     0]
 [    0     0     0     0     0     0     0     0     0     0     0     0     0     0     0     0     0     0     0     0     0     0  2109     0     0     0     0]
 [    0     0     0     0     0     0     0     0     0     0     0     0     0     0     0     0     0     0     0     0     0     0     0    33     0     0     0]
 [    0     0     0     0     0     0     0     0     0     0     0     0     0     0     0     0     0     0     0     0     0     0     0     0    29     0     0]
 [    0     0     0     0     0     0     0     0     0     0     0     0     0     0     0     0     0     0     0     0     0     0     0     0     0    69     0]
 [    0     0     0     0     0     0     0     0     0     0     0     0     0     0     0     0     0     0     0     0     0     0     0     0     0     0   183]]

Accuracy: 0.9704195986447746

Precision: [0.9858 0.9324 0.9464 0.9000 0.9333 0.6154 0.9667 0.9630 0.9565 0.9994 0.9841 0.9969 0.3030 0.5000 0.8636 1.0000 0.9700 0.7042 0.5600 0.6316 0.9737 0.9811 0.9981 0.8889 0.8750 1.0000 0.9583]
Mean: 0.866206656094028
Std: 0.18198140050102565

Recall: [0.9928 0.9718 0.9636 0.8491 0.9825 0.4848 1.0000 0.9848 0.9565 0.9945 0.9254 0.9878 0.5000 0.5833 0.8837 1.0000 0.9417 0.6494 0.4667 0.6061 0.9774 0.8814 0.9870 0.6667 0.7778 1.0000 0.9388]
Mean: 0.8501297207216812
Std: 0.17993546041690356

F1 score: [0.9893 0.9517 0.9550 0.8738 0.9573 0.5424 0.9831 0.9738 0.9565 0.9970 0.9538 0.9923 0.3774 0.5385 0.8736 1.0000 0.9557 0.6757 0.5091 0.6186 0.9755 0.9286 0.9925 0.7619 0.8235 1.0000 0.9485]
Mean: 0.8557313814332626
Std: 0.1806703752731381

Cohen Kappa score: 0.958809317399851
Confusion matrix:
[[3608    5    0    4    0    0    0    2    0    1    1    0    0    2    1    0    3    0    1    0    3    0    0    1    1    0    1]
 [   2   69    0    0    0    0    0    0    0    0    0    0    0    0    0    0    0    0    0    0    0    0    0    0    0    0    0]
 [   0    0   53    0    1    0    0    0    0    0    0    0    0    0    0    0    0    0    0    0    0    1    0    0    0    0    0]
 [   8    0    0   45    0    0    0    0    0    0    0    0    0    0    0    0    0    0    0    0    0    0    0    0    0    0    0]
 [   1    0    0    0   56    0    0    0    0    0    0    0    0    0    0    0    0    0    0    0    0    0    0    0    0    0    0]
 [   0    0    0    0    0   16    0    0    0    0    0    0    1    3    1    0    0    1    3    8    0    0    0    0    0    0    0]
 [   0    0    0    0    0    0   29    0    0    0    0    0    0    0    0    0    0    0    0    0    0    0    0    0    0    0    0]
 [   1    0    1    0    0    0    0  260    0    0    0    0    0    0    0    0    0    0    0    0    2    0    0    0    0    0    0]
 [   0    0    0    0    0    0    1    0   44    0    0    0    0    0    0    0    0    0    0    0    0    0    1    0    0    0    0]
 [   8    0    0    0    0    0    0    0    0 1639    0    1    0    0    0    0    0    0    0    0    0    0    0    0    0    0    0]
 [   5    0    0    0    0    0    0    0    0    0   62    0    0    0    0    0    0    0    0    0    0    0    0    0    0    0    0]
 [   4    0    0    0    0    0    0    0    0    0    0  323    0    0    0    0    0    0    0    0    0    0    0    0    0    0    0]
 [   0    0    0    0    0    1    0    0    0    0    0    0   10    3    0    0    0    1    0    5    0    0    0    0    0    0    0]
 [   0    0    0    0    0    2    0    0    0    0    0    0    2   14    2    0    0    0    0    4    0    0    0    0    0    0    0]
 [   2    0    0    0    0    2    0    0    0    0    0    0    1    0   76    0    0    0    3    2    0    0    0    0    0    0    0]
 [   0    0    0    0    0    0    0    0    0    0    0    0    0    0    0   14    0    0    0    0    0    0    0    0    0    0    0]
 [   5    0    0    1    0    0    0    0    0    0    0    0    0    0    0    0   97    0    0    0    0    0    0    0    0    0    0]
 [   0    0    0    0    0    1    0    0    0    0    0    0    6    3    1    0    0   50    2   14    0    0    0    0    0    0    0]
 [   3    0    0    0    0    1    0    0    0    0    0    0    2    1    5    0    0    2   14    2    0    0    0    0    0    0    0]
 [   2    0    0    0    0    3    0    0    0    0    0    0   11    2    2    0    0   17    2   60    0    0    0    0    0    0    0]
 [   3    0    1    0    0    0    0    1    0    0    0    0    0    0    0    0    0    0    0    0  259    0    0    0    0    0    1]
 [   1    0    1    0    0    0    0    3    0    0    0    0    0    0    0    0    0    0    0    0    2   52    0    0    0    0    0]
 [   0    0    0    0    2    0    0    3    2    0    0    0    0    0    0    0    0    0    0    0    0    0  530    0    0    0    0]
 [   4    0    0    0    0    0    0    0    0    0    0    0    0    0    0    0    0    0    0    0    0    0    0    8    0    0    0]
 [   2    0    0    0    0    0    0    0    0    0    0    0    0    0    0    0    0    0    0    0    0    0    0    0    7    0    0]
 [   0    0    0    0    0    0    0    0    0    0    0    0    0    0    0    0    0    0    0    0    0    0    0    0    0    6    0]
 [   1    0    0    0    1    0    0    1    0    0    0    0    0    0    0    0    0    0    0    0    0    0    0    0    0    0   46]]

