Classifier: GradientBoostingClassifier
Params: {'criterion': 'friedman_mse', 'init': None, 'learning_rate': 0.1, 'loss': 'deviance', 'max_depth': 3, 'max_features': None, 'max_leaf_nodes': None, 'min_impurity_decrease': 0.0, 'min_impurity_split': None, 'min_samples_leaf': 1, 'min_samples_split': 2, 'min_weight_fraction_leaf': 0.0, 'n_estimators': 100, 'presort': 'auto', 'random_state': None, 'subsample': 1.0, 'verbose': 0, 'warm_start': False}

Labels: None

Training accuracy: 0.9912137310993052
Training confusion matrix:
[[9473    0    0    0    0    0    0    1    0    0    0    0    0    0    0    0    0    0    0    0    1    0    0    0    0    0    0]
 [   0  235    0    0    0    0    0    0    0    0    0    0    0    0    0    0    0    0    0    0    0    0    0    0    0    0    0]
 [   0    0  167    0    0    0    0    0    0    0    0    0    0    0    0    0    0    0    0    0    0    0    0    0    0    0    0]
 [   0    0    0  125    0    0    0    0    0    0    0    0    0    0    0    0    0    0    0    0    0    0    0    0    0    0    0]
 [   0    0    0    0   93    0    0    0    0    0    0    0    0    0    0    0    0    0    0    0    0    0    0    0    0    0    0]
 [   0    0    0    0    0  128    0    0    0    0    0    0    2    2    0    0    0    1    0   10    0    0    0    0    0    0    0]
 [   0    0    0    0    0    0  122    0    0    0    0    0    0    0    0    0    0    0    0    0    0    0    0    0    0    0    0]
 [   0    0    0    0    0    0    0  709    0    0    0    0    0    0    0    0    0    0    0    0    1    0    0    0    0    0    0]
 [   0    0    0    0    0    0    0    0  108    0    0    0    0    0    0    0    0    0    0    0    0    0    0    0    0    0    0]
 [   7    0    0    0    0    0    0    0    0 3464    0    0    0    0    0    0    0    0    0    0    0    0    0    0    0    0    0]
 [   0    0    0    0    0    0    0    0    0    0  136    0    0    0    0    0    0    0    0    0    0    0    0    0    0    0    0]
 [   0    0    0    0    0    0    0    0    0    0    0 1432    0    0    0    0    0    0    0    0    0    0    0    0    0    0    0]
 [   0    0    0    0    0    2    0    0    0    0    0    0   72    1    0    0    0    7    0    8    0    0    0    0    0    0    0]
 [   0    0    0    0    0    2    0    0    0    0    0    0    1   88    0    0    0    0    0    2    0    0    0    0    0    0    0]
 [   0    0    0    0    0    0    0    0    0    0    0    0    0    1  236    0    0    0    7    0    0    0    0    0    0    0    0]
 [   0    0    0    0    0    0    0    0    0    0    0    0    0    0    0   38    0    0    0    0    0    0    0    0    0    0    0]
 [   0    0    0    0    0    0    0    0    0    0    0    0    0    0    0    0  189    0    0    0    0    0    0    0    0    0    0]
 [   0    0    0    0    0    6    0    0    0    0    0    0    1    5    0    0    0  176    1   29    0    0    0    0    0    0    0]
 [   0    0    0    0    0    1    0    0    0    0    0    0    0    1   11    0    0    0   86    3    0    0    0    0    0    0    0]
 [   0    0    0    0    0    3    0    0    0    0    0    0   21    8    1    0    0   25    0  274    0    0    0    0    0    0    0]
 [   0    0    0    0    0    0    0    0    0    0    0    0    0    0    0    0    0    0    0    0  596    0    0    0    0    0    0]
 [   0    0    0    0    0    0    0    0    0    0    0    0    0    0    0    0    0    0    0    0    0  111    0    0    0    0    0]
 [   0    0    0    0    0    0    0    0    0    0    0    0    0    0    0    0    0    0    0    0    0    0 1151    0    0    0    0]
 [   0    0    0    0    0    0    0    0    0    0    0    0    0    0    0    0    0    0    0    0    0    0    0   32    0    0    0]
 [   0    0    0    0    0    0    0    0    0    0    0    0    0    0    0    0    0    0    0    0    0    0    0    0   21    0    0]
 [   0    0    0    0    0    0    0    0    0    0    0    0    0    0    0    0    0    0    0    0    0    0    0    0    0   32    0]
 [   0    0    0    0    0    0    0    0    0    0    0    0    0    0    0    0    0    0    0    0    0    0    0    0    0    0  110]]

Accuracy: 0.9519527508779397

Precision: [0.9695 0.8406 0.9545 0.7835 0.9186 0.4464 1.0000 0.6479 0.9914 0.9968 1.0000 0.7800 0.6875 0.5000 0.7640 0.9667 0.9464 0.7434 0.3875 0.6071 0.9847 0.9935 0.9899 0.6000 0.9444 1.0000 0.9817]
Mean: 0.8305934552120527
Std: 0.1878216636329183

Recall: [0.9500 0.9206 0.9793 0.6387 0.9937 0.5102 1.0000 0.9869 0.9914 0.9872 0.6466 0.8667 0.7333 0.6667 0.7987 0.9667 0.9815 0.6269 0.5536 0.5075 0.9847 0.9623 0.9860 0.4615 1.0000 0.9767 0.8770]
Mean: 0.8353415093231611
Std: 0.1829332149291307

F1 score: [0.9597 0.8788 0.9668 0.7037 0.9547 0.4762 1.0000 0.7822 0.9914 0.9920 0.7854 0.8211 0.7097 0.5714 0.7810 0.9667 0.9636 0.6802 0.4559 0.5528 0.9847 0.9776 0.9879 0.5217 0.9714 0.9882 0.9264]
Mean: 0.8278189817186886
Std: 0.17842006994063297

Cohen Kappa score: 0.9312883731167975
Confusion matrix:
[[8435   11    8   21   14    0    0  261    0    6    0   10    0    0   29    1   18    5   31    0   10    1   13    4    1    0    0]
 [   5   58    0    0    0    0    0    0    0    0    0    0    0    0    0    0    0    0    0    0    0    0    0    0    0    0    0]
 [   0    0  189    0    0    0    0    2    0    0    0    0    0    0    0    0    0    0    0    0    0    0    0    0    0    0    2]
 [  43    0    0   76    0    0    0    0    0    0    0    0    0    0    0    0    0    0    0    0    0    0    0    0    0    0    0]
 [   1    0    0    0  158    0    0    0    0    0    0    0    0    0    0    0    0    0    0    0    0    0    0    0    0    0    0]
 [   0    0    0    0    0   25    0    0    0    0    0    0    2    0    3    0    0    1    5   13    0    0    0    0    0    0    0]
 [   0    0    0    0    0    0   29    0    0    0    0    0    0    0    0    0    0    0    0    0    0    0    0    0    0    0    0]
 [   7    0    0    0    0    0    0  528    0    0    0    0    0    0    0    0    0    0    0    0    0    0    0    0    0    0    0]
 [   0    0    0    0    0    0    0    0  115    0    0    0    0    0    0    0    0    0    0    0    0    0    1    0    0    0    0]
 [  65    0    0    0    0    0    0    0    0 5016    0    0    0    0    0    0    0    0    0    0    0    0    0    0    0    0    0]
 [  46    0    0    0    0    0    0    0    0    0   86    1    0    0    0    0    0    0    0    0    0    0    0    0    0    0    0]
 [   1    0    0    0    0    0    0    0    0    5    0   39    0    0    0    0    0    0    0    0    0    0    0    0    0    0    0]
 [   0    0    0    0    0    4    0    0    0    0    0    0   33    0    1    0    0    6    0    1    0    0    0    0    0    0    0]
 [   0    0    0    0    0    1    0    0    0    0    0    0    1   10    1    0    0    1    0    1    0    0    0    0    0    0    0]
 [  12    0    0    0    0    7    0    0    0    0    0    0    1    0  123    0    0    1    4    6    0    0    0    0    0    0    0]
 [   0    0    0    0    0    0    0    0    0    0    0    0    0    0    0   29    0    0    0    0    0    0    1    0    0    0    0]
 [   6    0    0    0    0    0    0    0    0    0    0    0    0    0    0    0  318    0    0    0    0    0    0    0    0    0    0]
 [  16    0    0    0    0    6    0    0    0    0    0    0    1    1    2    0    0   84    7   17    0    0    0    0    0    0    0]
 [   6    0    0    0    0    2    0    0    0    0    0    0    1    1    2    0    0    7   31    6    0    0    0    0    0    0    0]
 [  28    0    0    0    0   11    0    0    0    0    0    0    9    8    0    0    0    8    2   68    0    0    0    0    0    0    0]
 [   0    0    1    0    0    0    0    9    0    0    0    0    0    0    0    0    0    0    0    0  642    0    0    0    0    0    0]
 [   4    0    0    0    0    0    0    2    0    0    0    0    0    0    0    0    0    0    0    0    0  153    0    0    0    0    0]
 [  20    0    0    0    0    0    0    0    1    0    0    0    0    0    0    0    0    0    0    0    0    0 1474    0    0    0    0]
 [   2    0    0    0    0    0    0    0    0    5    0    0    0    0    0    0    0    0    0    0    0    0    0    6    0    0    0]
 [   0    0    0    0    0    0    0    0    0    0    0    0    0    0    0    0    0    0    0    0    0    0    0    0   17    0    0]
 [   0    0    0    0    0    0    0    1    0    0    0    0    0    0    0    0    0    0    0    0    0    0    0    0    0   42    0]
 [   3    0    0    0    0    0    0   12    0    0    0    0    0    0    0    0    0    0    0    0    0    0    0    0    0    0  107]]

