Classifier: LinearSVC
Params: {'C': 1.0, 'class_weight': None, 'dual': True, 'fit_intercept': True, 'intercept_scaling': 1, 'loss': 'squared_hinge', 'max_iter': 1000, 'multi_class': 'ovr', 'penalty': 'l2', 'random_state': None, 'tol': 0.0001, 'verbose': 0}

Labels: None

Training accuracy: 0.9871270944013077
Training confusion matrix:
[[9475    0    0    0    0    0    0    0    0    0    0    0    0    0    0    0    0    0    0    0    0    0    0    0    0    0    0]
 [   0  235    0    0    0    0    0    0    0    0    0    0    0    0    0    0    0    0    0    0    0    0    0    0    0    0    0]
 [   0    0  167    0    0    0    0    0    0    0    0    0    0    0    0    0    0    0    0    0    0    0    0    0    0    0    0]
 [   0    0    0  125    0    0    0    0    0    0    0    0    0    0    0    0    0    0    0    0    0    0    0    0    0    0    0]
 [   0    0    0    0   93    0    0    0    0    0    0    0    0    0    0    0    0    0    0    0    0    0    0    0    0    0    0]
 [   0    0    0    0    0  106    0    0    0    0    0    0    4    3    0    0    0    2    1   27    0    0    0    0    0    0    0]
 [   0    0    0    0    0    0  122    0    0    0    0    0    0    0    0    0    0    0    0    0    0    0    0    0    0    0    0]
 [   0    0    0    0    0    0    0  710    0    0    0    0    0    0    0    0    0    0    0    0    0    0    0    0    0    0    0]
 [   0    0    0    0    0    0    0    0  108    0    0    0    0    0    0    0    0    0    0    0    0    0    0    0    0    0    0]
 [   0    0    0    0    0    0    0    0    0 3471    0    0    0    0    0    0    0    0    0    0    0    0    0    0    0    0    0]
 [   0    0    0    0    0    0    0    0    0    0  136    0    0    0    0    0    0    0    0    0    0    0    0    0    0    0    0]
 [   0    0    0    0    0    0    0    0    0    0    0 1432    0    0    0    0    0    0    0    0    0    0    0    0    0    0    0]
 [   0    0    0    0    0    2    0    0    0    0    0    0   68    7    0    0    0    7    0    6    0    0    0    0    0    0    0]
 [   0    0    0    0    0    6    0    0    0    0    0    0    2   82    1    0    0    2    0    0    0    0    0    0    0    0    0]
 [   0    0    0    0    0    0    0    0    0    0    0    0    0    2  238    0    0    0    3    1    0    0    0    0    0    0    0]
 [   0    0    0    0    0    0    0    0    0    0    0    0    0    0    0   38    0    0    0    0    0    0    0    0    0    0    0]
 [   0    0    0    0    0    0    0    0    0    0    0    0    0    0    0    0  189    0    0    0    0    0    0    0    0    0    0]
 [   0    0    0    0    0    9    0    0    0    0    0    0    8   10    0    0    0  160    1   30    0    0    0    0    0    0    0]
 [   0    0    0    0    0    0    0    0    0    0    0    0    0    1   16    0    0    0   82    3    0    0    0    0    0    0    0]
 [   0    0    0    0    0    6    0    0    0    0    0    0   24   13    1    0    0   49    4  235    0    0    0    0    0    0    0]
 [   0    0    0    0    0    0    0    1    0    0    0    0    0    0    0    0    0    0    0    0  595    0    0    0    0    0    0]
 [   0    0    0    0    0    0    0    0    0    0    0    0    0    0    0    0    0    0    0    0    0  111    0    0    0    0    0]
 [   0    0    0    0    0    0    0    0    0    0    0    0    0    0    0    0    0    0    0    0    0    0 1151    0    0    0    0]
 [   0    0    0    0    0    0    0    0    0    0    0    0    0    0    0    0    0    0    0    0    0    0    0   32    0    0    0]
 [   0    0    0    0    0    0    0    0    0    0    0    0    0    0    0    0    0    0    0    0    0    0    0    0   21    0    0]
 [   0    0    0    0    0    0    0    0    0    0    0    0    0    0    0    0    0    0    0    0    0    0    0    0    0   32    0]
 [   0    0    0    0    0    0    0    0    0    0    0    0    0    0    0    0    0    0    0    0    0    0    0    0    0    0  110]]

Accuracy: 0.9419495583696924

Precision: [0.9810 0.8806 0.9585 0.8350 0.9226 0.4444 0.8056 0.7280 0.9828 0.9347 0.9551 0.5909 0.6667 0.6154 0.7725 0.9677 0.9435 0.7556 0.3762 0.5697 0.9785 0.9740 0.9960 0.6000 0.8095 1.0000 0.9780]
Mean: 0.8156434818736679
Std: 0.17983876045465974

Recall: [0.9252 0.9365 0.9585 0.7227 0.9748 0.4082 1.0000 0.9907 0.9828 0.9943 0.6391 0.8667 0.7556 0.5333 0.8377 1.0000 0.9784 0.5075 0.6786 0.7015 0.9770 0.9434 0.9873 0.4615 1.0000 0.9535 0.7295]
Mean: 0.8312639927074179
Std: 0.18533099153294622

F1 score: [0.9523 0.9077 0.9585 0.7748 0.9480 0.4255 0.8923 0.8393 0.9828 0.9636 0.7658 0.7027 0.7083 0.5714 0.8037 0.9836 0.9606 0.6071 0.4841 0.6288 0.9777 0.9585 0.9916 0.5217 0.8947 0.9762 0.8357]
Mean: 0.8154477672002031
Std: 0.1716739516123127

Cohen Kappa score: 0.9173354714250399
Confusion matrix:
[[8215    8    6   14   12    0    0  159    0  333    0   27    0    0   16    0   17   12   32    0   13    3    5    3    3    0    1]
 [   4   59    0    0    0    0    0    0    0    0    0    0    0    0    0    0    0    0    0    0    0    0    0    0    0    0    0]
 [   5    0  185    0    0    0    0    3    0    0    0    0    0    0    0    0    0    0    0    0    0    0    0    0    0    0    0]
 [  33    0    0   86    0    0    0    0    0    0    0    0    0    0    0    0    0    0    0    0    0    0    0    0    0    0    0]
 [   4    0    0    0  155    0    0    0    0    0    0    0    0    0    0    0    0    0    0    0    0    0    0    0    0    0    0]
 [   0    0    0    0    0   20    0    0    0    0    0    0    4    0    2    0    0    1    6   16    0    0    0    0    0    0    0]
 [   0    0    0    0    0    0   29    0    0    0    0    0    0    0    0    0    0    0    0    0    0    0    0    0    0    0    0]
 [   3    0    0    0    0    0    0  530    0    1    0    0    0    0    0    0    0    0    0    0    1    0    0    0    0    0    0]
 [   1    0    0    0    0    0    0    0  114    0    0    0    0    0    0    0    0    0    0    0    0    0    1    0    0    0    0]
 [  10    0    1    0    1    6    7    0    0 5052    0    0    0    0    0    0    0    0    0    2    0    1    0    0    0    0    1]
 [  46    0    0    0    0    0    0    0    0    1   85    0    0    0    0    0    0    0    0    0    0    0    0    1    0    0    0]
 [   3    0    0    0    0    0    0    0    0    3    0   39    0    0    0    0    0    0    0    0    0    0    0    0    0    0    0]
 [   0    0    0    0    0    3    0    0    0    0    0    0   34    0    0    0    0    1    4    3    0    0    0    0    0    0    0]
 [   0    0    0    0    0    0    0    0    0    0    0    0    2    8    0    0    0    1    0    4    0    0    0    0    0    0    0]
 [   3    0    0    1    0    9    0    0    0    0    0    0    0    0  129    0    0    1    1   10    0    0    0    0    0    0    0]
 [   0    0    0    0    0    0    0    0    0    0    0    0    0    0    0   30    0    0    0    0    0    0    0    0    0    0    0]
 [   7    0    0    0    0    0    0    0    0    0    0    0    0    0    0    0  317    0    0    0    0    0    0    0    0    0    0]
 [   5    0    0    0    0    2    0    0    0    2    1    0    3    1   12    0    0   68   13   27    0    0    0    0    0    0    0]
 [   0    0    0    1    0    2    0    0    0    0    0    0    0    1    2    0    0    3   38    9    0    0    0    0    0    0    0]
 [   0    0    0    0    0    3    0    0    0   10    0    0    8    3    6    0    0    3    7   94    0    0    0    0    0    0    0]
 [   3    0    1    1    0    0    0    8    1    0    0    0    0    0    0    0    0    0    0    0  637    0    0    0    1    0    0]
 [   4    0    0    0    0    0    0    3    0    0    1    0    0    0    0    1    0    0    0    0    0  150    0    0    0    0    0]
 [  15    0    0    0    0    0    0    0    1    0    2    0    0    0    0    0    1    0    0    0    0    0 1476    0    0    0    0]
 [   4    0    0    0    0    0    0    0    0    3    0    0    0    0    0    0    0    0    0    0    0    0    0    6    0    0    0]
 [   0    0    0    0    0    0    0    0    0    0    0    0    0    0    0    0    0    0    0    0    0    0    0    0   17    0    0]
 [   1    0    0    0    0    0    0    1    0    0    0    0    0    0    0    0    0    0    0    0    0    0    0    0    0   41    0]
 [   8    0    0    0    0    0    0   24    0    0    0    0    0    0    0    0    1    0    0    0    0    0    0    0    0    0   89]]

