Classifier: LogisticRegression
Params: {'C': 1.0, 'class_weight': None, 'dual': False, 'fit_intercept': True, 'intercept_scaling': 1, 'max_iter': 100, 'multi_class': 'ovr', 'n_jobs': 1, 'penalty': 'l2', 'random_state': None, 'solver': 'liblinear', 'tol': 0.0001, 'verbose': 0, 'warm_start': False}

Labels: None

Training accuracy: 0.985032693093584
Training confusion matrix:
[[9465    2    1    0    0    0    0    2    0    0    1    0    0    0    0    0    0    0    0    0    1    1    1    0    1    0    0]
 [   0  235    0    0    0    0    0    0    0    0    0    0    0    0    0    0    0    0    0    0    0    0    0    0    0    0    0]
 [   0    0  167    0    0    0    0    0    0    0    0    0    0    0    0    0    0    0    0    0    0    0    0    0    0    0    0]
 [   0    0    0  125    0    0    0    0    0    0    0    0    0    0    0    0    0    0    0    0    0    0    0    0    0    0    0]
 [   0    0    0    0   93    0    0    0    0    0    0    0    0    0    0    0    0    0    0    0    0    0    0    0    0    0    0]
 [   0    0    0    0    0  106    0    0    0    0    0    0    4    2    0    0    0    1    1   29    0    0    0    0    0    0    0]
 [   0    0    0    0    0    0  122    0    0    0    0    0    0    0    0    0    0    0    0    0    0    0    0    0    0    0    0]
 [   0    0    0    0    0    0    0  706    0    0    0    0    0    0    0    0    0    0    0    0    4    0    0    0    0    0    0]
 [   0    0    0    0    0    0    0    0  108    0    0    0    0    0    0    0    0    0    0    0    0    0    0    0    0    0    0]
 [   2    0    0    0    0    0    0    0    0 3469    0    0    0    0    0    0    0    0    0    0    0    0    0    0    0    0    0]
 [   0    0    0    0    0    0    0    0    0    0  136    0    0    0    0    0    0    0    0    0    0    0    0    0    0    0    0]
 [   0    0    0    0    0    0    0    0    0    0    0 1432    0    0    0    0    0    0    0    0    0    0    0    0    0    0    0]
 [   0    0    0    0    0    4    0    0    0    0    0    0   57    7    0    0    0    9    0   13    0    0    0    0    0    0    0]
 [   0    0    0    0    0    8    0    0    0    0    0    0    2   78    1    0    0    2    0    2    0    0    0    0    0    0    0]
 [   0    0    0    0    0    0    0    0    0    0    0    0    0    2  232    0    0    0    8    2    0    0    0    0    0    0    0]
 [   1    0    0    0    0    0    0    0    0    0    0    0    0    0    0   37    0    0    0    0    0    0    0    0    0    0    0]
 [   0    0    0    0    0    0    0    0    0    0    0    0    0    0    0    0  189    0    0    0    0    0    0    0    0    0    0]
 [   0    0    0    0    0    9    0    0    0    0    0    0    5    9    0    0    0  157    1   37    0    0    0    0    0    0    0]
 [   0    0    0    0    0    1    0    0    0    0    0    0    0    1   15    0    0    0   79    6    0    0    0    0    0    0    0]
 [   1    0    0    0    0    8    0    0    0    0    0    0   24   11    2    0    0   43    3  240    0    0    0    0    0    0    0]
 [   2    0    0    0    0    0    0    0    0    0    0    0    0    0    0    0    0    0    0    0  594    0    0    0    0    0    0]
 [   0    0    0    0    0    0    0    0    0    0    0    0    0    0    0    0    0    0    0    0    0  111    0    0    0    0    0]
 [   0    0    0    0    0    0    0    0    0    0    0    0    0    0    0    0    0    0    0    0    0    0 1151    0    0    0    0]
 [   0    0    0    0    0    0    0    0    0    0    0    0    0    0    0    0    0    0    0    0    0    0    0   32    0    0    0]
 [   0    0    0    1    0    0    0    0    0    0    0    0    0    0    0    0    0    0    0    0    0    0    0    0   20    0    0]
 [   0    0    0    0    0    0    0    0    0    0    0    0    0    0    0    0    0    0    0    0    0    0    0    0    0   32    0]
 [   0    0    0    0    0    0    0    0    0    0    0    0    0    0    0    0    0    0    0    0    0    0    0    0    0    0  110]]

Accuracy: 0.9508353729913802

Precision: [0.9746 0.9077 0.9733 0.8556 0.9870 0.5000 1.0000 0.7765 0.9914 0.9488 0.9579 0.6000 0.6441 0.8182 0.8344 1.0000 0.9488 0.9070 0.5263 0.6074 0.9771 0.9935 0.9933 0.7500 0.9412 1.0000 0.9684]
Mean: 0.8660068177020487
Std: 0.15577081252319497

Recall: [0.9453 0.9365 0.9430 0.6471 0.9560 0.5306 0.8276 0.9869 0.9914 0.9888 0.6842 0.9333 0.8444 0.6000 0.8506 0.9333 0.9722 0.5821 0.5357 0.7388 0.9801 0.9560 0.9926 0.4615 0.9412 0.9302 0.7541]
Mean: 0.8312449436514892
Std: 0.16708128491451327

F1 score: [0.9597 0.9219 0.9579 0.7368 0.9712 0.5149 0.9057 0.8691 0.9914 0.9684 0.7982 0.7304 0.7308 0.6923 0.8424 0.9655 0.9604 0.7091 0.5310 0.6667 0.9786 0.9744 0.9930 0.5714 0.9412 0.9639 0.8479]
Mean: 0.8405208361320932
Std: 0.14806313134776747

Cohen Kappa score: 0.9295519469430866
Confusion matrix:
[[8393    6    5   12    1    0    0  118    0  252    0   28    0    0   11    0   17    0   11    0   12    1    8    2    1    0    1]
 [   4   59    0    0    0    0    0    0    0    0    0    0    0    0    0    0    0    0    0    0    0    0    0    0    0    0    0]
 [   4    0  182    0    1    0    0    3    0    0    0    0    0    0    0    0    0    0    0    0    1    0    0    0    0    0    2]
 [  42    0    0   77    0    0    0    0    0    0    0    0    0    0    0    0    0    0    0    0    0    0    0    0    0    0    0]
 [   6    0    0    0  152    0    0    1    0    0    0    0    0    0    0    0    0    0    0    0    0    0    0    0    0    0    0]
 [   0    0    0    0    0   26    0    0    0    0    0    0    3    0    2    0    0    1    1   16    0    0    0    0    0    0    0]
 [   4    0    0    0    0    0   24    1    0    0    0    0    0    0    0    0    0    0    0    0    0    0    0    0    0    0    0]
 [   5    0    0    0    0    0    0  528    0    0    1    0    0    0    0    0    0    0    0    0    1    0    0    0    0    0    0]
 [   0    0    0    0    0    0    0    0  115    0    0    0    0    0    0    0    0    0    0    0    0    0    1    0    0    0    0]
 [  57    0    0    0    0    0    0    0    0 5024    0    0    0    0    0    0    0    0    0    0    0    0    0    0    0    0    0]
 [  40    0    0    0    0    0    0    0    0    2   91    0    0    0    0    0    0    0    0    0    0    0    0    0    0    0    0]
 [   0    0    0    0    0    0    0    0    0    3    0   42    0    0    0    0    0    0    0    0    0    0    0    0    0    0    0]
 [   0    0    0    0    0    3    0    0    0    0    0    0   38    0    0    0    0    1    0    3    0    0    0    0    0    0    0]
 [   0    0    0    0    0    0    0    0    0    0    0    0    2    9    0    0    0    0    0    4    0    0    0    0    0    0    0]
 [   3    0    0    0    0    9    0    1    0    0    0    0    2    0  131    0    0    1    1    6    0    0    0    0    0    0    0]
 [   0    0    0    0    0    0    0    1    0    0    0    0    0    0    0   28    0    0    0    0    0    0    1    0    0    0    0]
 [   9    0    0    0    0    0    0    0    0    0    0    0    0    0    0    0  315    0    0    0    0    0    0    0    0    0    0]
 [   6    0    0    0    0    4    0    0    0    1    1    0    3    1    4    0    0   78   11   25    0    0    0    0    0    0    0]
 [   0    0    0    1    0    6    0    0    0    0    0    0    2    1    2    0    0    4   30   10    0    0    0    0    0    0    0]
 [   2    0    0    0    0    4    0    0    0    9    0    0    9    0    7    0    0    1    3   99    0    0    0    0    0    0    0]
 [   8    0    0    0    0    0    0    5    0    0    0    0    0    0    0    0    0    0    0    0  639    0    0    0    0    0    0]
 [   5    0    0    0    0    0    0    1    0    0    0    0    0    0    0    0    0    0    0    0    1  152    0    0    0    0    0]
 [   8    0    0    0    0    0    0    0    1    0    2    0    0    0    0    0    0    0    0    0    0    0 1484    0    0    0    0]
 [   3    0    0    0    0    0    0    0    0    4    0    0    0    0    0    0    0    0    0    0    0    0    0    6    0    0    0]
 [   1    0    0    0    0    0    0    0    0    0    0    0    0    0    0    0    0    0    0    0    0    0    0    0   16    0    0]
 [   2    0    0    0    0    0    0    1    0    0    0    0    0    0    0    0    0    0    0    0    0    0    0    0    0   40    0]
 [  10    0    0    0    0    0    0   20    0    0    0    0    0    0    0    0    0    0    0    0    0    0    0    0    0    0   92]]

