Classifier: MLPClassifier
Params: {'activation': 'relu', 'alpha': 0.0001, 'batch_size': 'auto', 'beta_1': 0.9, 'beta_2': 0.999, 'early_stopping': False, 'epsilon': 1e-08, 'hidden_layer_sizes': (100,), 'learning_rate': 'constant', 'learning_rate_init': 0.001, 'max_iter': 200, 'momentum': 0.9, 'nesterovs_momentum': True, 'power_t': 0.5, 'random_state': None, 'shuffle': True, 'solver': 'adam', 'tol': 0.0001, 'validation_fraction': 0.1, 'verbose': False, 'warm_start': False}

Labels: None

Training accuracy: 0.9868716796076829
Training confusion matrix:
[[9475    0    0    0    0    0    0    0    0    0    0    0    0    0    0    0    0    0    0    0    0    0    0    0    0    0    0]
 [   0  235    0    0    0    0    0    0    0    0    0    0    0    0    0    0    0    0    0    0    0    0    0    0    0    0    0]
 [   0    0  167    0    0    0    0    0    0    0    0    0    0    0    0    0    0    0    0    0    0    0    0    0    0    0    0]
 [   0    0    0  125    0    0    0    0    0    0    0    0    0    0    0    0    0    0    0    0    0    0    0    0    0    0    0]
 [   0    0    0    0   93    0    0    0    0    0    0    0    0    0    0    0    0    0    0    0    0    0    0    0    0    0    0]
 [   0    0    0    0    0  135    0    0    0    0    0    0    0    5    0    0    0    1    1    1    0    0    0    0    0    0    0]
 [   0    0    0    0    0    0  122    0    0    0    0    0    0    0    0    0    0    0    0    0    0    0    0    0    0    0    0]
 [   0    0    0    0    0    0    0  709    0    0    0    0    0    0    0    0    0    0    0    0    1    0    0    0    0    0    0]
 [   0    0    0    0    0    0    0    0  108    0    0    0    0    0    0    0    0    0    0    0    0    0    0    0    0    0    0]
 [   0    0    0    0    0    0    0    0    0 3471    0    0    0    0    0    0    0    0    0    0    0    0    0    0    0    0    0]
 [   0    0    0    0    0    0    0    0    0    0  136    0    0    0    0    0    0    0    0    0    0    0    0    0    0    0    0]
 [   0    0    0    0    0    0    0    0    0    0    0 1432    0    0    0    0    0    0    0    0    0    0    0    0    0    0    0]
 [   0    0    0    0    0    9    0    0    0    0    0    0   39   11    0    0    0   16    0   15    0    0    0    0    0    0    0]
 [   0    0    0    0    0    4    0    0    0    0    0    0    0   87    0    0    0    2    0    0    0    0    0    0    0    0    0]
 [   0    0    0    0    0    0    0    0    0    0    0    0    0    2  238    0    0    0    4    0    0    0    0    0    0    0    0]
 [   0    0    0    0    0    0    0    0    0    0    0    0    0    0    0   38    0    0    0    0    0    0    0    0    0    0    0]
 [   0    0    0    0    0    0    0    0    0    0    0    0    0    0    0    0  189    0    0    0    0    0    0    0    0    0    0]
 [   0    0    0    0    0    9    0    0    0    0    0    0    0    9    0    0    0  194    1    5    0    0    0    0    0    0    0]
 [   0    0    0    0    0    2    0    0    0    0    0    0    0    1   17    0    0    0   81    1    0    0    0    0    0    0    0]
 [   0    0    0    0    0   36    0    0    0    0    0    0    9   14    1    0    0   75    5  192    0    0    0    0    0    0    0]
 [   0    0    0    0    0    0    0    0    0    0    0    0    0    0    0    0    0    0    0    0  596    0    0    0    0    0    0]
 [   0    0    0    0    0    0    0    0    0    0    0    0    0    0    0    0    0    0    0    0    0  111    0    0    0    0    0]
 [   0    0    0    0    0    0    0    0    0    0    0    0    0    0    0    0    0    0    0    0    0    0 1151    0    0    0    0]
 [   0    0    0    0    0    0    0    0    0    0    0    0    0    0    0    0    0    0    0    0    0    0    0   32    0    0    0]
 [   0    0    0    0    0    0    0    0    0    0    0    0    0    0    0    0    0    0    0    0    0    0    0    0   21    0    0]
 [   0    0    0    0    0    0    0    0    0    0    0    0    0    0    0    0    0    0    0    0    0    0    0    0    0   32    0]
 [   0    0    0    0    0    0    0    0    0    0    0    0    0    0    0    0    0    0    0    0    0    0    0    0    0    0  110]]

Accuracy: 0.9389166755347451

Precision: [0.9669 0.9194 0.9733 0.8415 0.9803 0.4848 1.0000 0.7357 0.9914 0.9348 1.0000 0.2923 0.7391 0.6250 0.8947 1.0000 0.9186 0.8108 0.6744 0.5643 0.9802 0.9934 0.9986 0.6667 0.8000 1.0000 0.9894]
Mean: 0.8435382788306384
Std: 0.18488520773677894

Recall: [0.9311 0.9048 0.9430 0.5798 0.9371 0.6531 0.7931 0.9888 0.9914 0.9845 0.6617 0.8444 0.7556 0.6667 0.7727 1.0000 0.9753 0.4478 0.5179 0.5896 0.9847 0.9497 0.9839 0.4615 0.9412 0.9070 0.7623]
Mean: 0.8121618079937959
Std: 0.17615400776660506

F1 score: [0.9486 0.9120 0.9579 0.6866 0.9582 0.5565 0.8846 0.8437 0.9914 0.9590 0.7964 0.4343 0.7473 0.6452 0.8293 1.0000 0.9461 0.5769 0.5859 0.5766 0.9824 0.9711 0.9912 0.5455 0.8649 0.9512 0.8611]
Mean: 0.8149530530853005
Std: 0.17046945840953104

Cohen Kappa score: 0.9125732449138824
Confusion matrix:
[[8267    5    5   12    3    0    0  151    0  320    0   74    0    0    2    0   20    0    0    0   11    1    0    3    4    0    1]
 [   6   57    0    0    0    0    0    0    0    0    0    0    0    0    0    0    0    0    0    0    0    0    0    0    0    0    0]
 [   5    0  182    0    0    0    0    6    0    0    0    0    0    0    0    0    0    0    0    0    0    0    0    0    0    0    0]
 [  42    0    0   69    0    0    0    0    0    0    0    0    0    0    0    0    8    0    0    0    0    0    0    0    0    0    0]
 [   8    0    0    0  149    0    0    1    0    0    0    0    0    0    0    0    0    0    0    0    1    0    0    0    0    0    0]
 [   0    0    0    0    0   32    0    0    0    0    0    0    4    0    0    0    0    1    1   11    0    0    0    0    0    0    0]
 [   4    0    0    0    0    0   23    1    0    0    0    0    0    0    0    0    0    0    0    0    0    0    1    0    0    0    0]
 [   5    0    0    0    0    0    0  529    0    0    0    0    0    0    0    0    0    0    0    0    1    0    0    0    0    0    0]
 [   0    0    0    0    0    0    0    0  115    0    0    0    0    0    0    0    0    0    0    0    0    0    1    0    0    0    0]
 [  59    0    0    0    0    0    0    0    0 5002    0   18    0    0    0    0    0    0    0    2    0    0    0    0    0    0    0]
 [  44    0    0    0    0    0    0    0    0    1   88    0    0    0    0    0    0    0    0    0    0    0    0    0    0    0    0]
 [   4    0    0    0    0    0    0    0    0    3    0   38    0    0    0    0    0    0    0    0    0    0    0    0    0    0    0]
 [   0    0    0    0    0    4    0    0    0    0    0    0   34    0    0    0    0    2    0    5    0    0    0    0    0    0    0]
 [   0    0    0    0    0    1    0    0    0    0    0    0    1   10    0    0    0    1    0    2    0    0    0    0    0    0    0]
 [  14    0    0    0    0    9    0    0    0    1    0    0    1    0  119    0    0    2    1    7    0    0    0    0    0    0    0]
 [   0    0    0    0    0    0    0    0    0    0    0    0    0    0    0   30    0    0    0    0    0    0    0    0    0    0    0]
 [   8    0    0    0    0    0    0    0    0    0    0    0    0    0    0    0  316    0    0    0    0    0    0    0    0    0    0]
 [  19    0    0    0    0    3    0    0    0   10    0    0    1    1    4    0    0   60    8   28    0    0    0    0    0    0    0]
 [   7    0    0    1    0    7    0    0    0    0    0    0    0    1    2    0    0    3   29    6    0    0    0    0    0    0    0]
 [   8    0    0    0    0   10    0    1    0   12    0    0    5    4    6    0    0    5    4   79    0    0    0    0    0    0    0]
 [   5    0    0    0    0    0    0    5    0    0    0    0    0    0    0    0    0    0    0    0  642    0    0    0    0    0    0]
 [   6    0    0    0    0    0    0    2    0    0    0    0    0    0    0    0    0    0    0    0    0  151    0    0    0    0    0]
 [  23    0    0    0    0    0    0    0    1    0    0    0    0    0    0    0    0    0    0    0    0    0 1471    0    0    0    0]
 [   5    0    0    0    0    0    0    0    0    2    0    0    0    0    0    0    0    0    0    0    0    0    0    6    0    0    0]
 [   1    0    0    0    0    0    0    0    0    0    0    0    0    0    0    0    0    0    0    0    0    0    0    0   16    0    0]
 [   3    0    0    0    0    0    0    1    0    0    0    0    0    0    0    0    0    0    0    0    0    0    0    0    0   39    0]
 [   7    0    0    0    0    0    0   22    0    0    0    0    0    0    0    0    0    0    0    0    0    0    0    0    0    0   93]]

