Classifier: MultinomialNB
Params: {'alpha': 1.0, 'class_prior': None, 'fit_prior': True}

Labels: None

Training accuracy: 0.9072844299141807
Training confusion matrix:
[[8671   77    5   39    0    0    0   32    0    9  163    0    0    0  104    0   93    1    0  107   14    0    4   20   93    0   43]
 [   1  234    0    0    0    0    0    0    0    0    0    0    0    0    0    0    0    0    0    0    0    0    0    0    0    0    0]
 [   0    0  140    0    1    0    5   13    0    0    0    0    0    0    0    0    0    0    0    0    8    0    0    0    0    0    0]
 [   2    0    0  102    0    0    0    0    0    0    0    0    0    0    0    0   21    0    0    0    0    0    0    0    0    0    0]
 [   0    0    0    0   85    0    6    0    0    0    0    0    0    0    0    0    1    0    0    0    0    0    1    0    0    0    0]
 [   1    0    0    0    0    4    0    0    0    0    0    0    0    0    2    0    0    0    0  136    0    0    0    0    0    0    0]
 [   0    0    0    0    0    0  122    0    0    0    0    0    0    0    0    0    0    0    0    0    0    0    0    0    0    0    0]
 [   0    0    2    0    9    0   11  674    0    0    0    0    0    0    0    0    1    0    0    0   12    0    1    0    0    0    0]
 [   0    0    0    0    0    0    4    0  102    0    0    0    0    0    0    0    0    0    0    0    0    0    2    0    0    0    0]
 [  95    0    0    4    0    0    0    0    0 3343    0    1    0    0    2    0    5    0    0    0    0    0   21    0    0    0    0]
 [   0    0    0    0    0    0    0    0    0    0  136    0    0    0    0    0    0    0    0    0    0    0    0    0    0    0    0]
 [  14    0    0    0    0    0    0    0    0    4    0 1414    0    0    0    0    0    0    0    0    0    0    0    0    0    0    0]
 [   0    0    0    0    0    0    0    0    0    0    0    0    0    0    1    0    0    2    0   87    0    0    0    0    0    0    0]
 [   0    0    0    0    0    0    0    0    0    0    0    0    0    1    2    0    0    2    0   88    0    0    0    0    0    0    0]
 [   0    0    0    1    0    0    0    0    0    0    0    0    0    0  187    0    0   10    0   43    0    1    2    0    0    0    0]
 [   0    0    1    0    0    0    3    0    0    0    0    0    0    0    0   33    0    0    0    0    0    0    0    0    0    0    1]
 [   1    0    0    1    2    0    2    0    0    0    0    0    0    0    0    0  182    0    0    0    0    0    0    0    1    0    0]
 [   0    0    0    0    0    0    0    0    0    0    0    0    0    0    0    0    0   31    0  187    0    0    0    0    0    0    0]
 [   0    0    0    0    0    0    0    0    0    0    0    0    0    0   54    0    0    4    3   41    0    0    0    0    0    0    0]
 [   0    0    0    0    0    0    0    0    0    0    0    0    0    0    0    0    0    0    0  332    0    0    0    0    0    0    0]
 [   0    0    0    0    0    0    0    0    0    0    0    0    0    0    0    0    0    0    0    0  595    0    1    0    0    0    0]
 [   0    0    1    0    0    0    0    4    0    0    0    0    0    0    0    0    0    0    0    0   30   73    3    0    0    0    0]
 [   0    0    1    0    7    0    6    1    0    0    0    0    0    0    0    0    0    0    0    0    0    0 1136    0    0    0    0]
 [   1    6    0    0    0    0    0    0    0    0    0    0    0    0    0    0    0    0    0    0    0    0    0   25    0    0    0]
 [   1    0    0    0    0    0    0    0    0    0    0    0    0    0    0    0    1    0    0    0    0    0    0    0   19    0    0]
 [   0    0    1    0    0    0    1    4    0    0    0    0    0    0    0    0    0    0    0    0    1    0    5    0    0   15    5]
 [   0    0    2    0    0    0    2    2    0    0    0    0    0    0    0    0    0    0    0    0    2    0    0    0    0    0  102]]

Accuracy: 0.8472916888368628

Precision: [0.9073 0.4758 0.7889 0.2511 0.8247 0.8571 0.6250 0.5832 0.9421 0.9733 0.5217 0.5714 0.0000 1.0000 0.4971 0.0811 0.4363 0.4464 0.2917 0.3115 0.8301 0.9481 0.9658 0.2778 0.1705 1.0000 0.2787]
Mean: 0.5872832718480224
Std: 0.30621454444161345

Recall: [0.8428 0.9365 0.7358 0.4874 0.7987 0.1224 0.8621 0.9495 0.9828 0.8884 0.6316 0.1778 0.0000 0.2667 0.5649 0.2000 0.9722 0.1866 0.2500 0.7463 0.9739 0.4591 0.9826 0.3846 0.8824 0.3256 0.2787]
Mean: 0.5884925112507389
Std: 0.319924658893874

F1 score: [0.8738 0.6310 0.7614 0.3314 0.8115 0.2143 0.7246 0.7226 0.9620 0.9289 0.5714 0.2712 0.0000 0.4211 0.5289 0.1154 0.6023 0.2632 0.2692 0.4396 0.8963 0.6186 0.9741 0.3226 0.2857 0.4912 0.2787]
Mean: 0.5300391818696197
Std: 0.27309450503106997

Cohen Kappa score: 0.7865485961129264
Confusion matrix:
[[7483   64   21  159   11    0    0  263    0  122   75    4    0    0   66    3  341   15   15   24   37    3   11   13   72    0   77]
 [   4   59    0    0    0    0    0    0    0    0    0    0    0    0    0    0    0    0    0    0    0    0    0    0    0    0    0]
 [   0    0  142    0    5    0    0   28    0    0    0    0    0    0    0    0    3    0    0    0   13    0    0    0    0    0    2]
 [  33    0    0   58    0    0    0    0    0    0    0    0    0    0    0    0   25    0    0    0    0    0    3    0    0    0    0]
 [   0    0    0    5  127    0    5    1    0    0    0    0    0    0    0    6   10    0    0    0    1    0    3    0    0    0    1]
 [   0    0    0    0    0    6    0    0    0    0    0    0    0    0    0    0    0    0    0   43    0    0    0    0    0    0    0]
 [   0    0    0    0    0    0   25    0    0    0    0    0    0    0    0    0    3    0    0    0    0    0    1    0    0    0    0]
 [   0    0    5    0    5    0    5  508    0    0    0    0    0    0    0    0    7    0    0    0    4    0    1    0    0    0    0]
 [   0    0    0    0    0    0    0    0  114    0    0    0    0    0    0    0    1    0    0    0    0    0    1    0    0    0    0]
 [ 563    0    0    1    0    0    0    0    0 4514    1    2    0    0    0    0    0    0    0    0    0    0    0    0    0    0    0]
 [  49    0    0    0    0    0    0    0    0    0   84    0    0    0    0    0    0    0    0    0    0    0    0    0    0    0    0]
 [  35    0    0    0    0    0    0    0    0    2    0    8    0    0    0    0    0    0    0    0    0    0    0    0    0    0    0]
 [   0    0    0    0    0    0    0    0    0    0    0    0    0    0    0    0    0    7    0   38    0    0    0    0    0    0    0]
 [   0    0    0    0    0    0    0    0    0    0    0    0    0    4    0    0    0    0    0   11    0    0    0    0    0    0    0]
 [  18    0    3    5    0    0    0    1    0    0    1    0    0    0   87    0    0    0    0   26    5    0    8    0    0    0    0]
 [   0    0    1    0    1    0    1    0    0    0    0    0    0    0    0    6    2    0    0    0    0    0   17    0    0    0    2]
 [   6    0    0    0    1    0    1    0    0    0    0    0    0    0    0    0  315    0    0    0    0    0    0    0    1    0    0]
 [  26    1    1    2    0    0    0    0    0    0    0    0    0    0   11    0    0   25   17   51    0    0    0    0    0    0    0]
 [   2    0    0    1    0    0    0    0    0    0    0    0    0    0    5    0    0    6   14   28    0    0    0    0    0    0    0]
 [  14    0    0    0    0    1    0    0    0    0    0    0    0    0    6    1    0    3    2  100    2    0    5    0    0    0    0]
 [   4    0    2    0    0    0    0    7    0    0    0    0    0    0    0    0    1    0    0    0  635    0    0    0    0    0    3]
 [   0    0    4    0    0    0    0   23    0    0    0    0    0    0    0    0    0    0    0    0   58   73    1    0    0    0    0]
 [   1    0    0    0    2    0    0    0    7    0    0    0    0    0    0    1   13    0    0    0    0    1 1469    0    0    0    1]
 [   8    0    0    0    0    0    0    0    0    0    0    0    0    0    0    0    0    0    0    0    0    0    0    5    0    0    0]
 [   2    0    0    0    0    0    0    0    0    0    0    0    0    0    0    0    0    0    0    0    0    0    0    0   15    0    0]
 [   0    0    0    0    1    0    3   12    0    0    0    0    0    0    0    0    1    0    0    0    9    0    1    0    0   14    2]
 [   0    0    1    0    1    0    0   28    0    0    0    0    0    0    0   57    0    0    0    0    1    0    0    0    0    0   34]]

