Classifier: RandomForestClassifier
Params: {'bootstrap': True, 'class_weight': None, 'criterion': 'gini', 'max_depth': None, 'max_features': 'auto', 'max_leaf_nodes': None, 'min_impurity_decrease': 0.0, 'min_impurity_split': None, 'min_samples_leaf': 1, 'min_samples_split': 2, 'min_weight_fraction_leaf': 0.0, 'n_estimators': 100, 'n_jobs': 1, 'oob_score': False, 'random_state': None, 'verbose': 0, 'warm_start': False}

Labels: None

Training accuracy: 0.993205966489579
Training confusion matrix:
[[9475    0    0    0    0    0    0    0    0    0    0    0    0    0    0    0    0    0    0    0    0    0    0    0    0    0    0]
 [   0  235    0    0    0    0    0    0    0    0    0    0    0    0    0    0    0    0    0    0    0    0    0    0    0    0    0]
 [   0    0  167    0    0    0    0    0    0    0    0    0    0    0    0    0    0    0    0    0    0    0    0    0    0    0    0]
 [   0    0    0  125    0    0    0    0    0    0    0    0    0    0    0    0    0    0    0    0    0    0    0    0    0    0    0]
 [   0    0    0    0   93    0    0    0    0    0    0    0    0    0    0    0    0    0    0    0    0    0    0    0    0    0    0]
 [   0    0    0    0    0  132    0    0    0    0    0    0    0    2    0    0    0    1    0    8    0    0    0    0    0    0    0]
 [   0    0    0    0    0    0  122    0    0    0    0    0    0    0    0    0    0    0    0    0    0    0    0    0    0    0    0]
 [   0    0    0    0    0    0    0  709    0    0    0    0    0    0    0    0    0    0    0    0    1    0    0    0    0    0    0]
 [   0    0    0    0    0    0    0    0  108    0    0    0    0    0    0    0    0    0    0    0    0    0    0    0    0    0    0]
 [   0    0    0    0    0    0    0    0    0 3471    0    0    0    0    0    0    0    0    0    0    0    0    0    0    0    0    0]
 [   0    0    0    0    0    0    0    0    0    0  136    0    0    0    0    0    0    0    0    0    0    0    0    0    0    0    0]
 [   0    0    0    0    0    0    0    0    0    0    0 1432    0    0    0    0    0    0    0    0    0    0    0    0    0    0    0]
 [   0    0    0    0    0    1    0    0    0    0    0    0   73    1    0    0    0    5    0   10    0    0    0    0    0    0    0]
 [   0    0    0    0    0    2    0    0    0    0    0    0    1   86    1    0    0    2    0    1    0    0    0    0    0    0    0]
 [   0    0    0    0    0    0    0    0    0    0    0    0    0    0  240    0    0    0    3    1    0    0    0    0    0    0    0]
 [   0    0    0    0    0    0    0    0    0    0    0    0    0    0    0   38    0    0    0    0    0    0    0    0    0    0    0]
 [   0    0    0    0    0    0    0    0    0    0    0    0    0    0    0    0  189    0    0    0    0    0    0    0    0    0    0]
 [   0    0    0    0    0    3    0    0    0    0    0    0    3    3    0    0    0  193    1   15    0    0    0    0    0    0    0]
 [   0    0    0    0    0    0    0    0    0    0    0    0    0    1   13    0    0    0   85    3    0    0    0    0    0    0    0]
 [   0    0    0    0    0    4    0    0    0    0    0    0   12    5    0    0    0   30    0  281    0    0    0    0    0    0    0]
 [   0    0    0    0    0    0    0    0    0    0    0    0    0    0    0    0    0    0    0    0  596    0    0    0    0    0    0]
 [   0    0    0    0    0    0    0    0    0    0    0    0    0    0    0    0    0    0    0    0    0  111    0    0    0    0    0]
 [   0    0    0    0    0    0    0    0    0    0    0    0    0    0    0    0    0    0    0    0    0    0 1151    0    0    0    0]
 [   0    0    0    0    0    0    0    0    0    0    0    0    0    0    0    0    0    0    0    0    0    0    0   32    0    0    0]
 [   0    0    0    0    0    0    0    0    0    0    0    0    0    0    0    0    0    0    0    0    0    0    0    0   21    0    0]
 [   0    0    0    0    0    0    0    0    0    0    0    0    0    0    0    0    0    0    0    0    0    0    0    0    0   32    0]
 [   0    0    0    0    0    0    0    0    0    0    0    0    0    0    0    0    0    0    0    0    0    0    0    0    0    0  110]]

Accuracy: 0.9325848675109077

Precision: [0.9367 0.9773 0.8656 0.8209 0.9237 0.4909 0.9375 0.7435 0.9914 0.9618 1.0000 0.8750 0.5926 0.6250 0.6735 1.0000 0.9394 0.6667 0.6341 0.5565 0.9463 0.9481 0.9861 0.6667 0.9375 0.9722 0.9508]
Mean: 0.8377692100682291
Std: 0.15851358260594747

Recall: [0.9570 0.6825 0.8342 0.4622 0.7610 0.5510 0.5172 0.9645 0.9914 0.9760 0.4662 0.7778 0.3556 0.6667 0.6429 0.1667 0.9568 0.1791 0.4643 0.4776 0.9724 0.8050 0.9973 0.4615 0.8824 0.8140 0.4754]
Mean: 0.6762409495142636
Std: 0.24748088802576756

F1 score: [0.9467 0.8037 0.8496 0.5914 0.8345 0.5192 0.6667 0.8397 0.9914 0.9688 0.6359 0.8235 0.4444 0.6452 0.6578 0.2857 0.9480 0.2824 0.5361 0.5141 0.9592 0.8707 0.9917 0.5455 0.9091 0.8861 0.6339]
Mean: 0.7252197350278888
Std: 0.2076045025945843

Cohen Kappa score: 0.9020598893955312
Confusion matrix:
[[8497    1    6   11    0    0    0  132    0  177    0    0    0    0   12    0   13    0    1    0   13    6    5    3    1    0    1]
 [  20   43    0    0    0    0    0    0    0    0    0    0    0    0    0    0    0    0    0    0    0    0    0    0    0    0    0]
 [  13    0  161    0    4    0    0    7    0    0    0    0    0    0    0    0    0    0    0    0    5    1    0    0    0    0    2]
 [  60    0    0   55    0    0    0    0    0    0    0    0    0    0    0    0    4    0    0    0    0    0    0    0    0    0    0]
 [  30    0    0    0  121    0    0    3    0    0    0    0    0    0    0    0    0    0    0    0    5    0    0    0    0    0    0]
 [   1    0    0    0    0   27    0    0    0    0    0    0    0    0    0    0    0    0    6   15    0    0    0    0    0    0    0]
 [   5    0    0    0    2    0   15    4    0    0    0    0    0    0    0    0    1    0    0    0    1    0    0    0    0    1    0]
 [  12    0    6    0    0    0    0  516    0    0    0    0    0    0    0    0    0    0    0    0    1    0    0    0    0    0    0]
 [   0    0    0    0    0    0    0    0  115    0    0    0    0    0    0    0    0    0    0    0    0    0    1    0    0    0    0]
 [ 117    0    0    0    0    0    0    0    0 4959    0    5    0    0    0    0    0    0    0    0    0    0    0    0    0    0    0]
 [  71    0    0    0    0    0    0    0    0    0   62    0    0    0    0    0    0    0    0    0    0    0    0    0    0    0    0]
 [   7    0    0    0    0    0    0    0    0    3    0   35    0    0    0    0    0    0    0    0    0    0    0    0    0    0    0]
 [   3    0    0    0    0    8    0    0    0    0    0    0   16    3    9    0    0    2    1    3    0    0    0    0    0    0    0]
 [   0    0    0    0    0    1    0    0    0    0    0    0    0   10    2    0    0    0    0    2    0    0    0    0    0    0    0]
 [  33    0    0    0    0    8    0    2    0    5    0    0    1    0   99    0    0    0    0    6    0    0    0    0    0    0    0]
 [   0    0    1    0    2    0    0    4    0    0    0    0    0    0    0    5    1    0    0    0    8    0    9    0    0    0    0]
 [   9    0    0    1    0    0    0    0    0    4    0    0    0    0    0    0  310    0    0    0    0    0    0    0    0    0    0]
 [  63    0    0    0    0    5    0    0    0    7    0    0    2    1   11    0    0   24    2   19    0    0    0    0    0    0    0]
 [  13    0    0    0    0    2    0    0    0    0    0    0    0    0    9    0    0    0   26    6    0    0    0    0    0    0    0]
 [  35    0    0    0    0    4    0    1    0    0    0    0    8    2    5    0    0   10    5   64    0    0    0    0    0    0    0]
 [   8    0    6    0    0    0    0    4    0    0    0    0    0    0    0    0    0    0    0    0  634    0    0    0    0    0    0]
 [  12    0    5    0    0    0    1   12    0    0    0    0    0    0    0    0    0    0    0    0    1  128    0    0    0    0    0]
 [   3    0    0    0    0    0    0    0    1    0    0    0    0    0    0    0    0    0    0    0    0    0 1491    0    0    0    0]
 [   6    0    0    0    0    0    0    0    0    1    0    0    0    0    0    0    0    0    0    0    0    0    0    6    0    0    0]
 [   2    0    0    0    0    0    0    0    0    0    0    0    0    0    0    0    0    0    0    0    0    0    0    0   15    0    0]
 [   1    0    1    0    1    0    0    1    0    0    0    0    0    0    0    0    1    0    0    0    2    0    1    0    0   35    0]
 [  50    0    0    0    1    0    0    8    0    0    0    0    0    0    0    0    0    0    0    0    0    0    5    0    0    0   58]]

