Classifier: GradientBoostingClassifier
Params: {'criterion': 'friedman_mse', 'init': None, 'learning_rate': 0.1, 'loss': 'deviance', 'max_depth': 3, 'max_features': None, 'max_leaf_nodes': None, 'min_impurity_decrease': 0.0, 'min_impurity_split': None, 'min_samples_leaf': 1, 'min_samples_split': 2, 'min_weight_fraction_leaf': 0.0, 'n_estimators': 100, 'presort': 'auto', 'random_state': None, 'subsample': 1.0, 'verbose': 0, 'warm_start': False}

Labels: None

Training accuracy: 0.9926048996611937
Training confusion matrix:
[[14670     0     0     4     0     0     0     6     0     1     0     0     0     0     0     0     1     0     0     0     0     0     2     1     0     0     0]
 [    3   231     0     0     0     0     0     0     0     0     0     0     0     0     0     0     0     0     0     0     0     0     0     0     0     0     0]
 [    0     0   294     0     0     0     0     0     0     0     0     0     0     0     0     0     0     0     0     0     0     0     0     0     0     0     0]
 [    3     0     0   189     0     0     0     0     0     0     0     0     0     0     0     0     0     0     0     0     0     0     0     0     0     0     0]
 [    0     0     0     0   204     0     0     0     0     0     0     0     0     0     0     0     0     0     0     0     0     0     0     0     0     0     0]
 [    0     0     0     0     0   134     0     0     0     0     0     0     1     2     1     0     0     0     1    13     0     0     0     0     0     0     0]
 [    0     0     0     0     0     0   115     0     0     0     0     0     0     0     0     0     0     0     0     0     0     0     0     0     0     0     0]
 [    2     0     0     0     0     0     0   997     0     0     0     0     0     0     0     0     0     0     0     0     0     0     0     0     0     0     0]
 [    0     0     0     0     0     0     0     0   179     0     0     0     0     0     0     0     0     0     0     0     0     0     0     0     0     0     0]
 [    9     0     0     0     0     0     0     0     0  6821     0     0     0     0     0     0     0     0     0     0     0     0     0     0     0     0     0]
 [    0     0     0     0     0     0     0     0     0     0   198     0     0     0     0     0     0     0     0     0     0     0     0     0     0     0     0]
 [    0     0     0     0     0     0     0     0     0     0     0  1181     0     0     0     0     0     0     0     0     0     0     0     0     0     0     0]
 [    0     0     0     0     0     1     0     0     0     0     0     0   101     1     0     0     0     2     0     5     0     0     0     0     0     0     0]
 [    0     0     0     0     0     3     0     0     0     0     0     0     2    78     1     0     0     1     0     1     0     0     0     0     0     0     0]
 [    3     0     0     0     0     3     0     0     0     0     0     0     2     0   296     0     0     1     9     5     0     0     0     0     0     0     0]
 [    0     0     0     0     0     0     0     0     0     0     0     0     0     0     0    57     0     0     0     0     0     0     0     0     0     0     0]
 [    5     0     0     0     0     0     0     0     0     0     0     0     0     0     0     0   404     0     0     0     0     0     0     0     0     0     0]
 [    0     0     0     0     0     5     0     0     0     0     0     0     9     4     0     0     0   253     0    22     0     0     0     0     0     0     0]
 [    0     0     0     0     0     4     0     0     0     0     0     0     1     2     8     0     0     1   107     6     0     0     0     0     0     0     0]
 [    0     0     0     0     0     6     0     0     0     0     0     0    24     7     2     0     0    30     0   306     0     0     0     0     0     0     0]
 [    0     0     0     0     0     0     0     1     0     0     0     0     0     0     0     0     0     0     0     0  1008     0     0     0     0     0     0]
 [    0     0     0     0     0     0     0     0     0     0     0     0     0     0     0     0     0     0     0     0     0   215     0     0     0     0     0]
 [    0     0     0     0     0     0     0     0     0     0     0     0     0     0     0     0     0     0     0     0     0     0  2114     0     0     0     0]
 [    0     0     0     0     0     0     0     0     0     0     0     0     0     0     0     0     0     0     0     0     0     0     0    38     0     0     0]
 [    0     0     0     0     0     0     0     0     0     0     0     0     0     0     0     0     0     0     0     0     0     0     0     0    28     0     0]
 [    0     0     0     0     0     0     0     0     0     0     0     0     0     0     0     0     0     0     0     0     0     0     0     0     0    62     0]
 [    0     0     0     0     0     0     0     0     0     0     0     0     0     0     0     0     0     0     0     0     0     0     0     0     0     0   189]]

Accuracy: 0.9788897576231431

Precision: [0.9913 0.9688 0.9565 0.9792 1.0000 0.6170 1.0000 0.9759 0.9778 0.9983 1.0000 0.9933 0.4500 0.7143 0.8293 1.0000 0.9808 0.6508 0.7143 0.7027 1.0000 1.0000 0.9981 0.8750 1.0000 1.0000 1.0000]
Mean: 0.9027118576523989
Std: 0.15115125318648573

Recall: [0.9948 0.9688 1.0000 0.9038 1.0000 0.7250 1.0000 0.9878 0.9778 0.9971 0.9437 1.0000 0.7200 0.6818 0.8608 1.0000 0.9808 0.6949 0.3448 0.5714 0.9833 0.9818 0.9981 1.0000 1.0000 0.9231 0.9535]
Mean: 0.8960386797214186
Std: 0.16238697073351693

F1 score: [0.9931 0.9688 0.9778 0.9400 1.0000 0.6667 1.0000 0.9818 0.9778 0.9977 0.9710 0.9966 0.5538 0.6977 0.8447 1.0000 0.9808 0.6721 0.4651 0.6303 0.9916 0.9908 0.9981 0.9333 1.0000 0.9600 0.9762]
Mean: 0.8950284284649117
Std: 0.15780641511818258

Cohen Kappa score: 0.9703100423811997
Confusion matrix:
[[3650    2    2    1    0    1    0    5    0    3    0    1    0    0    1    0    2    0    0    0    0    0    0    1    0    0    0]
 [   2   62    0    0    0    0    0    0    0    0    0    0    0    0    0    0    0    0    0    0    0    0    0    0    0    0    0]
 [   0    0   66    0    0    0    0    0    0    0    0    0    0    0    0    0    0    0    0    0    0    0    0    0    0    0    0]
 [   5    0    0   47    0    0    0    0    0    0    0    0    0    0    0    0    0    0    0    0    0    0    0    0    0    0    0]
 [   0    0    0    0   48    0    0    0    0    0    0    0    0    0    0    0    0    0    0    0    0    0    0    0    0    0    0]
 [   0    0    0    0    0   29    0    0    0    0    0    0    2    2    0    0    0    1    0    6    0    0    0    0    0    0    0]
 [   0    0    0    0    0    0   36    0    0    0    0    0    0    0    0    0    0    0    0    0    0    0    0    0    0    0    0]
 [   1    0    1    0    0    0    0  243    1    0    0    0    0    0    0    0    0    0    0    0    0    0    0    0    0    0    0]
 [   0    0    0    0    0    0    0    0   44    0    0    0    0    0    0    0    0    0    0    0    0    0    1    0    0    0    0]
 [   5    0    0    0    0    0    0    0    0 1717    0    0    0    0    0    0    0    0    0    0    0    0    0    0    0    0    0]
 [   4    0    0    0    0    0    0    0    0    0   67    0    0    0    0    0    0    0    0    0    0    0    0    0    0    0    0]
 [   0    0    0    0    0    0    0    0    0    0    0  296    0    0    0    0    0    0    0    0    0    0    0    0    0    0    0]
 [   0    0    0    0    0    3    0    0    0    0    0    0   18    0    0    0    0    2    0    2    0    0    0    0    0    0    0]
 [   0    0    0    0    0    2    0    0    0    0    0    0    1   15    2    0    0    2    0    0    0    0    0    0    0    0    0]
 [   5    0    0    0    0    1    0    0    0    0    0    1    0    0   68    0    0    0    3    1    0    0    0    0    0    0    0]
 [   0    0    0    0    0    0    0    0    0    0    0    0    0    0    0   11    0    0    0    0    0    0    0    0    0    0    0]
 [   2    0    0    0    0    0    0    0    0    0    0    0    0    0    0    0  102    0    0    0    0    0    0    0    0    0    0]
 [   0    0    0    0    0    1    0    0    0    0    0    0    4    1    2    0    0   41    0   10    0    0    0    0    0    0    0]
 [   0    0    0    0    0    1    0    0    0    0    0    0    1    1    9    0    0    4   10    3    0    0    0    0    0    0    0]
 [   0    0    0    0    0    9    0    0    0    0    0    0   14    2    0    0    0   13    1   52    0    0    0    0    0    0    0]
 [   3    0    0    0    0    0    0    1    0    0    0    0    0    0    0    0    0    0    0    0  235    0    0    0    0    0    0]
 [   1    0    0    0    0    0    0    0    0    0    0    0    0    0    0    0    0    0    0    0    0   54    0    0    0    0    0]
 [   1    0    0    0    0    0    0    0    0    0    0    0    0    0    0    0    0    0    0    0    0    0  531    0    0    0    0]
 [   0    0    0    0    0    0    0    0    0    0    0    0    0    0    0    0    0    0    0    0    0    0    0    7    0    0    0]
 [   0    0    0    0    0    0    0    0    0    0    0    0    0    0    0    0    0    0    0    0    0    0    0    0   10    0    0]
 [   1    0    0    0    0    0    0    0    0    0    0    0    0    0    0    0    0    0    0    0    0    0    0    0    0   12    0]
 [   2    0    0    0    0    0    0    0    0    0    0    0    0    0    0    0    0    0    0    0    0    0    0    0    0    0   41]]

