Classifier: LinearSVC
Params: {'C': 1.0, 'class_weight': None, 'dual': True, 'fit_intercept': True, 'intercept_scaling': 1, 'loss': 'squared_hinge', 'max_iter': 1000, 'multi_class': 'ovr', 'penalty': 'l2', 'random_state': None, 'tol': 0.0001, 'verbose': 0}

Labels: None

Training accuracy: 0.9894774563461037
Training confusion matrix:
[[14672     0     1     5     0     0     0     2     0     0     0     0     0     0     0     0     2     0     0     0     0     0     1     1     1     0     0]
 [    0   234     0     0     0     0     0     0     0     0     0     0     0     0     0     0     0     0     0     0     0     0     0     0     0     0     0]
 [    1     0   293     0     0     0     0     0     0     0     0     0     0     0     0     0     0     0     0     0     0     0     0     0     0     0     0]
 [    0     0     0   192     0     0     0     0     0     0     0     0     0     0     0     0     0     0     0     0     0     0     0     0     0     0     0]
 [    0     0     0     0   204     0     0     0     0     0     0     0     0     0     0     0     0     0     0     0     0     0     0     0     0     0     0]
 [    0     0     0     0     0   106     0     0     0     0     0     0     9     1     3     0     0     3     7    23     0     0     0     0     0     0     0]
 [    0     0     0     0     0     0   115     0     0     0     0     0     0     0     0     0     0     0     0     0     0     0     0     0     0     0     0]
 [    0     0     0     0     0     0     0   999     0     0     0     0     0     0     0     0     0     0     0     0     0     0     0     0     0     0     0]
 [    0     0     0     0     0     0     0     0   179     0     0     0     0     0     0     0     0     0     0     0     0     0     0     0     0     0     0]
 [    0     0     0     0     0     0     0     0     0  6830     0     0     0     0     0     0     0     0     0     0     0     0     0     0     0     0     0]
 [    0     0     0     0     0     0     0     0     0     0   198     0     0     0     0     0     0     0     0     0     0     0     0     0     0     0     0]
 [    0     0     0     0     0     0     0     0     0     0     0  1181     0     0     0     0     0     0     0     0     0     0     0     0     0     0     0]
 [    0     0     0     0     0     3     0     0     0     0     0     0    92     6     0     0     0     1     1     7     0     0     0     0     0     0     0]
 [    0     0     0     0     0     5     0     0     0     0     0     0     6    68     1     0     0     3     0     3     0     0     0     0     0     0     0]
 [    0     0     0     0     0     1     0     0     0     0     0     0     2     2   303     0     0     1     3     7     0     0     0     0     0     0     0]
 [    1     0     0     0     0     0     0     0     0     0     0     0     0     0     0    56     0     0     0     0     0     0     0     0     0     0     0]
 [    6     0     0     0     0     0     0     0     0     0     0     0     0     0     0     0   403     0     0     0     0     0     0     0     0     0     0]
 [    0     0     0     0     0    13     0     0     0     0     0     0    17     9     1     0     0   228     0    25     0     0     0     0     0     0     0]
 [    0     0     0     0     0     0     0     0     0     0     0     0     1     2    17     0     0     1   101     7     0     0     0     0     0     0     0]
 [    0     0     0     0     0    14     0     0     0     0     0     0    29    14     4     0     0    43     4   267     0     0     0     0     0     0     0]
 [    0     0     0     0     0     0     0     1     0     0     0     0     0     0     0     0     0     0     0     0  1008     0     0     0     0     0     0]
 [    1     0     0     0     0     0     0     0     0     0     0     0     0     0     0     0     0     0     0     0     0   214     0     0     0     0     0]
 [    0     0     0     0     0     0     0     0     1     0     0     0     0     0     0     0     0     0     0     0     0     0  2113     0     0     0     0]
 [    0     0     0     0     0     0     0     0     0     0     0     0     0     0     0     0     0     0     0     0     0     0     0    38     0     0     0]
 [    0     0     0     0     0     0     0     0     0     0     0     0     0     0     0     0     0     0     0     0     0     0     0     0    28     0     0]
 [    0     0     0     0     0     0     0     0     0     0     0     0     0     0     0     0     0     0     0     0     0     0     0     0     0    62     0]
 [    0     0     0     0     0     0     0     0     0     0     0     0     0     0     0     0     0     0     0     0     0     0     0     0     0     0   189]]

Accuracy: 0.9801928590044305

Precision: [0.9943 0.9683 0.9559 0.9804 1.0000 0.6829 1.0000 0.9837 0.9778 1.0000 0.9714 1.0000 0.4545 0.7600 0.8295 1.0000 0.9623 0.6393 0.7333 0.6620 1.0000 0.9474 0.9981 0.8750 1.0000 0.9286 1.0000]
Mean: 0.9001758213595227
Std: 0.14414199199758038

Recall: [0.9951 0.9531 0.9848 0.9615 0.9792 0.7000 1.0000 0.9837 0.9778 0.9977 0.9577 1.0000 0.8000 0.8636 0.9241 1.0000 0.9808 0.6610 0.3793 0.5165 0.9958 0.9818 0.9981 1.0000 0.8000 1.0000 1.0000]
Mean: 0.9033976028790653
Std: 0.1591629385179653

F1 score: [0.9947 0.9606 0.9701 0.9709 0.9895 0.6914 1.0000 0.9837 0.9778 0.9988 0.9645 1.0000 0.5797 0.8085 0.8743 1.0000 0.9714 0.6500 0.5000 0.5802 0.9979 0.9643 0.9981 0.9333 0.8889 0.9630 1.0000]
Mean: 0.896729940872904
Std: 0.1504114144303829

Cohen Kappa score: 0.9721693625970241
Confusion matrix:
[[3651    2    2    1    0    0    0    3    0    0    2    0    0    0    2    0    1    0    0    2    0    2    0    1    0    0    0]
 [   3   61    0    0    0    0    0    0    0    0    0    0    0    0    0    0    0    0    0    0    0    0    0    0    0    0    0]
 [   1    0   65    0    0    0    0    0    0    0    0    0    0    0    0    0    0    0    0    0    0    0    0    0    0    0    0]
 [   2    0    0   50    0    0    0    0    0    0    0    0    0    0    0    0    0    0    0    0    0    0    0    0    0    0    0]
 [   1    0    0    0   47    0    0    0    0    0    0    0    0    0    0    0    0    0    0    0    0    0    0    0    0    0    0]
 [   0    0    0    0    0   28    0    0    0    0    0    0    1    1    2    0    0    1    0    7    0    0    0    0    0    0    0]
 [   0    0    0    0    0    0   36    0    0    0    0    0    0    0    0    0    0    0    0    0    0    0    0    0    0    0    0]
 [   1    0    1    0    0    0    0  242    1    0    0    0    0    0    0    0    0    0    0    0    0    1    0    0    0    0    0]
 [   0    0    0    0    0    0    0    0   44    0    0    0    0    0    0    0    0    0    0    0    0    0    1    0    0    0    0]
 [   2    0    0    0    0    0    0    0    0 1718    0    0    0    0    0    0    2    0    0    0    0    0    0    0    0    0    0]
 [   3    0    0    0    0    0    0    0    0    0   68    0    0    0    0    0    0    0    0    0    0    0    0    0    0    0    0]
 [   0    0    0    0    0    0    0    0    0    0    0  296    0    0    0    0    0    0    0    0    0    0    0    0    0    0    0]
 [   0    0    0    0    0    2    0    0    0    0    0    0   20    0    0    0    0    0    0    3    0    0    0    0    0    0    0]
 [   0    0    0    0    0    2    0    0    0    0    0    0    0   19    0    0    0    0    0    1    0    0    0    0    0    0    0]
 [   2    0    0    0    0    0    0    1    0    0    0    0    0    0   73    0    0    0    2    1    0    0    0    0    0    0    0]
 [   0    0    0    0    0    0    0    0    0    0    0    0    0    0    0   11    0    0    0    0    0    0    0    0    0    0    0]
 [   2    0    0    0    0    0    0    0    0    0    0    0    0    0    0    0  102    0    0    0    0    0    0    0    0    0    0]
 [   0    0    0    0    0    2    0    0    0    0    0    0    7    2    2    0    0   39    0    7    0    0    0    0    0    0    0]
 [   0    0    0    0    0    0    0    0    0    0    0    0    1    0    9    0    0    5   11    3    0    0    0    0    0    0    0]
 [   1    0    0    0    0    7    0    0    0    0    0    0   15    3    0    0    0   16    2   47    0    0    0    0    0    0    0]
 [   1    0    0    0    0    0    0    0    0    0    0    0    0    0    0    0    0    0    0    0  238    0    0    0    0    0    0]
 [   0    0    0    0    0    0    0    0    0    0    0    0    0    0    0    0    0    0    0    0    0   54    0    0    0    1    0]
 [   0    0    0    0    0    0    0    0    0    0    0    0    0    0    0    0    1    0    0    0    0    0  531    0    0    0    0]
 [   0    0    0    0    0    0    0    0    0    0    0    0    0    0    0    0    0    0    0    0    0    0    0    7    0    0    0]
 [   2    0    0    0    0    0    0    0    0    0    0    0    0    0    0    0    0    0    0    0    0    0    0    0    8    0    0]
 [   0    0    0    0    0    0    0    0    0    0    0    0    0    0    0    0    0    0    0    0    0    0    0    0    0   13    0]
 [   0    0    0    0    0    0    0    0    0    0    0    0    0    0    0    0    0    0    0    0    0    0    0    0    0    0   43]]

