Classifier: LogisticRegression
Params: {'C': 1.0, 'class_weight': None, 'dual': False, 'fit_intercept': True, 'intercept_scaling': 1, 'max_iter': 100, 'multi_class': 'ovr', 'n_jobs': 1, 'penalty': 'l2', 'random_state': None, 'solver': 'liblinear', 'tol': 0.0001, 'verbose': 0, 'warm_start': False}

Labels: None

Training accuracy: 0.9876856919468334
Training confusion matrix:
[[14662     3     1     4     0     0     0     4     0     1     0     0     0     0     0     0     2     0     0     0     2     2     2     0     2     0     0]
 [    1   233     0     0     0     0     0     0     0     0     0     0     0     0     0     0     0     0     0     0     0     0     0     0     0     0     0]
 [    1     0   293     0     0     0     0     0     0     0     0     0     0     0     0     0     0     0     0     0     0     0     0     0     0     0     0]
 [    6     0     0   186     0     0     0     0     0     0     0     0     0     0     0     0     0     0     0     0     0     0     0     0     0     0     0]
 [    0     0     0     0   204     0     0     0     0     0     0     0     0     0     0     0     0     0     0     0     0     0     0     0     0     0     0]
 [    0     0     0     0     0   106     0     0     0     0     0     0     9     1     5     0     0     2     4    25     0     0     0     0     0     0     0]
 [    0     0     0     0     0     0   115     0     0     0     0     0     0     0     0     0     0     0     0     0     0     0     0     0     0     0     0]
 [    2     0     0     0     0     0     0   992     0     0     0     0     0     0     0     0     0     0     0     0     5     0     0     0     0     0     0]
 [    0     0     0     0     0     0     0     0   179     0     0     0     0     0     0     0     0     0     0     0     0     0     0     0     0     0     0]
 [    3     0     0     0     0     0     0     0     0  6827     0     0     0     0     0     0     0     0     0     0     0     0     0     0     0     0     0]
 [    3     0     0     0     0     0     0     0     0     0   195     0     0     0     0     0     0     0     0     0     0     0     0     0     0     0     0]
 [    0     0     0     0     0     0     0     0     0     0     0  1181     0     0     0     0     0     0     0     0     0     0     0     0     0     0     0]
 [    0     0     0     0     0     4     0     0     0     0     0     0    89     7     0     0     0     1     1     8     0     0     0     0     0     0     0]
 [    0     0     0     0     0     5     0     0     0     0     0     0     8    64     2     0     0     3     0     4     0     0     0     0     0     0     0]
 [    1     0     0     0     0     2     0     0     0     0     0     0     2     1   303     0     0     1     3     6     0     0     0     0     0     0     0]
 [    1     0     0     0     0     0     0     0     0     0     0     0     0     0     0    56     0     0     0     0     0     0     0     0     0     0     0]
 [    7     0     0     0     0     0     0     0     0     0     0     0     0     0     0     0   402     0     0     0     0     0     0     0     0     0     0]
 [    0     0     0     0     0    11     0     0     0     0     0     0    18     9     1     0     0   219     0    35     0     0     0     0     0     0     0]
 [    0     0     0     0     0     2     0     0     0     0     0     0     1     2    19     0     0     1    92    12     0     0     0     0     0     0     0]
 [    0     0     0     0     0    10     0     0     0     0     0     0    32    11     3     0     0    39     1   278     0     0     1     0     0     0     0]
 [    3     0     0     0     0     0     0     1     0     0     0     0     0     0     0     0     0     0     0     0  1005     0     0     0     0     0     0]
 [    1     0     0     0     0     0     0     0     0     0     0     0     0     0     0     0     0     0     0     0     0   214     0     0     0     0     0]
 [    1     0     0     0     0     0     0     0     1     0     0     0     0     0     0     0     0     0     0     0     0     0  2112     0     0     0     0]
 [    2     0     0     0     0     0     0     0     0     1     0     0     0     0     0     0     0     0     0     0     0     0     0    35     0     0     0]
 [    1     0     0     1     0     0     0     0     0     0     0     0     0     0     0     0     0     0     0     0     0     0     0     0    26     0     0]
 [    0     0     0     0     0     0     0     1     0     0     0     0     0     0     0     0     0     0     0     0     0     0     0     0     0    61     0]
 [    0     0     0     0     0     0     0     0     0     0     0     0     0     0     0     0     0     0     0     0     0     0     0     0     0     0   189]]

Accuracy: 0.9807140995569456

Precision: [0.9919 0.9841 0.9565 0.9592 1.0000 0.6667 1.0000 0.9757 1.0000 0.9988 0.9853 0.9966 0.5122 0.7391 0.8391 1.0000 0.9901 0.6780 0.7857 0.7237 0.9917 1.0000 0.9981 0.8333 1.0000 1.0000 1.0000]
Mean: 0.9113267095448931
Std: 0.13462293963645286

Recall: [0.9956 0.9688 1.0000 0.9038 0.9792 0.7000 1.0000 0.9797 0.9778 0.9988 0.9437 1.0000 0.8400 0.7727 0.9241 1.0000 0.9615 0.6780 0.3793 0.6044 0.9958 0.9636 1.0000 0.7143 0.8000 1.0000 0.9767]
Mean: 0.891030579520705
Std: 0.15367456135538995

F1 score: [0.9937 0.9764 0.9778 0.9307 0.9895 0.6829 1.0000 0.9777 0.9888 0.9988 0.9640 0.9983 0.6364 0.7556 0.8795 1.0000 0.9756 0.6780 0.5116 0.6587 0.9937 0.9815 0.9991 0.7692 0.8889 1.0000 0.9882]
Mean: 0.8960956763923486
Std: 0.14258141563487733

Cohen Kappa score: 0.9728707337587109
Confusion matrix:
[[3653    1    2    1    0    0    0    4    0    2    1    1    0    0    1    0    1    0    1    0    0    0    0    1    0    0    0]
 [   2   62    0    0    0    0    0    0    0    0    0    0    0    0    0    0    0    0    0    0    0    0    0    0    0    0    0]
 [   0    0   66    0    0    0    0    0    0    0    0    0    0    0    0    0    0    0    0    0    0    0    0    0    0    0    0]
 [   5    0    0   47    0    0    0    0    0    0    0    0    0    0    0    0    0    0    0    0    0    0    0    0    0    0    0]
 [   1    0    0    0   47    0    0    0    0    0    0    0    0    0    0    0    0    0    0    0    0    0    0    0    0    0    0]
 [   0    0    0    0    0   28    0    0    0    0    0    0    1    1    1    0    0    1    0    8    0    0    0    0    0    0    0]
 [   0    0    0    0    0    0   36    0    0    0    0    0    0    0    0    0    0    0    0    0    0    0    0    0    0    0    0]
 [   3    0    1    0    0    0    0  241    0    0    0    0    0    0    0    0    0    0    0    0    1    0    0    0    0    0    0]
 [   0    0    0    0    0    0    0    0   44    0    0    0    0    0    0    0    0    0    0    0    0    0    1    0    0    0    0]
 [   2    0    0    0    0    0    0    0    0 1720    0    0    0    0    0    0    0    0    0    0    0    0    0    0    0    0    0]
 [   4    0    0    0    0    0    0    0    0    0   67    0    0    0    0    0    0    0    0    0    0    0    0    0    0    0    0]
 [   0    0    0    0    0    0    0    0    0    0    0  296    0    0    0    0    0    0    0    0    0    0    0    0    0    0    0]
 [   0    0    0    0    0    2    0    0    0    0    0    0   21    0    0    0    0    0    0    2    0    0    0    0    0    0    0]
 [   0    0    0    0    0    3    0    0    0    0    0    0    0   17    1    0    0    0    0    1    0    0    0    0    0    0    0]
 [   3    0    0    0    0    1    0    0    0    0    0    0    0    0   73    0    0    0    1    1    0    0    0    0    0    0    0]
 [   0    0    0    0    0    0    0    0    0    0    0    0    0    0    0   11    0    0    0    0    0    0    0    0    0    0    0]
 [   3    0    0    1    0    0    0    0    0    0    0    0    0    0    0    0  100    0    0    0    0    0    0    0    0    0    0]
 [   1    0    0    0    0    2    0    0    0    0    0    0    6    2    2    0    0   40    0    6    0    0    0    0    0    0    0]
 [   0    0    0    0    0    0    0    0    0    0    0    0    1    0    9    0    0    5   11    3    0    0    0    0    0    0    0]
 [   1    0    0    0    0    6    0    0    0    0    0    0   12    3    0    0    0   13    1   55    0    0    0    0    0    0    0]
 [   1    0    0    0    0    0    0    0    0    0    0    0    0    0    0    0    0    0    0    0  238    0    0    0    0    0    0]
 [   0    0    0    0    0    0    0    1    0    0    0    0    0    0    0    0    0    0    0    0    1   53    0    0    0    0    0]
 [   0    0    0    0    0    0    0    0    0    0    0    0    0    0    0    0    0    0    0    0    0    0  532    0    0    0    0]
 [   2    0    0    0    0    0    0    0    0    0    0    0    0    0    0    0    0    0    0    0    0    0    0    5    0    0    0]
 [   2    0    0    0    0    0    0    0    0    0    0    0    0    0    0    0    0    0    0    0    0    0    0    0    8    0    0]
 [   0    0    0    0    0    0    0    0    0    0    0    0    0    0    0    0    0    0    0    0    0    0    0    0    0   13    0]
 [   0    0    0    0    0    0    0    1    0    0    0    0    0    0    0    0    0    0    0    0    0    0    0    0    0    0   42]]

