Classifier: MultinomialNB
Params: {'alpha': 1.0, 'class_prior': None, 'fit_prior': True}

Labels: None

Training accuracy: 0.9138975762314308
Training confusion matrix:
[[13482   108    19   129     6     0     0   214     0    33   237    11     0     0   122     0    21    69     0   104    40     2    11    10    23     0    44]
 [    4   230     0     0     0     0     0     0     0     0     0     0     0     0     0     0     0     0     0     0     0     0     0     0     0     0     0]
 [    3     0   264     0     4     0     2    15     0     0     0     0     0     0     0     0     1     0     0     0     4     1     0     0     0     0     0]
 [   35     0     0   147     0     0     0     0     0     0     0     0     0     0     0     0    10     0     0     0     0     0     0     0     0     0     0]
 [    0     0     0     0   201     0     0     0     0     0     0     0     0     0     0     0     0     0     0     0     1     0     2     0     0     0     0]
 [    1     0     0     0     0     6     0     0     0     0     0     0     0     0     2     0     0     2     0   141     0     0     0     0     0     0     0]
 [    0     0     0     0     0     0   111     0     0     0     0     0     0     0     0     0     3     0     0     0     0     0     1     0     0     0     0]
 [    2     0     3     0    17     0     4   962     0     0     0     0     0     0     0     0     0     0     0     0     9     0     0     0     0     0     2]
 [    1     0     0     0     0     0     4     0   171     0     0     0     0     0     0     0     0     0     0     0     0     0     3     0     0     0     0]
 [  249     0     0     5     0     0     0     1     0  6544     5     1     0     0     6     0     3     0     0     0     0     0    16     0     0     0     0]
 [   13     0     0     0     0     0     0     0     0     0   185     0     0     0     0     0     0     0     0     0     0     0     0     0     0     0     0]
 [   21     0     0     0     0     0     0     0     0     3     0  1157     0     0     0     0     0     0     0     0     0     0     0     0     0     0     0]
 [    0     0     0     0     0     0     0     0     0     0     0     0     0     0     0     0     0     6     0   104     0     0     0     0     0     0     0]
 [    0     0     0     0     0     0     0     0     0     0     0     0     1     0     1     0     0     0     0    84     0     0     0     0     0     0     0]
 [    2     0     0     0     0     0     0     0     0     0     0     0     0     0   228     0     0    16     0    69     0     1     3     0     0     0     0]
 [    0     0     1     0     6     0     2     0     0     0     0     0     0     0     0    36     1     0     0     0     0     0    10     0     0     0     1]
 [   27     0     0    17     4     0     2     0     0     0     0     0     0     0     0     0   358     0     0     0     0     0     0     0     1     0     0]
 [    5     0     0     0     0     0     0     0     0     0     0     0     0     0     2     0     0    93     0   193     0     0     0     0     0     0     0]
 [    1     0     0     0     0     0     0     0     0     0     0     0     0     0    45     0     0    20     5    58     0     0     0     0     0     0     0]
 [    2     0     0     0     0     0     0     0     0     0     4     0     0     0     3     0     0    13     0   349     1     0     3     0     0     0     0]
 [    3     0     0     0     0     0     0     4     0     0     0     0     0     0     0     0     0     0     0     0   998     0     1     0     0     0     3]
 [    1     0     5     0     0     0     0     8     0     0     0     0     0     0     0     0     0     0     0     0    25   174     2     0     0     0     0]
 [    4     0     1     0     6     0     6     0     1     0     0     0     0     0     0     0     0     0     0     0     0     0  2096     0     0     0     0]
 [    3    18     0     0     0     0     0     0     0     0     2     0     0     0     0     0     0     0     0     0     0     0     0    15     0     0     0]
 [    2     0     0     0     0     0     0     0     0     0     0     0     0     0     0     0     0     0     0     0     0     0     0     0    26     0     0]
 [    0     0     4     0     6     0     0    13     0     0     0     0     0     0     0     0     1     0     0     0     2     0     0     0     0    36     0]
 [    0     0     5     0     0     0     1     2     0     0     0     0     0     0     0     0     0     0     0     0     2     0     0     0     0     0   179]]

Accuracy: 0.910086004691165

Precision: [0.9698 0.6277 0.8657 0.4744 0.7385 1.0000 0.9000 0.7823 1.0000 0.9928 0.4878 0.9734 0.0000 0.0000 0.5310 1.0000 0.8788 0.3818 1.0000 0.3333 0.9115 0.9773 0.9832 0.4286 0.5000 1.0000 0.6379]
Mean: 0.717619314146354
Std: 0.3010693558191444

Recall: [0.9111 0.9219 0.8788 0.7115 1.0000 0.0500 1.0000 0.9350 0.9556 0.9605 0.8451 0.9899 0.0000 0.0000 0.7595 0.8182 0.8365 0.3559 0.0345 0.9231 0.9916 0.7818 0.9887 0.4286 0.8000 0.3846 0.8605]
Mean: 0.7082533173641203
Std: 0.33506330929753503

F1 score: [0.9396 0.7468 0.8722 0.5692 0.8496 0.0952 0.9474 0.8519 0.9773 0.9764 0.6186 0.9816 0.0000 0.0000 0.6250 0.9000 0.8571 0.3684 0.0667 0.4898 0.9499 0.8687 0.9859 0.4286 0.6154 0.5556 0.7327]
Mean: 0.6618283884163061
Std: 0.313848839194599

Cohen Kappa score: 0.8762422467347313
Confusion matrix:
[[3343   33    3   31    2    0    0   54    0   11   61    8    0    0   38    0    2   18    0   28    4    1    2    4    8    0   18]
 [   5   59    0    0    0    0    0    0    0    0    0    0    0    0    0    0    0    0    0    0    0    0    0    0    0    0    0]
 [   0    0   58    0    4    0    2    2    0    0    0    0    0    0    0    0    0    0    0    0    0    0    0    0    0    0    0]
 [  10    0    0   37    0    0    0    0    0    0    0    0    0    0    0    0    5    0    0    0    0    0    0    0    0    0    0]
 [   0    0    0    0   48    0    0    0    0    0    0    0    0    0    0    0    0    0    0    0    0    0    0    0    0    0    0]
 [   0    0    0    0    0    2    0    0    0    0    0    0    0    0    0    0    0    1    0   37    0    0    0    0    0    0    0]
 [   0    0    0    0    0    0   36    0    0    0    0    0    0    0    0    0    0    0    0    0    0    0    0    0    0    0    0]
 [   0    0    3    1    5    0    1  230    0    0    0    0    0    0    0    0    0    0    0    0    5    0    0    0    0    0    1]
 [   0    0    0    0    0    0    0    0   43    0    0    0    0    0    0    0    1    0    0    0    0    0    1    0    0    0    0]
 [  60    0    0    0    0    0    0    0    0 1654    1    0    0    0    1    0    3    0    0    0    0    0    3    0    0    0    0]
 [  11    0    0    0    0    0    0    0    0    0   60    0    0    0    0    0    0    0    0    0    0    0    0    0    0    0    0]
 [   2    0    0    0    0    0    0    0    0    1    0  293    0    0    0    0    0    0    0    0    0    0    0    0    0    0    0]
 [   0    0    0    0    0    0    0    0    0    0    0    0    0    0    0    0    0    1    0   24    0    0    0    0    0    0    0]
 [   0    0    0    0    0    0    0    0    0    0    0    0    0    0    0    0    0    0    0   22    0    0    0    0    0    0    0]
 [   1    0    0    0    0    0    0    1    0    0    0    0    0    0   60    0    0    3    0   14    0    0    0    0    0    0    0]
 [   0    0    0    0    0    0    0    0    0    0    0    0    0    0    0    9    1    0    0    0    0    0    1    0    0    0    0]
 [   8    0    0    9    0    0    0    0    0    0    0    0    0    0    0    0   87    0    0    0    0    0    0    0    0    0    0]
 [   2    0    0    0    0    0    0    0    0    0    0    0    0    0    0    0    0   21    0   36    0    0    0    0    0    0    0]
 [   0    0    0    0    0    0    0    0    0    0    0    0    0    0   14    0    0    7    1    7    0    0    0    0    0    0    0]
 [   0    0    0    0    0    0    0    0    0    0    1    0    0    0    0    0    0    4    0   84    0    0    2    0    0    0    0]
 [   1    0    0    0    0    0    0    0    0    0    0    0    0    0    0    0    0    0    0    0  237    0    0    0    0    0    1]
 [   0    0    0    0    0    0    0    2    0    0    0    0    0    0    0    0    0    0    0    0   10   43    0    0    0    0    0]
 [   0    0    0    0    4    0    0    1    0    0    0    0    0    0    0    0    0    0    0    0    0    0  526    0    0    0    1]
 [   2    2    0    0    0    0    0    0    0    0    0    0    0    0    0    0    0    0    0    0    0    0    0    3    0    0    0]
 [   2    0    0    0    0    0    0    0    0    0    0    0    0    0    0    0    0    0    0    0    0    0    0    0    8    0    0]
 [   0    0    1    0    0    0    0    4    0    0    0    0    0    0    0    0    0    0    0    0    3    0    0    0    0    5    0]
 [   0    0    2    0    2    0    1    0    0    0    0    0    0    0    0    0    0    0    0    0    1    0    0    0    0    0   37]]

