Classifier: RandomForestClassifier
Params: {'bootstrap': True, 'class_weight': None, 'criterion': 'gini', 'max_depth': None, 'max_features': 'auto', 'max_leaf_nodes': None, 'min_impurity_decrease': 0.0, 'min_impurity_split': None, 'min_samples_leaf': 1, 'min_samples_split': 2, 'min_weight_fraction_leaf': 0.0, 'n_estimators': 100, 'n_jobs': 1, 'oob_score': False, 'random_state': None, 'verbose': 0, 'warm_start': False}

Labels: None

Training accuracy: 0.9950482147511076
Training confusion matrix:
[[14676     0     0     5     0     0     0     0     0     0     0     0     0     0     0     0     3     0     0     0     0     0     0     1     0     0     0]
 [    0   234     0     0     0     0     0     0     0     0     0     0     0     0     0     0     0     0     0     0     0     0     0     0     0     0     0]
 [    0     0   294     0     0     0     0     0     0     0     0     0     0     0     0     0     0     0     0     0     0     0     0     0     0     0     0]
 [    0     0     0   192     0     0     0     0     0     0     0     0     0     0     0     0     0     0     0     0     0     0     0     0     0     0     0]
 [    0     0     0     0   204     0     0     0     0     0     0     0     0     0     0     0     0     0     0     0     0     0     0     0     0     0     0]
 [    0     0     0     0     0   140     0     0     0     0     0     0     0     1     1     0     0     1     0     9     0     0     0     0     0     0     0]
 [    0     0     0     0     0     0   115     0     0     0     0     0     0     0     0     0     0     0     0     0     0     0     0     0     0     0     0]
 [    0     0     0     0     0     0     0   998     0     0     0     0     0     0     0     0     0     0     0     0     1     0     0     0     0     0     0]
 [    0     0     0     0     0     0     0     0   179     0     0     0     0     0     0     0     0     0     0     0     0     0     0     0     0     0     0]
 [    0     0     0     0     0     0     0     0     0  6830     0     0     0     0     0     0     0     0     0     0     0     0     0     0     0     0     0]
 [    0     0     0     0     0     0     0     0     0     0   198     0     0     0     0     0     0     0     0     0     0     0     0     0     0     0     0]
 [    0     0     0     0     0     0     0     0     0     0     0  1181     0     0     0     0     0     0     0     0     0     0     0     0     0     0     0]
 [    0     0     0     0     0     1     0     0     0     0     0     0   100     1     0     0     0     3     0     5     0     0     0     0     0     0     0]
 [    0     0     0     0     0     2     0     0     0     0     0     0     1    75     0     0     0     4     1     3     0     0     0     0     0     0     0]
 [    0     0     0     0     0     1     0     0     0     0     0     0     0     1   307     0     0     1     4     5     0     0     0     0     0     0     0]
 [    0     0     0     0     0     0     0     0     0     0     0     0     0     0     0    57     0     0     0     0     0     0     0     0     0     0     0]
 [    3     0     0     0     0     0     0     0     0     0     0     0     0     0     0     0   406     0     0     0     0     0     0     0     0     0     0]
 [    0     0     0     0     0     2     0     0     0     0     0     0     4     1     0     0     0   271     0    15     0     0     0     0     0     0     0]
 [    0     0     0     0     0     2     0     0     0     0     0     0     0     1     9     0     0     1   112     4     0     0     0     0     0     0     0]
 [    0     0     0     0     0     3     0     0     0     0     0     0    16     4     0     0     0    31     1   320     0     0     0     0     0     0     0]
 [    0     0     0     0     0     0     0     0     0     0     0     0     0     0     0     0     0     0     0     0  1009     0     0     0     0     0     0]
 [    0     0     0     0     0     0     0     0     0     0     0     0     0     0     0     0     0     0     0     0     0   215     0     0     0     0     0]
 [    0     0     0     0     0     0     0     0     0     0     0     0     0     0     0     0     0     0     0     0     0     0  2114     0     0     0     0]
 [    0     0     0     0     0     0     0     0     0     0     0     0     0     0     0     0     0     0     0     0     0     0     0    38     0     0     0]
 [    0     0     0     0     0     0     0     0     0     0     0     0     0     0     0     0     0     0     0     0     0     0     0     0    28     0     0]
 [    0     0     0     0     0     0     0     0     0     0     0     0     0     0     0     0     0     0     0     0     0     0     0     0     0    62     0]
 [    0     0     0     0     0     0     0     0     0     0     0     0     0     0     0     0     0     0     0     0     0     0     0     0     0     0   189]]

Accuracy: 0.9730258014073495

Precision: [0.9846 0.9672 0.9403 0.9348 0.9038 0.5476 0.9714 0.9679 1.0000 0.9994 0.9844 0.9966 0.3636 0.6000 0.8718 1.0000 1.0000 0.6562 0.7222 0.6310 0.9875 0.9811 0.9981 0.6667 1.0000 1.0000 1.0000]
Mean: 0.8769029975425972
Std: 0.1764403716534122

Recall: [0.9954 0.9219 0.9545 0.8269 0.9792 0.5750 0.9444 0.9797 0.9778 0.9959 0.8873 1.0000 0.4800 0.5455 0.8608 1.0000 0.9038 0.7119 0.4483 0.5824 0.9916 0.9455 0.9925 0.8571 0.7000 1.0000 0.9070]
Mean: 0.8505310332670152
Std: 0.1745162954862115

F1 score: [0.9900 0.9440 0.9474 0.8776 0.9400 0.5610 0.9577 0.9737 0.9888 0.9977 0.9333 0.9983 0.4138 0.5714 0.8662 1.0000 0.9495 0.6829 0.5532 0.6057 0.9896 0.9630 0.9953 0.7500 0.8235 1.0000 0.9512]
Mean: 0.8601772368137418
Std: 0.17185789491485778

Cohen Kappa score: 0.9619809971281797
Confusion matrix:
[[3652    2    2    2    0    0    0    2    0    1    1    0    0    0    2    0    0    0    2    0    0    0    0    3    0    0    0]
 [   5   59    0    0    0    0    0    0    0    0    0    0    0    0    0    0    0    0    0    0    0    0    0    0    0    0    0]
 [   1    0   63    0    1    0    0    0    0    0    0    0    0    0    0    0    0    0    0    0    1    0    0    0    0    0    0]
 [   9    0    0   43    0    0    0    0    0    0    0    0    0    0    0    0    0    0    0    0    0    0    0    0    0    0    0]
 [   1    0    0    0   47    0    0    0    0    0    0    0    0    0    0    0    0    0    0    0    0    0    0    0    0    0    0]
 [   0    0    0    0    0   23    0    0    0    0    0    0    2    3    0    0    0    2    0   10    0    0    0    0    0    0    0]
 [   0    0    0    0    0    0   34    2    0    0    0    0    0    0    0    0    0    0    0    0    0    0    0    0    0    0    0]
 [   1    0    1    0    0    0    0  241    0    0    0    0    0    0    0    0    0    0    0    0    2    1    0    0    0    0    0]
 [   0    0    0    0    0    0    0    0   44    0    0    0    0    0    0    0    0    0    0    0    0    0    1    0    0    0    0]
 [   6    0    0    0    0    0    0    0    0 1715    0    1    0    0    0    0    0    0    0    0    0    0    0    0    0    0    0]
 [   8    0    0    0    0    0    0    0    0    0   63    0    0    0    0    0    0    0    0    0    0    0    0    0    0    0    0]
 [   0    0    0    0    0    0    0    0    0    0    0  296    0    0    0    0    0    0    0    0    0    0    0    0    0    0    0]
 [   0    0    0    0    0    4    0    0    0    0    0    0   12    2    0    0    0    0    0    7    0    0    0    0    0    0    0]
 [   0    0    0    0    0    3    0    0    0    0    0    0    1   12    2    0    0    3    0    1    0    0    0    0    0    0    0]
 [   6    0    0    0    0    1    0    0    0    0    0    0    0    0   68    0    0    0    2    2    0    0    0    0    0    0    0]
 [   0    0    0    0    0    0    0    0    0    0    0    0    0    0    0   11    0    0    0    0    0    0    0    0    0    0    0]
 [   9    0    0    1    0    0    0    0    0    0    0    0    0    0    0    0   94    0    0    0    0    0    0    0    0    0    0]
 [   0    0    0    0    0    1    0    0    0    0    0    0    6    1    2    0    0   42    0    7    0    0    0    0    0    0    0]
 [   2    0    0    0    0    1    0    0    0    0    0    0    2    0    4    0    0    3   13    4    0    0    0    0    0    0    0]
 [   2    0    0    0    0    9    0    0    0    0    0    0   10    2    0    0    0   14    1   53    0    0    0    0    0    0    0]
 [   1    0    0    0    0    0    0    1    0    0    0    0    0    0    0    0    0    0    0    0  237    0    0    0    0    0    0]
 [   1    0    0    0    0    0    0    2    0    0    0    0    0    0    0    0    0    0    0    0    0   52    0    0    0    0    0]
 [   1    0    1    0    2    0    0    0    0    0    0    0    0    0    0    0    0    0    0    0    0    0  528    0    0    0    0]
 [   1    0    0    0    0    0    0    0    0    0    0    0    0    0    0    0    0    0    0    0    0    0    0    6    0    0    0]
 [   3    0    0    0    0    0    0    0    0    0    0    0    0    0    0    0    0    0    0    0    0    0    0    0    7    0    0]
 [   0    0    0    0    0    0    0    0    0    0    0    0    0    0    0    0    0    0    0    0    0    0    0    0    0   13    0]
 [   0    0    0    0    2    0    1    1    0    0    0    0    0    0    0    0    0    0    0    0    0    0    0    0    0    0   39]]

