Classifier: LinearSVC
Params: {'C': 1.0, 'class_weight': None, 'dual': True, 'fit_intercept': True, 'intercept_scaling': 1, 'loss': 'squared_hinge', 'max_iter': 1000, 'multi_class': 'ovr', 'penalty': 'l2', 'random_state': None, 'tol': 0.0001, 'verbose': 0}

Labels: None

Training accuracy: 0.986382590565546
Training confusion matrix:
[[14682     4     2     0     0     0     0     8     0     4     1     0     0     0     1     0     1     0     0     0     2     1     2     1     2     0     0]
 [    5   233     0     0     0     0     0     0     0     0     0     0     0     0     0     0     0     0     0     0     0     0     0     0     0     0     0]
 [    1     0   297     0     0     0     0     0     0     0     0     0     0     0     0     0     0     0     0     0     0     0     0     0     0     0     0]
 [   18     0     0   182     0     0     0     0     0     0     0     0     0     0     0     0     0     0     0     0     0     0     0     0     0     0     0]
 [    1     0     0     0   205     0     0     0     0     0     0     0     0     0     0     0     0     0     0     0     0     0     0     0     0     0     0]
 [    0     0     0     0     0   114     0     0     0     0     0     0     6     1     5     0     0     3     1    26     0     0     0     0     0     0     0]
 [    0     0     0     0     0     0   119     0     0     0     0     0     0     0     0     0     0     0     0     0     0     0     0     0     0     0     0]
 [    2     0     1     0     0     0     0   992     0     0     0     0     0     0     0     0     0     0     0     0     3     0     0     0     0     0     0]
 [    0     0     0     0     0     0     0     0   180     0     0     0     0     0     0     0     0     0     0     0     0     0     0     0     0     0     0]
 [    5     0     0     0     0     0     0     0     0  6856     0     0     0     0     0     0     0     0     0     0     0     0     0     0     0     0     0]
 [    5     0     0     0     0     0     0     0     0     0   208     0     0     0     0     0     0     0     0     0     0     0     0     0     0     0     0]
 [    0     0     0     0     0     0     0     0     0     0     0  1165     0     0     0     0     0     0     0     0     0     0     0     0     0     0     0]
 [    0     0     0     0     0     6     0     0     0     0     0     0    57     8     0     0     0     8     0    28     0     0     0     0     0     0     0]
 [    0     0     0     0     0     7     0     0     0     0     0     0     0    76     2     0     0     2     0     3     0     0     0     0     0     0     0]
 [    2     0     0     0     0     3     0     0     0     0     0     0     2     0   295     0     0     2     5     5     0     0     0     0     0     0     0]
 [    0     0     0     0     0     0     0     0     0     0     0     0     0     0     0    44     0     0     0     0     0     0     0     0     0     0     0]
 [   16     0     0     0     0     0     0     0     0     0     0     0     0     0     0     0   392     0     0     0     0     0     0     0     1     0     0]
 [    1     0     0     0     0     5     0     0     0     0     0     0    10    11     0     0     0   214     0    45     0     0     0     0     0     0     0]
 [    3     0     0     0     0     5     0     0     0     0     0     0     3     2    16     0     0     2    75    10     0     0     0     0     0     0     0]
 [    2     0     0     0     0    11     0     0     0     0     0     0    16    18     4     0     0    32     0   291     0     0     0     0     0     0     0]
 [    3     0     0     0     0     0     0     0     0     0     0     0     0     0     0     0     0     0     0     0   975     0     0     0     0     0     0]
 [    1     0     0     0     0     0     0     0     0     0     0     0     0     0     0     0     0     0     0     0     0   212     0     0     0     0     0]
 [    0     0     0     0     0     0     0     0     1     0     0     0     0     0     0     0     0     0     0     0     0     0  2107     0     0     0     0]
 [    1     0     0     0     0     0     0     0     0     0     0     0     0     0     0     0     0     0     0     0     0     0     0    35     0     0     0]
 [    2     0     0     0     0     0     0     0     0     0     0     0     0     0     0     0     0     0     0     0     0     0     0     0    27     0     0]
 [    0     0     0     0     0     0     0     1     0     0     0     0     0     0     0     0     0     0     0     0     0     0     0     0     0    60     0]
 [    1     0     0     0     0     0     0     0     0     0     0     0     0     0     0     0     0     0     0     0     0     0     0     0     0     0   185]]

Accuracy: 0.9786291373468856

Precision: [0.9883 0.9661 0.9841 0.9286 0.9783 0.5476 1.0000 0.9839 1.0000 0.9988 1.0000 1.0000 0.6111 0.5714 0.8588 1.0000 1.0000 0.7407 0.9565 0.6058 0.9963 0.9825 1.0000 1.0000 1.0000 1.0000 1.0000]
Mean: 0.9147693305272435
Std: 0.14852007200867276

Recall: [0.9970 0.9500 1.0000 0.8864 0.9783 0.6389 1.0000 0.9879 1.0000 0.9976 0.9821 1.0000 0.3929 0.8889 0.8690 0.9583 0.9231 0.6061 0.5238 0.6848 0.9852 0.9825 1.0000 0.8889 0.8889 0.9286 0.9783]
Mean: 0.8858234665384733
Std: 0.16246473969666078

F1 score: [0.9926 0.9580 0.9920 0.9070 0.9783 0.5897 1.0000 0.9859 1.0000 0.9982 0.9910 1.0000 0.4783 0.6957 0.8639 0.9787 0.9600 0.6667 0.6769 0.6429 0.9907 0.9825 1.0000 0.9412 0.9412 0.9630 0.9890]
Mean: 0.8949303876494551
Std: 0.15138821339919648

Cohen Kappa score: 0.9700837410223185
Confusion matrix:
[[3632    2    1    3    0    0    0    2    0    2    0    0    0    0    0    0    0    0    0    0    0    1    0    0    0    0    0]
 [   3   57    0    0    0    0    0    0    0    0    0    0    0    0    0    0    0    0    0    0    0    0    0    0    0    0    0]
 [   0    0   62    0    0    0    0    0    0    0    0    0    0    0    0    0    0    0    0    0    0    0    0    0    0    0    0]
 [   5    0    0   39    0    0    0    0    0    0    0    0    0    0    0    0    0    0    0    0    0    0    0    0    0    0    0]
 [   1    0    0    0   45    0    0    0    0    0    0    0    0    0    0    0    0    0    0    0    0    0    0    0    0    0    0]
 [   0    0    0    0    0   23    0    0    0    0    0    0    2    0    2    0    0    0    1    8    0    0    0    0    0    0    0]
 [   0    0    0    0    0    0   32    0    0    0    0    0    0    0    0    0    0    0    0    0    0    0    0    0    0    0    0]
 [   2    0    0    0    0    0    0  244    0    0    0    0    0    0    0    0    0    0    0    0    1    0    0    0    0    0    0]
 [   0    0    0    0    0    0    0    0   44    0    0    0    0    0    0    0    0    0    0    0    0    0    0    0    0    0    0]
 [   4    0    0    0    0    0    0    0    0 1687    0    0    0    0    0    0    0    0    0    0    0    0    0    0    0    0    0]
 [   1    0    0    0    0    0    0    0    0    0   55    0    0    0    0    0    0    0    0    0    0    0    0    0    0    0    0]
 [   0    0    0    0    0    0    0    0    0    0    0  312    0    0    0    0    0    0    0    0    0    0    0    0    0    0    0]
 [   1    0    0    0    0    2    0    0    0    0    0    0   11    4    0    0    0    3    0    7    0    0    0    0    0    0    0]
 [   0    0    0    0    0    2    0    0    0    0    0    0    0   16    0    0    0    0    0    0    0    0    0    0    0    0    0]
 [   8    0    0    0    0    0    0    0    0    0    0    0    0    1   73    0    0    0    0    2    0    0    0    0    0    0    0]
 [   1    0    0    0    0    0    0    0    0    0    0    0    0    0    0   23    0    0    0    0    0    0    0    0    0    0    0]
 [   8    0    0    0    0    0    0    0    0    0    0    0    0    0    0    0   96    0    0    0    0    0    0    0    0    0    0]
 [   1    0    0    0    0    4    0    0    0    0    0    0    3    0    0    0    0   40    0   18    0    0    0    0    0    0    0]
 [   1    0    0    0    0    2    0    0    0    0    0    0    1    1    7    0    0    2   22    6    0    0    0    0    0    0    0]
 [   1    0    0    0    0    9    0    0    0    0    0    0    1    6    3    0    0    9    0   63    0    0    0    0    0    0    0]
 [   3    0    0    0    0    0    0    1    0    0    0    0    0    0    0    0    0    0    0    0  266    0    0    0    0    0    0]
 [   1    0    0    0    0    0    0    0    0    0    0    0    0    0    0    0    0    0    0    0    0   56    0    0    0    0    0]
 [   0    0    0    0    0    0    0    0    0    0    0    0    0    0    0    0    0    0    0    0    0    0  538    0    0    0    0]
 [   1    0    0    0    0    0    0    0    0    0    0    0    0    0    0    0    0    0    0    0    0    0    0    8    0    0    0]
 [   1    0    0    0    0    0    0    0    0    0    0    0    0    0    0    0    0    0    0    0    0    0    0    0    8    0    0]
 [   0    0    0    0    1    0    0    0    0    0    0    0    0    0    0    0    0    0    0    0    0    0    0    0    0   13    0]
 [   0    0    0    0    0    0    0    1    0    0    0    0    0    0    0    0    0    0    0    0    0    0    0    0    0    0   45]]

