Classifier: LogisticRegression
Params: {'C': 1.0, 'class_weight': None, 'dual': False, 'fit_intercept': True, 'intercept_scaling': 1, 'max_iter': 100, 'multi_class': 'ovr', 'n_jobs': 1, 'penalty': 'l2', 'random_state': None, 'solver': 'liblinear', 'tol': 0.0001, 'verbose': 0, 'warm_start': False}

Labels: None

Training accuracy: 0.972765181131092
Training confusion matrix:
[[14631     8     3     0     0     0     0    15     0    24     1     0     0     0     1     0     0     7     0     0     9     4     7     0     0     0     1]
 [   14   224     0     0     0     0     0     0     0     0     0     0     0     0     0     0     0     0     0     0     0     0     0     0     0     0     0]
 [   11     0   285     0     0     0     0     0     0     0     0     0     0     0     0     0     0     0     0     0     1     1     0     0     0     0     0]
 [   65     0     0   135     0     0     0     0     0     0     0     0     0     0     0     0     0     0     0     0     0     0     0     0     0     0     0]
 [    4     0     0     0   202     0     0     0     0     0     0     0     0     0     0     0     0     0     0     0     0     0     0     0     0     0     0]
 [    5     0     0     0     0    98     0     0     0     0     0     0     3     1     3     0     0     8     0    38     0     0     0     0     0     0     0]
 [    1     0     0     0     0     0   118     0     0     0     0     0     0     0     0     0     0     0     0     0     0     0     0     0     0     0     0]
 [   23     0     1     0     0     0     0   964     0     0     0     0     0     0     0     0     0     0     0     0    10     0     0     0     0     0     0]
 [    1     0     0     0     0     0     0     0   178     0     0     0     0     0     0     0     0     0     0     0     0     0     1     0     0     0     0]
 [   23     0     0     0     0     0     0     0     0  6837     0     1     0     0     0     0     0     0     0     0     0     0     0     0     0     0     0]
 [   27     0     0     0     0     0     0     0     0     0   186     0     0     0     0     0     0     0     0     0     0     0     0     0     0     0     0]
 [   13     0     0     0     0     0     0     0     0     4     0  1148     0     0     0     0     0     0     0     0     0     0     0     0     0     0     0]
 [    2     0     0     0     0     8     0     0     0     0     0     0    43     6     0     0     0    11     0    37     0     0     0     0     0     0     0]
 [    3     0     0     0     0     8     0     0     0     0     0     0     1    43     1     0     0     8     0    26     0     0     0     0     0     0     0]
 [   13     0     0     0     0     8     0     0     0     0     0     0     2     1   274     0     0     3     4     9     0     0     0     0     0     0     0]
 [    0     0     0     0     0     0     0     0     0     0     0     0     0     0     0    44     0     0     0     0     0     0     0     0     0     0     0]
 [   50     0     0     0     0     0     0     0     0     0     0     0     0     0     0     0   359     0     0     0     0     0     0     0     0     0     0]
 [   16     0     0     0     0     5     0     0     0     0     0     0     6     3     0     0     0   191     1    64     0     0     0     0     0     0     0]
 [   13     0     0     0     0     6     0     0     0     0     0     0     3     2    27     0     0     3    49    13     0     0     0     0     0     0     0]
 [   16     0     0     0     0     3     0     0     0     0     0     0     9     2     2     0     0    33     1   308     0     0     0     0     0     0     0]
 [    9     0     0     0     0     0     0     0     0     0     0     0     0     0     0     0     0     0     0     0   969     0     0     0     0     0     0]
 [    5     0     0     0     0     0     0     3     0     0     0     0     0     0     0     0     0     0     0     0     3   202     0     0     0     0     0]
 [    5     0     0     0     0     0     0     0     1     0     0     0     0     0     0     0     0     0     0     0     0     0  2102     0     0     0     0]
 [   17     0     0     0     0     0     0     0     0     0     0     0     0     0     0     0     0     0     0     0     0     0     0    19     0     0     0]
 [   10     0     0     0     0     0     0     0     0     0     0     0     0     0     0     0     0     0     0     0     0     0     0     0    19     0     0]
 [    3     0     0     0     1     0     0     1     0     0     0     0     0     0     0     0     0     0     0     0     0     0     0     0     0    56     0]
 [    6     0     1     0     0     0     0     1     0     0     0     0     0     0     0     0     0     0     0     0     2     0     0     0     0     0   176]]

Accuracy: 0.9685952567109721

Precision: [0.9705 0.9333 0.9683 1.0000 0.9184 0.5938 1.0000 0.9712 1.0000 0.9976 1.0000 1.0000 0.7500 0.5882 0.8919 1.0000 1.0000 0.7037 0.9444 0.5891 0.9851 0.9623 0.9944 1.0000 1.0000 1.0000 1.0000]
Mean: 0.9171231331668792
Std: 0.13587827062235802

Recall: [0.9948 0.9333 0.9839 0.6818 0.9783 0.5278 1.0000 0.9555 1.0000 0.9976 0.8929 0.9776 0.3214 0.5556 0.7857 0.9167 0.8750 0.5758 0.4048 0.8261 0.9815 0.8947 0.9963 0.6667 0.3333 0.8571 0.9130]
Mean: 0.8084083600004397
Std: 0.21415527392050526

F1 score: [0.9825 0.9333 0.9760 0.8108 0.9474 0.5588 1.0000 0.9633 1.0000 0.9976 0.9434 0.9887 0.4500 0.5714 0.8354 0.9565 0.9333 0.6333 0.5667 0.6878 0.9833 0.9273 0.9954 0.8000 0.5000 0.9231 0.9545]
Mean: 0.8451801718299926
Std: 0.17626867102917562

Cohen Kappa score: 0.9558120494077863
Confusion matrix:
[[3624    4    1    0    0    0    0    3    0    4    0    0    0    0    0    0    0    2    0    0    2    2    1    0    0    0    0]
 [   4   56    0    0    0    0    0    0    0    0    0    0    0    0    0    0    0    0    0    0    0    0    0    0    0    0    0]
 [   1    0   61    0    0    0    0    0    0    0    0    0    0    0    0    0    0    0    0    0    0    0    0    0    0    0    0]
 [  14    0    0   30    0    0    0    0    0    0    0    0    0    0    0    0    0    0    0    0    0    0    0    0    0    0    0]
 [   1    0    0    0   45    0    0    0    0    0    0    0    0    0    0    0    0    0    0    0    0    0    0    0    0    0    0]
 [   3    0    0    0    0   19    0    0    0    0    0    0    1    0    0    0    0    1    0   12    0    0    0    0    0    0    0]
 [   0    0    0    0    0    0   32    0    0    0    0    0    0    0    0    0    0    0    0    0    0    0    0    0    0    0    0]
 [   9    0    0    0    0    0    0  236    0    0    0    0    0    0    0    0    0    0    0    0    2    0    0    0    0    0    0]
 [   0    0    0    0    0    0    0    0   44    0    0    0    0    0    0    0    0    0    0    0    0    0    0    0    0    0    0]
 [   4    0    0    0    0    0    0    0    0 1687    0    0    0    0    0    0    0    0    0    0    0    0    0    0    0    0    0]
 [   6    0    0    0    0    0    0    0    0    0   50    0    0    0    0    0    0    0    0    0    0    0    0    0    0    0    0]
 [   7    0    0    0    0    0    0    0    0    0    0  305    0    0    0    0    0    0    0    0    0    0    0    0    0    0    0]
 [   1    0    0    0    0    2    0    0    0    0    0    0    9    5    0    0    0    3    0    8    0    0    0    0    0    0    0]
 [   1    0    0    0    0    2    0    0    0    0    0    0    1   10    0    0    0    1    0    3    0    0    0    0    0    0    0]
 [  14    0    0    0    0    0    0    0    0    0    0    0    0    1   66    0    0    0    1    2    0    0    0    0    0    0    0]
 [   1    0    1    0    0    0    0    0    0    0    0    0    0    0    0   22    0    0    0    0    0    0    0    0    0    0    0]
 [  13    0    0    0    0    0    0    0    0    0    0    0    0    0    0    0   91    0    0    0    0    0    0    0    0    0    0]
 [   2    0    0    0    0    4    0    0    0    0    0    0    0    0    0    0    0   38    0   22    0    0    0    0    0    0    0]
 [   3    0    0    0    0    4    0    0    0    0    0    0    1    1    8    0    0    2   17    6    0    0    0    0    0    0    0]
 [   7    0    0    0    0    1    0    0    0    0    0    0    0    0    0    0    0    7    0   76    0    0    1    0    0    0    0]
 [   4    0    0    0    0    0    0    1    0    0    0    0    0    0    0    0    0    0    0    0  265    0    0    0    0    0    0]
 [   4    0    0    0    0    0    0    2    0    0    0    0    0    0    0    0    0    0    0    0    0   51    0    0    0    0    0]
 [   1    0    0    0    1    0    0    0    0    0    0    0    0    0    0    0    0    0    0    0    0    0  536    0    0    0    0]
 [   3    0    0    0    0    0    0    0    0    0    0    0    0    0    0    0    0    0    0    0    0    0    0    6    0    0    0]
 [   6    0    0    0    0    0    0    0    0    0    0    0    0    0    0    0    0    0    0    0    0    0    0    0    3    0    0]
 [   0    0    0    0    2    0    0    0    0    0    0    0    0    0    0    0    0    0    0    0    0    0    0    0    0   12    0]
 [   1    0    0    0    1    0    0    1    0    0    0    0    0    0    0    0    0    0    0    0    0    0    1    0    0    0   42]]

