Classifier: MLPClassifier
Params: {'activation': 'relu', 'alpha': 0.0001, 'batch_size': 'auto', 'beta_1': 0.9, 'beta_2': 0.999, 'early_stopping': False, 'epsilon': 1e-08, 'hidden_layer_sizes': (100,), 'learning_rate': 'constant', 'learning_rate_init': 0.001, 'max_iter': 200, 'momentum': 0.9, 'nesterovs_momentum': True, 'power_t': 0.5, 'random_state': None, 'shuffle': True, 'solver': 'adam', 'tol': 0.0001, 'validation_fraction': 0.1, 'verbose': False, 'warm_start': False}

Labels: None

Training accuracy: 0.9910737555381809
Training confusion matrix:
[[14700     0     2     4     0     0     0     0     0     0     0     0     0     0     0     0     4     0     0     0     0     0     0     1     0     0     0]
 [    0   238     0     0     0     0     0     0     0     0     0     0     0     0     0     0     0     0     0     0     0     0     0     0     0     0     0]
 [    1     0   297     0     0     0     0     0     0     0     0     0     0     0     0     0     0     0     0     0     0     0     0     0     0     0     0]
 [    0     0     0   200     0     0     0     0     0     0     0     0     0     0     0     0     0     0     0     0     0     0     0     0     0     0     0]
 [    0     0     0     0   206     0     0     0     0     0     0     0     0     0     0     0     0     0     0     0     0     0     0     0     0     0     0]
 [    0     0     0     0     0   134     0     0     0     0     0     0     3     4     1     0     0     2     1    11     0     0     0     0     0     0     0]
 [    0     0     0     0     0     0   119     0     0     0     0     0     0     0     0     0     0     0     0     0     0     0     0     0     0     0     0]
 [    0     0     0     0     0     0     0   997     0     0     0     0     0     0     0     0     0     0     0     0     1     0     0     0     0     0     0]
 [    0     0     0     0     0     0     0     0   180     0     0     0     0     0     0     0     0     0     0     0     0     0     0     0     0     0     0]
 [    0     0     0     0     0     0     0     0     0  6861     0     0     0     0     0     0     0     0     0     0     0     0     0     0     0     0     0]
 [    0     0     0     0     0     0     0     0     0     0   213     0     0     0     0     0     0     0     0     0     0     0     0     0     0     0     0]
 [    0     0     0     0     0     0     0     0     0     0     0  1165     0     0     0     0     0     0     0     0     0     0     0     0     0     0     0]
 [    0     0     0     0     0     6     0     0     0     0     0     0    74     6     0     0     0    12     0     9     0     0     0     0     0     0     0]
 [    0     0     0     0     0     2     0     0     0     0     0     0     0    84     0     0     0     2     0     2     0     0     0     0     0     0     0]
 [    0     0     0     0     0     6     0     0     0     0     0     0     1     1   288     0     0     1    13     4     0     0     0     0     0     0     0]
 [    0     0     0     0     0     0     0     0     0     0     0     0     0     0     0    44     0     0     0     0     0     0     0     0     0     0     0]
 [    2     0     0     0     0     0     0     0     0     0     0     0     0     0     0     0   407     0     0     0     0     0     0     0     0     0     0]
 [    0     0     0     0     0     6     0     0     0     0     0     0     5    10     0     0     0   240     0    25     0     0     0     0     0     0     0]
 [    0     0     0     0     0     5     0     0     0     0     0     0     0     2     6     0     0     2    93     8     0     0     0     0     0     0     0]
 [    0     0     0     0     0    21     0     0     0     0     0     0    20    13     2     0     0    44     2   272     0     0     0     0     0     0     0]
 [    1     0     0     0     0     0     0     0     0     0     0     0     0     0     0     0     0     0     0     0   977     0     0     0     0     0     0]
 [    0     0     0     0     0     0     0     0     0     0     0     0     0     0     0     0     0     0     0     0     0   213     0     0     0     0     0]
 [    0     0     0     0     0     0     0     0     0     0     0     0     0     0     0     0     0     0     0     0     0     0  2108     0     0     0     0]
 [    0     0     0     0     0     0     0     0     0     0     0     0     0     0     0     0     0     0     0     0     0     0     0    36     0     0     0]
 [    0     0     0     0     0     0     0     0     0     0     0     0     0     0     0     0     0     0     0     0     0     0     0     0    29     0     0]
 [    0     0     0     0     0     0     0     0     0     0     0     0     0     0     0     0     0     0     0     0     0     0     0     0     0    61     0]
 [    0     0     0     0     0     0     0     0     0     0     0     0     0     0     0     0     0     0     0     0     0     0     0     0     0     0   186]]

Accuracy: 0.979932238728173

Precision: [0.9921 0.9492 0.9841 0.8571 0.9783 0.5682 1.0000 0.9720 1.0000 0.9976 1.0000 1.0000 0.7368 0.5600 0.9359 1.0000 0.9902 0.6712 0.8485 0.6437 0.9963 1.0000 1.0000 1.0000 1.0000 1.0000 1.0000]
Mean: 0.9141171291512763
Std: 0.1410240946302713

Recall: [0.9948 0.9333 1.0000 0.9545 0.9783 0.6944 1.0000 0.9838 1.0000 0.9982 0.9821 1.0000 0.5000 0.7778 0.8690 0.9583 0.9712 0.7424 0.6667 0.6087 0.9889 0.9825 1.0000 1.0000 0.6667 0.9286 0.9783]
Mean: 0.8947587473613111
Std: 0.14513164778856372

F1 score: [0.9934 0.9412 0.9920 0.9032 0.9783 0.6250 1.0000 0.9779 1.0000 0.9979 0.9910 1.0000 0.5957 0.6512 0.9012 0.9787 0.9806 0.7050 0.7467 0.6257 0.9926 0.9912 1.0000 1.0000 0.8000 0.9630 0.9890]
Mean: 0.9007559853397682
Std: 0.13841376740565597

Cohen Kappa score: 0.9719571480612542
Confusion matrix:
[[3624    3    1    6    0    0    0    4    0    4    0    0    0    0    0    0    1    0    0    0    0    0    0    0    0    0    0]
 [   4   56    0    0    0    0    0    0    0    0    0    0    0    0    0    0    0    0    0    0    0    0    0    0    0    0    0]
 [   0    0   62    0    0    0    0    0    0    0    0    0    0    0    0    0    0    0    0    0    0    0    0    0    0    0    0]
 [   2    0    0   42    0    0    0    0    0    0    0    0    0    0    0    0    0    0    0    0    0    0    0    0    0    0    0]
 [   1    0    0    0   45    0    0    0    0    0    0    0    0    0    0    0    0    0    0    0    0    0    0    0    0    0    0]
 [   0    0    0    0    0   25    0    0    0    0    0    0    1    2    0    0    0    0    1    7    0    0    0    0    0    0    0]
 [   0    0    0    0    0    0   32    0    0    0    0    0    0    0    0    0    0    0    0    0    0    0    0    0    0    0    0]
 [   3    0    0    0    0    0    0  243    0    0    0    0    0    0    0    0    0    0    0    0    1    0    0    0    0    0    0]
 [   0    0    0    0    0    0    0    0   44    0    0    0    0    0    0    0    0    0    0    0    0    0    0    0    0    0    0]
 [   3    0    0    0    0    0    0    0    0 1688    0    0    0    0    0    0    0    0    0    0    0    0    0    0    0    0    0]
 [   1    0    0    0    0    0    0    0    0    0   55    0    0    0    0    0    0    0    0    0    0    0    0    0    0    0    0]
 [   0    0    0    0    0    0    0    0    0    0    0  312    0    0    0    0    0    0    0    0    0    0    0    0    0    0    0]
 [   1    0    0    0    0    2    0    0    0    0    0    0   14    4    0    0    0    2    0    5    0    0    0    0    0    0    0]
 [   1    0    0    0    0    2    0    0    0    0    0    0    0   14    0    0    0    1    0    0    0    0    0    0    0    0    0]
 [   4    0    0    0    0    0    0    0    0    0    0    0    0    1   73    0    0    0    4    2    0    0    0    0    0    0    0]
 [   1    0    0    0    0    0    0    0    0    0    0    0    0    0    0   23    0    0    0    0    0    0    0    0    0    0    0]
 [   3    0    0    0    0    0    0    0    0    0    0    0    0    0    0    0  101    0    0    0    0    0    0    0    0    0    0]
 [   1    0    0    0    0    4    0    0    0    0    0    0    1    0    0    0    0   49    0   11    0    0    0    0    0    0    0]
 [   0    0    0    0    0    1    0    0    0    0    0    0    1    1    3    0    0    2   28    6    0    0    0    0    0    0    0]
 [   0    0    0    0    0   10    0    0    0    0    0    0    2    3    2    0    0   19    0   56    0    0    0    0    0    0    0]
 [   1    0    0    0    0    0    0    2    0    0    0    0    0    0    0    0    0    0    0    0  267    0    0    0    0    0    0]
 [   1    0    0    0    0    0    0    0    0    0    0    0    0    0    0    0    0    0    0    0    0   56    0    0    0    0    0]
 [   0    0    0    0    0    0    0    0    0    0    0    0    0    0    0    0    0    0    0    0    0    0  538    0    0    0    0]
 [   0    0    0    0    0    0    0    0    0    0    0    0    0    0    0    0    0    0    0    0    0    0    0    9    0    0    0]
 [   2    0    0    1    0    0    0    0    0    0    0    0    0    0    0    0    0    0    0    0    0    0    0    0    6    0    0]
 [   0    0    0    0    1    0    0    0    0    0    0    0    0    0    0    0    0    0    0    0    0    0    0    0    0   13    0]
 [   0    0    0    0    0    0    0    1    0    0    0    0    0    0    0    0    0    0    0    0    0    0    0    0    0    0   45]]

