Classifier: MultinomialNB
Params: {'alpha': 1.0, 'class_prior': None, 'fit_prior': True}

Labels: None

Training accuracy: 0.9076426896012509
Training confusion matrix:
[[14513     0     1     0     0     0     0    82     0    37     0     0     0     0     0     0     0     0     0    48    16     0    14     0     0     0     0]
 [  171    67     0     0     0     0     0     0     0     0     0     0     0     0     0     0     0     0     0     0     0     0     0     0     0     0     0]
 [   42     0   146     0     0     0     0   100     0     0     0     0     0     0     0     0     0     0     0     0     8     0     2     0     0     0     0]
 [  106     0     0    66     0     0     0     0     0     0     0     0     0     0     0     0     0     0     0     0     0     0    28     0     0     0     0]
 [    6     0     0     0   121     0     0    49     0     0     0     0     0     0     0     0     0     0     0     0     1     0    29     0     0     0     0]
 [    9     0     0     0     0     0     0     0     0     0     0     0     0     0     0     0     0     0     0   147     0     0     0     0     0     0     0]
 [    1     0     0     0     0     0     5    80     0     0     0     0     0     0     0     0     0     0     0     0     0     0    33     0     0     0     0]
 [   11     0     1     0     0     0     0   975     0     0     0     0     0     0     0     0     0     0     0     0     9     0     2     0     0     0     0]
 [    1     0     0     0     0     0     0     3   159     0     0     0     0     0     0     0     4     0     0     0     0     0    13     0     0     0     0]
 [  123     0     0     0     0     0     0     0     0  6721     0     2     0     0     0     0     0     0     0     0     0     0    15     0     0     0     0]
 [  212     0     0     0     0     0     0     0     0     0     1     0     0     0     0     0     0     0     0     0     0     0     0     0     0     0     0]
 [   41     0     0     0     0     0     0     0     0     4     0  1120     0     0     0     0     0     0     0     0     0     0     0     0     0     0     0]
 [    3     0     0     0     0     0     0     0     0     0     0     0     0     0     0     0     0     0     0   104     0     0     0     0     0     0     0]
 [    4     0     0     0     0     0     0     0     0     0     0     0     0     0     0     0     0     0     0    86     0     0     0     0     0     0     0]
 [  109     0     0     0     0     0     0     0     0     0     0     0     0     0    76     0     0     0     0   114     0     0    15     0     0     0     0]
 [    1     0     0     0     0     0     0    19     0     0     0     0     0     0     0     5     0     0     0     0     0     0    19     0     0     0     0]
 [   70     0     0     0     0     0     0     5     0     0     0     0     0     0     0     0   332     0     0     0     0     0     2     0     0     0     0]
 [   63     0     0     0     0     0     0     0     0     0     0     0     0     0     1     0     0     2     0   220     0     0     0     0     0     0     0]
 [   37     0     0     0     0     0     0     0     0     0     0     0     0     0     0     0     0     0     0    79     0     0     0     0     0     0     0]
 [   48     0     0     0     0     0     0     0     0     0     0     0     0     0     0     0     0     0     0   322     0     0     4     0     0     0     0]
 [   28     0     0     0     0     0     0    20     0     0     0     0     0     0     0     0     0     0     0     0   923     0     7     0     0     0     0]
 [    6     0     0     0     0     0     0    47     0     0     0     0     0     0     0     0     0     0     0     0    45    89    26     0     0     0     0]
 [    3     0     0     0     0     0     0     7     1     0     0     0     0     0     0     0     0     0     0     0     0     0  2097     0     0     0     0]
 [   36     0     0     0     0     0     0     0     0     0     0     0     0     0     0     0     0     0     0     0     0     0     0     0     0     0     0]
 [   29     0     0     0     0     0     0     0     0     0     0     0     0     0     0     0     0     0     0     0     0     0     0     0     0     0     0]
 [    5     0     0     0     0     0     0    23     0     0     0     0     0     0     0     0     1     0     0     0     1     0    31     0     0     0     0]
 [   24     0     0     0     0     0     0    30     0     0     0     0     0     0     0     0     0     0     0     0     4     0     7     0     0     0   121]]

Accuracy: 0.9048735991660151

Precision: [0.9197 1.0000 0.9744 1.0000 1.0000 0.0000 1.0000 0.6868 1.0000 0.9958 1.0000 1.0000 0.0000 0.0000 1.0000 1.0000 0.9884 0.0000 0.0000 0.2711 0.9055 1.0000 0.8814 0.0000 0.0000 1.0000 1.0000]
Mean: 0.6897361195828035
Std: 0.4329317177051734

Recall: [0.9901 0.2333 0.6129 0.3864 0.4783 0.0000 0.1250 0.9676 0.8864 0.9763 0.0179 0.9647 0.0000 0.0000 0.1429 0.1250 0.8173 0.0000 0.0000 0.8043 0.9222 0.3333 0.9944 0.0000 0.0000 0.0714 0.7174]
Mean: 0.4284152609938535
Std: 0.39795503177157604

F1 score: [0.9536 0.3784 0.7525 0.5574 0.6471 0.0000 0.2222 0.8034 0.9398 0.9860 0.0351 0.9821 0.0000 0.0000 0.2500 0.2222 0.8947 0.0000 0.0000 0.4055 0.9138 0.5000 0.9345 0.0000 0.0000 0.1333 0.8354]
Mean: 0.45728953825584345
Std: 0.3833855772451529

Cohen Kappa score: 0.8639407802052758
Confusion matrix:
[[3607    0    0    0    0    0    0   14    0    7    0    0    0    0    0    0    0    0    0    8    4    0    3    0    0    0    0]
 [  46   14    0    0    0    0    0    0    0    0    0    0    0    0    0    0    0    0    0    0    0    0    0    0    0    0    0]
 [   7    0   38    0    0    0    0   16    0    0    0    0    0    0    0    0    0    0    0    0    1    0    0    0    0    0    0]
 [  22    0    0   17    0    0    0    0    0    0    0    0    0    0    0    0    0    0    0    0    0    0    5    0    0    0    0]
 [   3    0    0    0   22    0    0   16    0    0    0    0    0    0    0    0    0    0    0    0    0    0    5    0    0    0    0]
 [   3    0    0    0    0    0    0    0    0    0    0    0    0    0    0    0    0    0    0   33    0    0    0    0    0    0    0]
 [   0    0    0    0    0    0    4   18    0    0    0    0    0    0    0    0    0    0    0    0    0    0   10    0    0    0    0]
 [   5    0    0    0    0    0    0  239    0    0    0    0    0    0    0    0    0    0    0    0    2    0    1    0    0    0    0]
 [   0    0    0    0    0    0    0    0   39    0    0    0    0    0    0    0    1    0    0    0    0    0    4    0    0    0    0]
 [  32    0    0    0    0    0    0    0    0 1651    0    0    0    0    0    0    0    0    0    0    0    0    8    0    0    0    0]
 [  55    0    0    0    0    0    0    0    0    0    1    0    0    0    0    0    0    0    0    0    0    0    0    0    0    0    0]
 [  11    0    0    0    0    0    0    0    0    0    0  301    0    0    0    0    0    0    0    0    0    0    0    0    0    0    0]
 [   1    0    0    0    0    0    0    0    0    0    0    0    0    0    0    0    0    0    0   27    0    0    0    0    0    0    0]
 [   1    0    0    0    0    0    0    0    0    0    0    0    0    0    0    0    0    0    0   17    0    0    0    0    0    0    0]
 [  37    0    0    0    0    0    0    0    0    0    0    0    0    0   12    0    0    0    0   28    0    0    7    0    0    0    0]
 [   1    0    0    0    0    0    0   13    0    0    0    0    0    0    0    3    0    0    0    0    0    0    7    0    0    0    0]
 [  17    0    0    0    0    0    0    1    0    0    0    0    0    0    0    0   85    0    0    0    0    0    1    0    0    0    0]
 [  13    0    0    0    0    0    0    0    0    0    0    0    0    0    0    0    0    0    0   53    0    0    0    0    0    0    0]
 [   9    0    0    0    0    0    0    0    0    0    0    0    0    0    0    0    0    0    0   33    0    0    0    0    0    0    0]
 [  16    0    0    0    0    0    0    0    0    0    0    0    0    0    0    0    0    0    0   74    0    0    2    0    0    0    0]
 [   9    0    0    0    0    0    0    7    0    0    0    0    0    0    0    0    0    0    0    0  249    0    5    0    0    0    0]
 [   4    0    0    0    0    0    0   12    0    0    0    0    0    0    0    0    0    0    0    0   19   19    3    0    0    0    0]
 [   1    0    0    0    0    0    0    2    0    0    0    0    0    0    0    0    0    0    0    0    0    0  535    0    0    0    0]
 [   9    0    0    0    0    0    0    0    0    0    0    0    0    0    0    0    0    0    0    0    0    0    0    0    0    0    0]
 [   9    0    0    0    0    0    0    0    0    0    0    0    0    0    0    0    0    0    0    0    0    0    0    0    0    0    0]
 [   0    0    1    0    0    0    0    4    0    0    0    0    0    0    0    0    0    0    0    0    0    0    8    0    0    1    0]
 [   4    0    0    0    0    0    0    6    0    0    0    0    0    0    0    0    0    0    0    0    0    0    3    0    0    0   33]]

