Classifier: RandomForestClassifier
Params: {'bootstrap': True, 'class_weight': None, 'criterion': 'gini', 'max_depth': None, 'max_features': 'auto', 'max_leaf_nodes': None, 'min_impurity_decrease': 0.0, 'min_impurity_split': None, 'min_samples_leaf': 1, 'min_samples_split': 2, 'min_weight_fraction_leaf': 0.0, 'n_estimators': 100, 'n_jobs': 1, 'oob_score': False, 'random_state': None, 'verbose': 0, 'warm_start': False}

Labels: None

Training accuracy: 0.9951785248892364
Training confusion matrix:
[[14706     0     1     3     0     0     0     0     0     0     0     0     0     0     0     0     1     0     0     0     0     0     0     0     0     0     0]
 [    0   238     0     0     0     0     0     0     0     0     0     0     0     0     0     0     0     0     0     0     0     0     0     0     0     0     0]
 [    0     0   298     0     0     0     0     0     0     0     0     0     0     0     0     0     0     0     0     0     0     0     0     0     0     0     0]
 [    1     0     0   199     0     0     0     0     0     0     0     0     0     0     0     0     0     0     0     0     0     0     0     0     0     0     0]
 [    0     0     0     0   206     0     0     0     0     0     0     0     0     0     0     0     0     0     0     0     0     0     0     0     0     0     0]
 [    0     0     0     0     0   142     0     0     0     0     0     0     0     1     1     0     0     1     0    11     0     0     0     0     0     0     0]
 [    0     0     0     0     0     0   119     0     0     0     0     0     0     0     0     0     0     0     0     0     0     0     0     0     0     0     0]
 [    0     0     0     0     0     0     0   997     0     0     0     0     0     0     0     0     0     0     0     0     1     0     0     0     0     0     0]
 [    0     0     0     0     0     0     0     0   180     0     0     0     0     0     0     0     0     0     0     0     0     0     0     0     0     0     0]
 [    0     0     0     0     0     0     0     0     0  6861     0     0     0     0     0     0     0     0     0     0     0     0     0     0     0     0     0]
 [    0     0     0     0     0     0     0     0     0     0   213     0     0     0     0     0     0     0     0     0     0     0     0     0     0     0     0]
 [    0     0     0     0     0     0     0     0     0     0     0  1165     0     0     0     0     0     0     0     0     0     0     0     0     0     0     0]
 [    0     0     0     0     0     1     0     0     0     0     0     0    95     0     0     0     0     2     0     9     0     0     0     0     0     0     0]
 [    0     0     0     0     0     2     0     0     0     0     0     0     0    82     1     0     0     3     0     2     0     0     0     0     0     0     0]
 [    0     0     0     0     0     2     0     0     0     0     0     0     0     0   306     0     0     1     3     2     0     0     0     0     0     0     0]
 [    0     0     0     0     0     0     0     0     0     0     0     0     0     0     0    44     0     0     0     0     0     0     0     0     0     0     0]
 [    2     0     0     0     0     0     0     0     0     0     0     0     0     0     0     0   407     0     0     0     0     0     0     0     0     0     0]
 [    0     0     0     0     0     2     0     0     0     0     0     0     4     1     0     0     0   258     1    20     0     0     0     0     0     0     0]
 [    0     0     0     0     0     2     0     0     0     0     0     0     0     1    12     0     0     0    98     3     0     0     0     0     0     0     0]
 [    0     0     0     0     0     5     0     0     0     0     0     0    14     5     2     0     0    21     2   325     0     0     0     0     0     0     0]
 [    1     0     0     0     0     0     0     0     0     0     0     0     0     0     0     0     0     0     0     0   977     0     0     0     0     0     0]
 [    0     0     0     0     0     0     0     0     0     0     0     0     0     0     0     0     0     0     0     0     0   213     0     0     0     0     0]
 [    0     0     0     0     0     0     0     0     0     0     0     0     0     0     0     0     0     0     0     0     0     0  2108     0     0     0     0]
 [    1     0     0     0     0     0     0     0     0     0     0     0     0     0     0     0     0     0     0     0     0     0     0    35     0     0     0]
 [    0     0     0     0     0     0     0     0     0     0     0     0     0     0     0     0     0     0     0     0     0     0     0     0    29     0     0]
 [    0     0     0     0     0     0     0     0     0     0     0     0     0     0     0     0     0     0     0     0     0     0     0     0     0    61     0]
 [    0     0     0     0     0     0     0     0     0     0     0     0     0     0     0     0     0     0     0     0     0     0     0     0     0     0   186]]

Accuracy: 0.9698983580922595

Precision: [0.9792 0.9138 0.9667 0.9167 0.8824 0.5946 0.9667 0.9640 1.0000 0.9988 1.0000 1.0000 0.6500 0.5000 0.8289 0.9130 0.9897 0.5970 0.9091 0.5729 0.9888 0.9811 0.9981 1.0000 1.0000 1.0000 0.9762]
Mean: 0.892139718796416
Std: 0.15467385720154758

Recall: [0.9951 0.8833 0.9355 0.7500 0.9783 0.6111 0.9062 0.9757 1.0000 0.9976 0.9286 1.0000 0.4643 0.6667 0.7500 0.8750 0.9231 0.6061 0.4762 0.5978 0.9852 0.9123 0.9981 0.8889 0.6667 0.8571 0.8913]
Mean: 0.8340788538253966
Std: 0.16557815207539858

F1 score: [0.9871 0.8983 0.9508 0.8250 0.9278 0.6027 0.9355 0.9698 1.0000 0.9982 0.9630 1.0000 0.5417 0.5714 0.7875 0.8936 0.9552 0.6015 0.6250 0.5851 0.9870 0.9455 0.9981 0.9412 0.8000 0.9231 0.9318]
Mean: 0.8572586229438732
Std: 0.15442276955718218

Cohen Kappa score: 0.9577637483788772
Confusion matrix:
[[3625    5    0    3    0    0    0    0    0    2    0    0    0    0    3    1    1    0    0    1    0    1    1    0    0    0    0]
 [   7   53    0    0    0    0    0    0    0    0    0    0    0    0    0    0    0    0    0    0    0    0    0    0    0    0    0]
 [   1    0   58    0    3    0    0    0    0    0    0    0    0    0    0    0    0    0    0    0    0    0    0    0    0    0    0]
 [  11    0    0   33    0    0    0    0    0    0    0    0    0    0    0    0    0    0    0    0    0    0    0    0    0    0    0]
 [   1    0    0    0   45    0    0    0    0    0    0    0    0    0    0    0    0    0    0    0    0    0    0    0    0    0    0]
 [   1    0    0    0    0   22    0    0    0    0    0    0    0    2    1    0    0    1    1    8    0    0    0    0    0    0    0]
 [   0    0    0    0    1    0   29    1    0    0    0    0    0    0    0    1    0    0    0    0    0    0    0    0    0    0    0]
 [   4    0    0    0    0    0    0  241    0    0    0    0    0    0    0    0    0    0    0    0    2    0    0    0    0    0    0]
 [   0    0    0    0    0    0    0    0   44    0    0    0    0    0    0    0    0    0    0    0    0    0    0    0    0    0    0]
 [   4    0    0    0    0    0    0    0    0 1687    0    0    0    0    0    0    0    0    0    0    0    0    0    0    0    0    0]
 [   4    0    0    0    0    0    0    0    0    0   52    0    0    0    0    0    0    0    0    0    0    0    0    0    0    0    0]
 [   0    0    0    0    0    0    0    0    0    0    0  312    0    0    0    0    0    0    0    0    0    0    0    0    0    0    0]
 [   0    0    0    0    0    3    0    0    0    0    0    0   13    4    0    0    0    4    0    4    0    0    0    0    0    0    0]
 [   0    0    0    0    0    2    0    0    0    0    0    0    0   12    0    0    0    3    0    1    0    0    0    0    0    0    0]
 [  13    0    0    0    0    0    0    0    0    0    0    0    0    1   63    0    0    3    1    3    0    0    0    0    0    0    0]
 [   2    0    0    0    0    0    0    1    0    0    0    0    0    0    0   21    0    0    0    0    0    0    0    0    0    0    0]
 [   7    0    0    0    0    0    0    1    0    0    0    0    0    0    0    0   96    0    0    0    0    0    0    0    0    0    0]
 [   3    0    0    0    0    3    0    0    0    0    0    0    2    1    0    0    0   40    0   17    0    0    0    0    0    0    0]
 [   4    0    0    0    0    2    0    0    0    0    0    0    1    1    5    0    0    2   20    7    0    0    0    0    0    0    0]
 [   6    0    0    0    0    5    0    1    0    0    0    0    4    3    4    0    0   14    0   55    0    0    0    0    0    0    0]
 [   2    0    0    0    0    0    0    1    0    0    0    0    0    0    0    0    0    0    0    0  266    0    0    0    0    0    1]
 [   1    0    1    0    0    0    0    2    0    0    0    0    0    0    0    0    0    0    0    0    1   52    0    0    0    0    0]
 [   1    0    0    0    0    0    0    0    0    0    0    0    0    0    0    0    0    0    0    0    0    0  537    0    0    0    0]
 [   1    0    0    0    0    0    0    0    0    0    0    0    0    0    0    0    0    0    0    0    0    0    0    8    0    0    0]
 [   3    0    0    0    0    0    0    0    0    0    0    0    0    0    0    0    0    0    0    0    0    0    0    0    6    0    0]
 [   0    0    0    0    2    0    0    0    0    0    0    0    0    0    0    0    0    0    0    0    0    0    0    0    0   12    0]
 [   1    0    1    0    0    0    1    2    0    0    0    0    0    0    0    0    0    0    0    0    0    0    0    0    0    0   41]]

