Classifier: LogisticRegression
Params: {'C': 1.0, 'class_weight': None, 'dual': False, 'fit_intercept': True, 'intercept_scaling': 1, 'max_iter': 100, 'multi_class': 'ovr', 'n_jobs': 1, 'penalty': 'l2', 'random_state': None, 'solver': 'liblinear', 'tol': 0.0001, 'verbose': 0, 'warm_start': False}

Labels: None

Training accuracy: 0.9983094139914368
Training confusion matrix:
[[67162     2     2     1     0     0     0     1     0     1     1     0     0     0     0     0    31     0     0     0     2     1     1     0     0     0     0]
 [    0   792     0     0     0     0     0     0     0     0     0     0     0     0     0     0     0     0     0     0     0     0     0     0     0     0     0]
 [    2     0   471     0     0     0     0     0     0     0     0     0     0     0     0     0     0     0     0     0     0     0     0     0     0     0     0]
 [    2     0     0  1929     0     0     0     0     0     0     0     0     0     0     0     0     0     0     0     0     0     0     0     0     0     0     0]
 [    0     0     0     0   101     0     0     0     0     0     0     0     0     0     0     0     0     0     0     0     0     0     0     0     0     0     0]
 [    0     0     0     0     0   227     0     0     0     0     0     0     0     1     2     0     0     0     2    16     0     0     0     0     0     0     0]
 [    1     0     0     0     0     0    56     0     0     0     0     0     0     0     0     0     0     0     0     0     0     0     0     0     0     0     0]
 [    1     0     0     0     0     0     0   593     0     0     0     0     0     0     0     0     0     0     0     0     2     0     0     0     0     0     0]
 [    0     0     0     0     0     0     0     0   180     0     0     0     0     0     0     0     0     0     0     0     0     0     0     0     0     0     0]
 [    1     0     0     0     0     0     0     0     0 24647     0     0     0     0     0     0     1     0     0     0     0     0     0     0     0     0     0]
 [    1     0     0     0     0     0     0     0     0     0  1859     0     0     0     0     0     0     0     0     0     0     0     0     0     0     0     0]
 [    0     0     0     0     0     0     0     0     0     4     0   785     0     0     0     0     0     0     0     0     0     0     0     0     0     0     0]
 [    0     0     0     0     0     0     0     0     0     0     0     0    93     1     0     0     0     1     1    12     0     0     0     0     0     0     0]
 [    0     0     0     0     0     1     0     0     0     0     0     0     2   190     0     0     0     1     1     0     0     0     0     0     0     0     0]
 [    0     0     0     0     0     2     0     0     0     0     0     0     0     0  1358     0     0     1     4     1     0     0     0     0     0     0     0]
 [    0     0     0     0     0     0     0     0     0     0     0     0     0     0     0    59     0     0     0     0     0     0     0     0     0     0     0]
 [    1     0     0     0     0     0     0     0     0     0     0     0     0     0     0     0  1205     0     0     0     0     0     0     0     0     0     0]
 [    0     0     0     0     0     1     0     0     0     0     0     0     3     0     0     0     0   572     0    17     0     0     0     0     0     0     0]
 [    0     0     0     1     0     0     0     0     0     0     0     0     0     0     4     0     0     0   364     6     0     0     0     0     0     0     0]
 [    0     0     0     0     0     7     0     0     0     0     0     0     3     7     2     0     0    21     1   528     0     0     0     0     0     0     0]
 [    0     0     0     0     0     0     0     0     0     0     0     0     0     0     0     0     0     0     0     0  2550     0     0     0     0     0     0]
 [    0     0     0     0     0     0     0     0     0     0     0     0     0     0     0     0     0     0     0     0     0   471     0     0     0     0     0]
 [    1     0     0     0     0     0     0     0     0     0     0     0     0     0     0     0     0     0     0     0     0     0  1640     0     0     0     0]
 [    0     0     0     0     0     0     0     0     0     0     0     0     0     0     0     0     0     0     0     0     0     0     0   247     0     0     0]
 [    0     0     0     0     0     0     0     0     0     0     0     0     0     0     0     0     0     0     0     0     0     0     0     0   300     0     0]
 [    1     0     0     0     0     0     0     0     0     0     0     0     0     0     0     0     0     0     0     0     0     0     0     0     0    62     0]
 [    1     0     0     0     0     0     0     0     0     0     0     0     0     0     0     0     0     0     0     0     0     0     0     0     0     0   213]]

Accuracy: 0.9972344472110181

Precision: [0.9992 0.9976 0.9971 0.9989 1.0000 0.9650 1.0000 0.9940 1.0000 0.9997 0.9994 1.0000 0.7857 0.9110 0.9868 1.0000 0.9800 0.9345 0.9681 0.8945 0.9969 0.9971 0.9993 1.0000 0.9800 1.0000 1.0000]
Mean: 0.9772154584099619
Std: 0.046563622721924915

Recall: [0.9991 0.9976 0.9942 0.9968 0.9859 0.8953 0.9878 0.9728 0.9946 0.9999 0.9983 0.9935 0.7458 0.9513 0.9926 0.9750 0.9964 0.9408 0.9586 0.9016 0.9991 1.0000 1.0000 0.9956 0.9966 0.9492 0.9907]
Mean: 0.9707050741259544
Std: 0.0524613085793248

F1 score: [0.9992 0.9976 0.9956 0.9979 0.9929 0.9288 0.9939 0.9833 0.9973 0.9998 0.9989 0.9968 0.7652 0.9307 0.9897 0.9873 0.9881 0.9376 0.9633 0.8980 0.9980 0.9985 0.9997 0.9978 0.9882 0.9739 0.9953]
Mean: 0.9738294580416896
Std: 0.04861246061485977

Cohen Kappa score: 0.9954463932254989
Confusion matrix:
[[59920     2     1     2     0     0     0     2     0     6     1     0     0     0     1     0    27     0     0     0     3     0     1     0     5     0     0]
 [    2   842     0     0     0     0     0     0     0     0     0     0     0     0     0     0     0     0     0     0     0     0     0     0     0     0     0]
 [    2     0   340     0     0     0     0     0     0     0     0     0     0     0     0     0     0     0     0     0     0     0     0     0     0     0     0]
 [    6     0     0  1898     0     0     0     0     0     0     0     0     0     0     0     0     0     0     0     0     0     0     0     0     0     0     0]
 [    1     0     0     0    70     0     0     0     0     0     0     0     0     0     0     0     0     0     0     0     0     0     0     0     0     0     0]
 [    0     0     0     0     0   248     0     0     0     0     0     0     5     6     1     0     0     2     4    11     0     0     0     0     0     0     0]
 [    1     0     0     0     0     0    81     0     0     0     0     0     0     0     0     0     0     0     0     0     0     0     0     0     0     0     0]
 [    9     0     0     0     0     0     0   500     0     0     0     0     0     0     0     0     0     0     0     0     4     1     0     0     0     0     0]
 [    1     0     0     0     0     0     0     0   183     0     0     0     0     0     0     0     0     0     0     0     0     0     0     0     0     0     0]
 [    2     0     0     0     0     0     0     0     0 32143     0     0     0     0     0     0     1     0     0     1     0     0     0     0     0     0     0]
 [    3     0     0     0     0     0     0     0     0     0  1771     0     0     0     0     0     0     0     0     0     0     0     0     0     0     0     0]
 [    2     0     0     0     0     0     0     0     0     5     0  1076     0     0     0     0     0     0     0     0     0     0     0     0     0     0     0]
 [    0     0     0     0     0     3     0     0     0     0     0     0    88     0     0     0     0     1     0    26     0     0     0     0     0     0     0]
 [    0     0     0     0     0     1     0     0     0     0     0     0     4   215     1     0     0     3     1     1     0     0     0     0     0     0     0]
 [    1     0     0     0     0     0     0     0     0     0     0     0     1     0  1348     0     0     1     4     3     0     0     0     0     0     0     0]
 [    1     0     0     0     0     0     0     0     0     0     0     0     0     0     0    39     0     0     0     0     0     0     0     0     0     0     0]
 [    4     0     0     0     0     0     0     0     0     0     0     0     0     0     0     0  1370     0     0     0     0     0     0     0     1     0     0]
 [    0     0     0     0     0     1     0     0     0     0     0     0     8     2     0     0     0   556     3    21     0     0     0     0     0     0     0]
 [    1     0     0     0     0     0     0     0     0     0     0     0     0     0    12     0     0     0   394     4     0     0     0     0     0     0     0]
 [    3     0     0     0     0     4     0     0     0     0     0     0     6    13     3     0     0    32     1   568     0     0     0     0     0     0     0]
 [    1     0     0     0     0     0     0     1     0     0     0     0     0     0     0     0     0     0     0     0  2257     0     0     0     0     0     0]
 [    0     0     0     0     0     0     0     0     0     0     0     0     0     0     0     0     0     0     0     0     0   341     0     0     0     0     0]
 [    0     0     0     0     0     0     0     0     0     0     0     0     0     0     0     0     0     0     0     0     0     0  1504     0     0     0     0]
 [    1     0     0     0     0     0     0     0     0     0     0     0     0     0     0     0     0     0     0     0     0     0     0   224     0     0     0]
 [    1     0     0     0     0     0     0     0     0     0     0     0     0     0     0     0     0     0     0     0     0     0     0     0   294     0     0]
 [    3     0     0     0     0     0     0     0     0     0     0     0     0     0     0     0     0     0     0     0     0     0     0     0     0    56     0]
 [    2     0     0     0     0     0     0     0     0     0     0     0     0     0     0     0     0     0     0     0     0     0     0     0     0     0   212]]

