Classifier: MultinomialNB
Params: {'alpha': 1.0, 'class_prior': None, 'fit_prior': True}

Labels: None

Training accuracy: 0.8178117936750032
Training confusion matrix:
[[55768   565    10  1397     4     0     0   503     1    86  2607    24     0     0   890     1  3071   392    25    40     7    10     4    92  1611     0    97]
 [    2   790     0     0     0     0     0     0     0     0     0     0     0     0     0     0     0     0     0     0     0     0     0     0     0     0     0]
 [    0     0   465     0     1     0     0     7     0     0     0     0     0     0     0     0     0     0     0     0     0     0     0     0     0     0     0]
 [    6     0     0  1903     0     0     0     0     0     0     0     0     0     0     0     0    22     0     0     0     0     0     0     0     0     0     0]
 [    0     0    10     0    89     0     0     0     0     0     0     0     0     0     0     0     0     0     0     0     0     0     2     0     0     0     0]
 [    1     0     0     0     0    94     0     0     0     0     0     0     0     0    39     0     0    68     0    46     0     0     0     0     0     0     0]
 [    0     0     0     0     0     0    55     0     1     0     0     0     0     0     0     0     0     0     0     0     0     0     1     0     0     0     0]
 [    0     0     8     0     3     0     0   581     0     0     0     0     0     0     0     0     0     0     0     0     3     0     1     0     0     0     0]
 [    0     0     1     0     0     0     1     0   177     0     0     0     0     0     0     0     0     0     0     0     0     0     1     0     0     0     0]
 [ 6170     0     0     0     1     0     0     1     0 17924     0   529     0     0    14     0     1     0     1     0     0     0     8     0     0     0     0]
 [   11     0     0     0     0     0     0     0     0     0  1849     0     0     0     0     0     0     0     0     0     0     0     0     0     0     0     0]
 [  235     0     0     0     0     0     0     0     0     0     0   554     0     0     0     0     0     0     0     0     0     0     0     0     0     0     0]
 [    0     0     0     0     0     0     0     0     0     0     0     0     0     0    21     0     0    25     0    62     0     0     0     0     0     0     0]
 [    1     0     0     0     0     0     0     0     0     0     0     0     0    93    32     0     0    31     0    38     0     0     0     0     0     0     0]
 [    0     0     0     0     0     1     0     1     0     0     0     0     0     0  1228     0     0   122     1    10     0     0     3     0     0     0     0]
 [    0     0     3     0     0     0     0     0     0     0     0     0     0     0     0    42     0     0     0     0     0     0    14     0     0     0     0]
 [   76     0     1     0     0     0     0     0     0     0     0     0     0     0     0     0  1129     0     0     0     0     0     0     0     0     0     0]
 [   62     0     0     0     0     0     0     0     0     0     0     0     0     0    84     0     0   392     0    55     0     0     0     0     0     0     0]
 [    2     0     0     0     0     0     0     0     0     0     0     0     0     0   170     0     0   120    65    18     0     0     0     0     0     0     0]
 [    6     0     0     0     0     0     0     0     0     0    12     0     0     0     4     0     0    56     0   488     0     0     3     0     0     0     0]
 [    1     0     0     0     0     0     0    17     0     0     0     0     0     0     0     0     0     0     0     0  2530     0     2     0     0     0     0]
 [    1     0     0     0     0     0     0    12     0     0     0     0     0     0     0     0     0     0     0     0     0   456     2     0     0     0     0]
 [    0     0     5     0     1     0     0     0     3     0     0     0     0     0     0     1     0     0     0     0     0     0  1631     0     0     0     0]
 [    0     0     0     0     0     0     0     0     0     0    12     0     0     0     0     0     0     0     0     0     0     0     0   235     0     0     0]
 [    1     0     0    88     0     0     0     0     0     0     0     0     0     0     0     0     3     0     0     0     0     0     0     0   208     0     0]
 [    0     0     4     0     1     0     0     2     0     0     0     0     0     0     0     0     0     0     0     0     2     0     1     0     0    53     0]
 [    1     0     2     0     0     0     0     1     0     0     0     0     0     0     0     0     0     0     0     0     0     0     0     0     0     0   210]]

Accuracy: 0.8085337057488584

Precision: [0.8530 0.6330 0.9233 0.5625 0.8333 1.0000 0.9759 0.5878 0.9892 0.9976 0.4772 0.6602 0.0000 1.0000 0.4687 1.0000 0.3004 0.3313 0.5932 0.6458 0.9964 0.9940 0.9758 0.6667 0.0889 1.0000 0.5838]
Mean: 0.7088158534411076
Std: 0.29036819111589673

Recall: [0.8272 0.9953 0.9854 0.9905 0.7746 0.2347 0.9878 0.9767 0.9946 0.7333 0.9972 0.7175 0.0000 0.2389 0.9138 0.9000 0.9753 0.6379 0.0852 0.8683 0.9894 0.9765 0.9940 0.9511 0.5390 0.7627 0.9766]
Mean: 0.7786465455564802
Std: 0.2950572115455925

F1 score: [0.8399 0.7738 0.9533 0.7175 0.8029 0.3801 0.9818 0.7339 0.9919 0.8453 0.6455 0.6876 0.0000 0.3857 0.6196 0.9474 0.4593 0.4361 0.1489 0.7407 0.9929 0.9852 0.9848 0.7839 0.1526 0.8654 0.7308]
Mean: 0.6884049712418888
Std: 0.27631093850848243

Cohen Kappa score: 0.7001234312871821
Confusion matrix:
[[49609   487     5  1342     2     0     0   309     0    57  1917    20     0     0   876     0  3098   280    22    55     5     2     2   106  1629     0   148]
 [    4   840     0     0     0     0     0     0     0     0     0     0     0     0     0     0     0     0     0     0     0     0     0     0     0     0     0]
 [    0     0   337     0     0     0     0     5     0     0     0     0     0     0     0     0     0     0     0     0     0     0     0     0     0     0     0]
 [    5     0     0  1886     0     0     0     0     0     0     0     0     0     0     0     0    13     0     0     0     0     0     0     0     0     0     0]
 [    0     0    12     0    55     0     2     1     0     0     0     0     0     0     0     0     0     0     0     0     0     0     1     0     0     0     0]
 [    1     0     0     0     0    65     0     0     0     0     0     0     0     0    63     0     0   111     0    37     0     0     0     0     0     0     0]
 [    0     0     0     0     0     0    81     1     0     0     0     0     0     0     0     0     0     0     0     0     0     0     0     0     0     0     0]
 [    1     0     3     0     3     0     0   502     0     0     0     0     0     0     0     0     0     0     0     0     3     0     2     0     0     0     0]
 [    0     0     0     0     0     0     0     0   183     0     0     0     0     0     0     0     0     0     0     0     0     0     1     0     0     0     0]
 [ 8156     0     0     0     0     0     0     0     0 23575     0   380     0     0    15     0     1     0     0     0     0     0    19     1     0     0     0]
 [    5     0     0     0     0     0     0     0     0     0  1769     0     0     0     0     0     0     0     0     0     0     0     0     0     0     0     0]
 [  306     0     0     0     0     0     0     0     0     0     0   777     0     0     0     0     0     0     0     0     0     0     0     0     0     0     0]
 [    0     0     0     0     0     0     0     0     0     0     0     0     0     0    21     0     0    35     0    62     0     0     0     0     0     0     0]
 [    0     0     0     0     0     0     0     0     0     0     0     0     0    54    58     0     0    49     0    65     0     0     0     0     0     0     0]
 [    2     0     0     0     0     0     0     0     0     0     0     0     0     0  1241     0     0   105     2     7     0     0     1     0     0     0     0]
 [    0     0     0     0     1     0     0     0     0     0     0     0     0     0     0    36     0     0     0     0     0     0     2     0     0     0     1]
 [   33     0     0     0     0     0     0     0     0     0     0     0     0     0     0     0  1341     0     0     0     0     0     0     0     1     0     0]
 [   31     0     0     0     0     0     0     0     0     0     0     0     0     0   123     0     0   377     0    60     0     0     0     0     0     0     0]
 [    2     0     0     0     0     0     0     0     0     0     0     0     0     0   247     0     0   113    35    14     0     0     0     0     0     0     0]
 [    1     0     0     0     0     0     0     0     0     0    10     0     0     0     4     0     0    68     0   547     0     0     0     0     0     0     0]
 [    0     0     0     0     0     0     0    21     0     0     0     0     0     0     0     0     0     0     0     0  2235     0     3     0     0     0     0]
 [    0     0     0     0     0     0     0     6     0     0     0     0     0     0     0     0     0     0     0     0     0   333     2     0     0     0     0]
 [    0     0     3     0     3     0     0     1     2     0     0     0     0     0     0     0     0     0     0     0     0     0  1495     0     0     0     0]
 [    0     0     0     0     0     0     0     0     0     0    11     0     0     0     0     0     0     0     0     0     0     0     0   214     0     0     0]
 [    0     0     0   125     0     0     0     0     0     0     0     0     0     0     0     0    11     0     0     0     0     0     0     0   159     0     0]
 [    0     0     4     0     2     0     0     4     0     0     0     0     0     0     0     0     0     0     0     0     0     0     4     0     0    45     0]
 [    0     0     1     0     0     0     0     4     0     0     0     0     0     0     0     0     0     0     0     0     0     0     0     0     0     0   209]]

