Classifier: RandomForestClassifier
Params: {'bootstrap': True, 'class_weight': None, 'criterion': 'gini', 'max_depth': None, 'max_features': 'auto', 'max_leaf_nodes': None, 'min_impurity_decrease': 0.0, 'min_impurity_split': None, 'min_samples_leaf': 1, 'min_samples_split': 2, 'min_weight_fraction_leaf': 0.0, 'n_estimators': 100, 'n_jobs': 1, 'oob_score': False, 'random_state': None, 'verbose': 0, 'warm_start': False}

Labels: None

Training accuracy: 0.9991638949631563
Training confusion matrix:
[[67175     0     0     0     0     0     0     0     0     0     0     0     0     0     0     0    30     0     0     0     0     0     0     0     0     0     0]
 [    0   792     0     0     0     0     0     0     0     0     0     0     0     0     0     0     0     0     0     0     0     0     0     0     0     0     0]
 [    0     0   473     0     0     0     0     0     0     0     0     0     0     0     0     0     0     0     0     0     0     0     0     0     0     0     0]
 [    1     0     0  1930     0     0     0     0     0     0     0     0     0     0     0     0     0     0     0     0     0     0     0     0     0     0     0]
 [    0     0     0     0   101     0     0     0     0     0     0     0     0     0     0     0     0     0     0     0     0     0     0     0     0     0     0]
 [    0     0     0     0     0   244     0     0     0     0     0     0     0     0     1     0     0     0     0     3     0     0     0     0     0     0     0]
 [    0     0     0     0     0     0    57     0     0     0     0     0     0     0     0     0     0     0     0     0     0     0     0     0     0     0     0]
 [    0     0     0     0     0     0     0   596     0     0     0     0     0     0     0     0     0     0     0     0     0     0     0     0     0     0     0]
 [    0     0     0     0     0     0     0     0   180     0     0     0     0     0     0     0     0     0     0     0     0     0     0     0     0     0     0]
 [    0     0     0     0     0     0     0     0     0 24649     0     0     0     0     0     0     0     0     0     0     0     0     0     0     0     0     0]
 [    0     0     0     0     0     0     0     0     0     0  1860     0     0     0     0     0     0     0     0     0     0     0     0     0     0     0     0]
 [    0     0     0     0     0     0     0     0     0     0     0   789     0     0     0     0     0     0     0     0     0     0     0     0     0     0     0]
 [    0     0     0     0     0     0     0     0     0     0     0     0    99     0     0     0     0     0     0     9     0     0     0     0     0     0     0]
 [    0     0     0     0     0     0     0     0     0     0     0     0     0   193     0     0     0     1     1     0     0     0     0     0     0     0     0]
 [    0     0     0     0     0     0     0     0     0     0     0     0     0     0  1364     0     0     1     1     0     0     0     0     0     0     0     0]
 [    0     0     0     0     0     0     0     0     0     0     0     0     0     0     0    59     0     0     0     0     0     0     0     0     0     0     0]
 [    0     0     0     0     0     0     0     0     0     0     0     0     0     0     0     0  1206     0     0     0     0     0     0     0     0     0     0]
 [    0     0     0     0     0     0     0     0     0     0     0     0     0     0     0     0     0   580     0    13     0     0     0     0     0     0     0]
 [    0     0     0     0     0     0     0     0     0     0     0     0     0     0     4     0     0     0   370     1     0     0     0     0     0     0     0]
 [    0     0     0     0     0     4     0     0     0     0     0     0     0     6     1     0     0    13     1   544     0     0     0     0     0     0     0]
 [    0     0     0     0     0     0     0     0     0     0     0     0     0     0     0     0     0     0     0     0  2550     0     0     0     0     0     0]
 [    0     0     0     0     0     0     0     0     0     0     0     0     0     0     0     0     0     0     0     0     0   471     0     0     0     0     0]
 [    0     0     0     0     0     0     0     0     0     0     0     0     0     0     0     0     0     0     0     0     0     0  1641     0     0     0     0]
 [    0     0     0     0     0     0     0     0     0     0     0     0     0     0     0     0     0     0     0     0     0     0     0   247     0     0     0]
 [    0     0     0     0     0     0     0     0     0     0     0     0     0     0     0     0     0     0     0     0     0     0     0     0   300     0     0]
 [    0     0     0     0     0     0     0     0     0     0     0     0     0     0     0     0     0     0     0     0     0     0     0     0     0    63     0]
 [    0     0     0     0     0     0     0     0     0     0     0     0     0     0     0     0     0     0     0     0     0     0     0     0     0     0   214]]

Accuracy: 0.9970323137845809

Precision: [0.9990 0.9988 0.9912 0.9995 0.8072 0.9549 0.9634 0.9882 1.0000 0.9999 1.0000 1.0000 0.8155 0.9425 0.9846 1.0000 0.9827 0.9237 0.9603 0.8892 0.9978 0.9942 0.9993 1.0000 0.9966 1.0000 1.0000]
Mean: 0.9699473702903795
Std: 0.05233681560042993

Recall: [0.9993 0.9976 0.9883 0.9942 0.9437 0.9170 0.9634 0.9767 1.0000 0.9999 0.9972 0.9982 0.7119 0.9425 0.9875 0.9750 0.9927 0.9425 0.9416 0.9048 0.9991 0.9971 0.9967 0.9911 0.9966 0.9322 0.9720]
Mean: 0.9651319853361983
Std: 0.05701274862706968

F1 score: [0.9992 0.9982 0.9898 0.9968 0.8701 0.9355 0.9634 0.9824 1.0000 0.9999 0.9986 0.9991 0.7602 0.9425 0.9860 0.9873 0.9877 0.9330 0.9509 0.8969 0.9985 0.9956 0.9980 0.9955 0.9966 0.9649 0.9858]
Mean: 0.9671279787452024
Std: 0.052338674021540646

Cohen Kappa score: 0.9951128110131676
Confusion matrix:
[[59931     1     1     1     0     0     0     0     0     3     0     0     0     0     1     0    23     3     1     4     0     1     1     0     0     0     0]
 [    2   842     0     0     0     0     0     0     0     0     0     0     0     0     0     0     0     0     0     0     0     0     0     0     0     0     0]
 [    1     0   338     0     2     0     0     0     0     0     0     0     0     0     0     0     0     0     0     0     1     0     0     0     0     0     0]
 [   10     0     0  1893     0     0     0     0     0     0     0     0     0     0     0     0     1     0     0     0     0     0     0     0     0     0     0]
 [    1     0     0     0    67     0     1     2     0     0     0     0     0     0     0     0     0     0     0     0     0     0     0     0     0     0     0]
 [    2     0     0     0     0   254     0     0     0     0     0     0     0     4     2     0     0     5     2     8     0     0     0     0     0     0     0]
 [    0     0     0     0     3     0    79     0     0     0     0     0     0     0     0     0     0     0     0     0     0     0     0     0     0     0     0]
 [    3     0     0     0     5     0     0   502     0     0     0     0     0     0     0     0     0     0     0     0     3     1     0     0     0     0     0]
 [    0     0     0     0     0     0     0     0   184     0     0     0     0     0     0     0     0     0     0     0     0     0     0     0     0     0     0]
 [    3     0     0     0     0     0     0     0     0 32144     0     0     0     0     0     0     0     0     0     0     0     0     0     0     0     0     0]
 [    5     0     0     0     0     0     0     0     0     0  1769     0     0     0     0     0     0     0     0     0     0     0     0     0     0     0     0]
 [    2     0     0     0     0     0     0     0     0     0     0  1081     0     0     0     0     0     0     0     0     0     0     0     0     0     0     0]
 [    0     0     0     0     0     3     0     0     0     0     0     0    84     1     0     0     0     3     0    27     0     0     0     0     0     0     0]
 [    0     0     0     0     0     1     0     0     0     0     0     0     4   213     1     0     0     3     1     3     0     0     0     0     0     0     0]
 [    3     0     0     0     0     0     0     0     0     0     0     0     1     0  1341     0     0     1     6     6     0     0     0     0     0     0     0]
 [    1     0     0     0     0     0     0     0     0     0     0     0     0     0     0    39     0     0     0     0     0     0     0     0     0     0     0]
 [    9     0     0     0     0     0     0     0     0     0     0     0     0     0     0     0  1365     0     0     0     0     0     0     0     1     0     0]
 [    1     0     0     0     0     0     0     0     0     0     0     0     7     0     1     0     0   557     5    20     0     0     0     0     0     0     0]
 [    4     0     0     0     0     4     0     0     0     0     0     0     0     0    12     0     0     1   387     3     0     0     0     0     0     0     0]
 [    6     0     0     0     0     4     0     0     0     0     0     0     7     8     4     0     0    30     1   570     0     0     0     0     0     0     0]
 [    1     0     0     0     0     0     0     1     0     0     0     0     0     0     0     0     0     0     0     0  2257     0     0     0     0     0     0]
 [    0     0     0     0     0     0     0     1     0     0     0     0     0     0     0     0     0     0     0     0     0   340     0     0     0     0     0]
 [    0     0     0     0     3     0     1     1     0     0     0     0     0     0     0     0     0     0     0     0     0     0  1499     0     0     0     0]
 [    2     0     0     0     0     0     0     0     0     0     0     0     0     0     0     0     0     0     0     0     0     0     0   223     0     0     0]
 [    1     0     0     0     0     0     0     0     0     0     0     0     0     0     0     0     0     0     0     0     0     0     0     0   294     0     0]
 [    0     0     0     0     2     0     1     1     0     0     0     0     0     0     0     0     0     0     0     0     0     0     0     0     0    55     0]
 [    2     0     2     0     1     0     0     0     0     0     0     0     0     0     0     0     0     0     0     0     1     0     0     0     0     0   208]]

