Classifier: GradientBoostingClassifier
Params: {'criterion': 'friedman_mse', 'init': None, 'learning_rate': 0.1, 'loss': 'deviance', 'max_depth': 3, 'max_features': None, 'max_leaf_nodes': None, 'min_impurity_decrease': 0.0, 'min_impurity_split': None, 'min_samples_leaf': 1, 'min_samples_split': 2, 'min_weight_fraction_leaf': 0.0, 'n_estimators': 100, 'presort': 'auto', 'random_state': None, 'subsample': 1.0, 'verbose': 0, 'warm_start': False}

Labels: None

Training accuracy: 0.990747980192859
Training confusion matrix:
[[14655     0     0     3     1     0     0     0     0     1     0     0     0     0     0     0     2     0     0     0     0     0     0     0     0     0     0]
 [    0   234     0     0     0     0     0     0     0     0     0     0     0     0     0     0     0     0     0     0     0     0     0     0     0     0     0]
 [    0     0   297     0     0     0     0     0     0     0     0     0     0     0     0     0     0     0     0     0     0     0     0     0     0     0     0]
 [    1     0     0   195     0     0     0     0     0     0     0     0     0     0     0     0     0     0     0     0     0     0     0     0     0     0     0]
 [    0     0     0     0   205     0     0     0     0     0     0     0     0     0     0     0     0     0     0     0     0     0     0     0     0     0     0]
 [    0     0     0     0     0   129     0     0     0     0     0     0     5     2     1     0     0     1     0    13     0     0     0     0     0     0     0]
 [    0     0     0     0     0     0   116     0     0     0     0     0     0     0     0     0     0     0     0     0     0     0     0     0     0     0     0]
 [    3     0     0     0     0     0     0  1025     0     0     0     0     0     0     0     0     0     0     0     0     1     0     0     0     0     0     0]
 [    0     0     0     0     0     0     0     0   181     0     0     0     0     0     0     0     0     0     0     0     0     0     0     0     0     0     0]
 [   69     0     0     0     0     0     0     0     0  6729     0     0     0     0     0     0     0     0     0     0     0     0     0     0     0     0     0]
 [    0     0     0     0     0     0     0     0     0     0   222     0     0     0     0     0     0     0     0     0     0     0     0     0     0     0     0]
 [    0     0     0     0     0     0     0     0     0     0     0  1176     0     0     0     0     0     0     0     0     0     0     0     0     0     0     0]
 [    0     0     0     0     0     1     0     0     0     0     0     0    73     4     0     0     0     4     0    17     0     0     0     0     0     0     0]
 [    0     0     0     0     0     1     0     0     0     0     0     0     2    82     0     0     0     2     0     2     0     0     0     0     0     0     0]
 [    1     0     0     0     0     2     0     0     0     0     0     0     2     1   310     0     0     0     5     4     0     0     0     0     0     0     0]
 [    0     0     0     0     0     0     0     0     0     0     0     0     0     0     0    57     0     0     0     0     0     0     0     0     0     0     0]
 [    2     0     0     0     0     0     0     0     0     0     0     0     0     0     0     0   413     0     0     0     0     0     0     0     0     0     0]
 [    9     0     0     0     0     2     0     0     0     0     0     0     7     5     0     0     0   234     1    20     0     0     0     0     0     0     0]
 [    0     0     0     0     0     2     0     0     0     0     0     0     0     2    14     0     0     1   104     8     0     0     0     0     0     0     0]
 [    1     0     0     0     0     5     0     0     0     0     0     0    12     8     1     0     0    28     2   326     0     0     0     0     0     0     0]
 [    2     0     0     0     0     0     0     0     0     0     0     0     0     0     0     0     0     0     0     0   995     0     0     0     0     0     0]
 [    0     0     0     0     0     0     0     0     0     0     0     0     0     0     0     0     0     0     0     0     0   222     0     0     0     0     0]
 [    0     0     0     0     0     0     0     0     1     0     0     0     0     0     0     0     0     0     0     0     0     0  2123     0     0     0     0]
 [    0     0     0     0     0     0     0     0     0     0     0     0     0     0     0     0     0     0     0     0     0     0     0    32     0     0     0]
 [    0     0     0     0     0     0     0     0     0     0     0     0     0     0     0     0     0     0     0     0     0     0     0     0    32     0     0]
 [    0     0     0     0     0     0     0     0     0     0     0     0     0     0     0     0     0     0     0     0     0     0     0     0     0    62     0]
 [    0     0     0     0     0     0     0     0     0     0     0     0     0     0     0     0     0     0     0     0     0     0     0     0     0     0   183]]

Accuracy: 0.9762835548605682

Precision: [0.9855 1.0000 0.9649 0.9149 0.9792 0.6579 1.0000 0.9862 1.0000 0.9988 0.9787 0.9901 0.7308 0.5385 0.8784 1.0000 0.9697 0.7500 0.8500 0.5833 0.9802 0.9216 1.0000 1.0000 0.8571 1.0000 1.0000]
Mean: 0.9079959863286036
Std: 0.134042804049805

Recall: [0.9940 1.0000 0.8730 0.8958 1.0000 0.6098 1.0000 0.9954 0.9535 0.9846 0.9787 1.0000 0.5278 0.7368 0.8904 1.0000 0.9796 0.8108 0.6296 0.5904 0.9880 0.9792 1.0000 0.8462 1.0000 1.0000 0.9184]
Mean: 0.8956294617632927
Std: 0.14458258081893754

F1 score: [0.9898 1.0000 0.9167 0.9053 0.9895 0.6329 1.0000 0.9908 0.9762 0.9917 0.9787 0.9950 0.6129 0.6222 0.8844 1.0000 0.9746 0.7792 0.7234 0.5868 0.9841 0.9495 1.0000 0.9167 0.9231 1.0000 0.9574]
Mean: 0.8992904236614483
Std: 0.1358453578865623

Cohen Kappa score: 0.9664100808141419
Confusion matrix:
[[3670    0    1    4    1    0    0    2    0    2    1    2    0    0    1    0    3    2    0    0    0    2    0    0    1    0    0]
 [   0   64    0    0    0    0    0    0    0    0    0    0    0    0    0    0    0    0    0    0    0    0    0    0    0    0    0]
 [   3    0   55    0    0    0    0    1    0    0    0    0    0    0    0    0    0    0    0    0    2    2    0    0    0    0    0]
 [   5    0    0   43    0    0    0    0    0    0    0    0    0    0    0    0    0    0    0    0    0    0    0    0    0    0    0]
 [   0    0    0    0   47    0    0    0    0    0    0    0    0    0    0    0    0    0    0    0    0    0    0    0    0    0    0]
 [   1    0    0    0    0   25    0    0    0    0    0    0    1    1    1    0    0    1    1   10    0    0    0    0    0    0    0]
 [   0    0    0    0    0    0   35    0    0    0    0    0    0    0    0    0    0    0    0    0    0    0    0    0    0    0    0]
 [   0    0    0    0    0    0    0  215    0    0    0    0    0    0    0    0    0    0    0    0    1    0    0    0    0    0    0]
 [   2    0    0    0    0    0    0    0   41    0    0    0    0    0    0    0    0    0    0    0    0    0    0    0    0    0    0]
 [  27    0    0    0    0    0    0    0    0 1727    0    0    0    0    0    0    0    0    0    0    0    0    0    0    0    0    0]
 [   0    0    0    0    0    0    0    0    0    0   46    1    0    0    0    0    0    0    0    0    0    0    0    0    0    0    0]
 [   0    0    0    0    0    0    0    0    0    0    0  301    0    0    0    0    0    0    0    0    0    0    0    0    0    0    0]
 [   0    0    0    0    0    3    0    0    0    0    0    0   19    5    0    0    0    1    1    7    0    0    0    0    0    0    0]
 [   0    0    0    0    0    0    0    0    0    0    0    0    0   14    1    0    0    1    0    3    0    0    0    0    0    0    0]
 [   2    0    0    0    0    0    0    0    0    0    0    0    0    0   65    0    0    1    0    5    0    0    0    0    0    0    0]
 [   0    0    0    0    0    0    0    0    0    0    0    0    0    0    0   11    0    0    0    0    0    0    0    0    0    0    0]
 [   2    0    0    0    0    0    0    0    0    0    0    0    0    0    0    0   96    0    0    0    0    0    0    0    0    0    0]
 [   1    0    0    0    0    1    0    0    0    0    0    0    2    2    1    0    0   60    0    7    0    0    0    0    0    0    0]
 [   0    0    0    0    0    2    0    0    0    0    0    0    1    0    3    0    0    1   17    3    0    0    0    0    0    0    0]
 [   4    0    0    0    0    7    0    0    0    0    0    0    3    4    2    0    0   13    1   49    0    0    0    0    0    0    0]
 [   2    0    1    0    0    0    0    0    0    0    0    0    0    0    0    0    0    0    0    0  248    0    0    0    0    0    0]
 [   0    0    0    0    0    0    0    0    0    0    0    0    0    0    0    0    0    0    0    0    1   47    0    0    0    0    0]
 [   0    0    0    0    0    0    0    0    0    0    0    0    0    0    0    0    0    0    0    0    0    0  522    0    0    0    0]
 [   2    0    0    0    0    0    0    0    0    0    0    0    0    0    0    0    0    0    0    0    0    0    0   11    0    0    0]
 [   0    0    0    0    0    0    0    0    0    0    0    0    0    0    0    0    0    0    0    0    0    0    0    0    6    0    0]
 [   0    0    0    0    0    0    0    0    0    0    0    0    0    0    0    0    0    0    0    0    0    0    0    0    0   13    0]
 [   3    0    0    0    0    0    0    0    0    0    0    0    0    0    0    0    0    0    0    0    1    0    0    0    0    0   45]]

