Classifier: LinearSVC
Params: {'C': 1.0, 'class_weight': None, 'dual': True, 'fit_intercept': True, 'intercept_scaling': 1, 'loss': 'squared_hinge', 'max_iter': 1000, 'multi_class': 'ovr', 'penalty': 'l2', 'random_state': None, 'tol': 0.0001, 'verbose': 0}

Labels: None

Training accuracy: 0.9880766223612197
Training confusion matrix:
[[14657     0     0     2     1     0     0     0     0     1     0     0     0     0     0     0     1     0     0     0     0     0     0     0     0     0     0]
 [    0   234     0     0     0     0     0     0     0     0     0     0     0     0     0     0     0     0     0     0     0     0     0     0     0     0     0]
 [    0     0   297     0     0     0     0     0     0     0     0     0     0     0     0     0     0     0     0     0     0     0     0     0     0     0     0]
 [    2     0     0   194     0     0     0     0     0     0     0     0     0     0     0     0     0     0     0     0     0     0     0     0     0     0     0]
 [    0     0     0     0   205     0     0     0     0     0     0     0     0     0     0     0     0     0     0     0     0     0     0     0     0     0     0]
 [    0     0     0     0     0   105     0     0     0     0     0     0     7     2     4     0     0     4     4    25     0     0     0     0     0     0     0]
 [    0     0     0     0     0     0   116     0     0     0     0     0     0     0     0     0     0     0     0     0     0     0     0     0     0     0     0]
 [    0     0     0     0     0     0     0  1029     0     0     0     0     0     0     0     0     0     0     0     0     0     0     0     0     0     0     0]
 [    0     0     0     0     0     0     0     0   181     0     0     0     0     0     0     0     0     0     0     0     0     0     0     0     0     0     0]
 [   66     0     0     0     0     0     0     0     0  6732     0     0     0     0     0     0     0     0     0     0     0     0     0     0     0     0     0]
 [    0     0     0     0     0     0     0     0     0     0   222     0     0     0     0     0     0     0     0     0     0     0     0     0     0     0     0]
 [    0     0     0     0     0     0     0     0     0     0     0  1176     0     0     0     0     0     0     0     0     0     0     0     0     0     0     0]
 [    0     0     0     0     0     2     0     0     0     0     0     0    71     3     0     0     0     3     0    20     0     0     0     0     0     0     0]
 [    0     0     0     0     0     4     0     0     0     0     0     0     1    71     1     0     0     2     1     9     0     0     0     0     0     0     0]
 [    1     0     0     0     0     0     0     0     0     0     0     0     2     1   316     0     0     0     0     5     0     0     0     0     0     0     0]
 [    0     0     0     0     0     0     0     0     0     0     0     0     0     0     0    57     0     0     0     0     0     0     0     0     0     0     0]
 [    3     0     0     0     0     0     0     0     0     0     0     0     0     0     0     0   412     0     0     0     0     0     0     0     0     0     0]
 [    8     0     0     0     0    12     0     0     0     0     0     0    12     8     0     0     0   213     2    23     0     0     0     0     0     0     0]
 [    0     0     0     0     0     0     0     0     0     0     0     0     1     1    20     0     0     1   100     8     0     0     0     0     0     0     0]
 [    1     0     0     0     0     9     0     0     0     0     0     0    19     8     3     0     0    46     3   294     0     0     0     0     0     0     0]
 [    2     0     0     0     0     0     0     1     0     0     0     0     0     0     0     0     0     0     0     0   994     0     0     0     0     0     0]
 [    0     0     0     0     0     0     0     0     0     0     0     0     0     0     0     0     0     0     0     0     0   222     0     0     0     0     0]
 [    0     0     0     0     0     0     0     0     1     0     0     0     0     0     0     0     0     0     0     0     0     0  2123     0     0     0     0]
 [    0     0     0     0     0     0     0     0     0     0     0     0     0     0     0     0     0     0     0     0     0     0     0    32     0     0     0]
 [    0     0     0     0     0     0     0     0     0     0     0     0     0     0     0     0     0     0     0     0     0     0     0     0    32     0     0]
 [    0     0     0     0     0     0     0     0     0     0     0     0     0     0     0     0     0     0     0     0     0     0     0     0     0    62     0]
 [    0     0     0     0     0     0     0     0     0     0     0     0     0     0     0     0     0     0     0     0     0     0     0     0     0     0   183]]

Accuracy: 0.9770654156893406

Precision: [0.9874 1.0000 0.9355 0.9149 0.9792 0.6897 1.0000 0.9817 1.0000 0.9994 0.9792 0.9967 0.6786 0.6000 0.8718 1.0000 0.9697 0.7397 0.9048 0.5638 0.9764 0.9592 1.0000 1.0000 0.8333 1.0000 0.9778]
Mean: 0.9088353153753551
Std: 0.13093988643741672

Recall: [0.9954 1.0000 0.9206 0.8958 1.0000 0.4878 1.0000 0.9907 0.9767 0.9846 1.0000 1.0000 0.5278 0.7895 0.9315 0.9091 0.9796 0.7297 0.7037 0.6386 0.9880 0.9792 1.0000 0.9231 0.8333 1.0000 0.8980]
Mean: 0.8919545461046391
Std: 0.14682278010624875

F1 score: [0.9914 1.0000 0.9280 0.9053 0.9895 0.5714 1.0000 0.9862 0.9882 0.9920 0.9895 0.9983 0.5937 0.6818 0.9007 0.9524 0.9746 0.7347 0.7917 0.5989 0.9822 0.9691 1.0000 0.9600 0.8333 1.0000 0.9362]
Mean: 0.8981086171953883
Std: 0.13699088172265175

Cohen Kappa score: 0.9675243678328737
Confusion matrix:
[[3675    0    1    3    1    0    0    2    0    1    1    1    0    0    1    0    3    0    0    0    0    2    0    0    1    0    0]
 [   0   64    0    0    0    0    0    0    0    0    0    0    0    0    0    0    0    0    0    0    0    0    0    0    0    0    0]
 [   1    0   58    0    0    0    0    1    0    0    0    0    0    0    0    0    0    0    0    0    2    0    0    0    0    0    1]
 [   5    0    0   43    0    0    0    0    0    0    0    0    0    0    0    0    0    0    0    0    0    0    0    0    0    0    0]
 [   0    0    0    0   47    0    0    0    0    0    0    0    0    0    0    0    0    0    0    0    0    0    0    0    0    0    0]
 [   1    0    0    0    0   20    0    0    0    0    0    0    2    0    2    0    0    1    1   14    0    0    0    0    0    0    0]
 [   0    0    0    0    0    0   35    0    0    0    0    0    0    0    0    0    0    0    0    0    0    0    0    0    0    0    0]
 [   0    0    0    0    0    0    0  214    0    0    0    0    0    0    0    0    0    0    0    0    2    0    0    0    0    0    0]
 [   1    0    0    0    0    0    0    0   42    0    0    0    0    0    0    0    0    0    0    0    0    0    0    0    0    0    0]
 [  27    0    0    0    0    0    0    0    0 1727    0    0    0    0    0    0    0    0    0    0    0    0    0    0    0    0    0]
 [   0    0    0    0    0    0    0    0    0    0   47    0    0    0    0    0    0    0    0    0    0    0    0    0    0    0    0]
 [   0    0    0    0    0    0    0    0    0    0    0  301    0    0    0    0    0    0    0    0    0    0    0    0    0    0    0]
 [   0    0    0    0    0    3    0    0    0    0    0    0   19    5    0    0    0    1    0    8    0    0    0    0    0    0    0]
 [   0    0    0    0    0    0    0    0    0    0    0    0    0   15    1    0    0    0    0    3    0    0    0    0    0    0    0]
 [   1    0    0    0    0    0    0    0    0    0    0    0    0    0   68    0    0    1    0    3    0    0    0    0    0    0    0]
 [   1    0    0    0    0    0    0    0    0    0    0    0    0    0    0   10    0    0    0    0    0    0    0    0    0    0    0]
 [   2    0    0    0    0    0    0    0    0    0    0    0    0    0    0    0   96    0    0    0    0    0    0    0    0    0    0]
 [   1    0    0    0    0    2    0    0    0    0    0    0    4    2    1    0    0   54    0   10    0    0    0    0    0    0    0]
 [   0    0    0    0    0    1    0    0    0    0    0    0    0    0    3    0    0    1   19    3    0    0    0    0    0    0    0]
 [   3    0    0    0    0    3    0    0    0    0    0    0    3    3    2    0    0   15    1   53    0    0    0    0    0    0    0]
 [   2    0    1    0    0    0    0    0    0    0    0    0    0    0    0    0    0    0    0    0  248    0    0    0    0    0    0]
 [   0    0    0    0    0    0    0    0    0    0    0    0    0    0    0    0    0    0    0    0    1   47    0    0    0    0    0]
 [   0    0    0    0    0    0    0    0    0    0    0    0    0    0    0    0    0    0    0    0    0    0  522    0    0    0    0]
 [   1    0    0    0    0    0    0    0    0    0    0    0    0    0    0    0    0    0    0    0    0    0    0   12    0    0    0]
 [   0    0    0    1    0    0    0    0    0    0    0    0    0    0    0    0    0    0    0    0    0    0    0    0    5    0    0]
 [   0    0    0    0    0    0    0    0    0    0    0    0    0    0    0    0    0    0    0    0    0    0    0    0    0   13    0]
 [   1    0    2    0    0    0    0    1    0    0    0    0    0    0    0    0    0    0    0    0    1    0    0    0    0    0   44]]

