Classifier: LogisticRegression
Params: {'C': 1.0, 'class_weight': None, 'dual': False, 'fit_intercept': True, 'intercept_scaling': 1, 'max_iter': 100, 'multi_class': 'ovr', 'n_jobs': 1, 'penalty': 'l2', 'random_state': None, 'solver': 'liblinear', 'tol': 0.0001, 'verbose': 0, 'warm_start': False}

Labels: None

Training accuracy: 0.985502997133177
Training confusion matrix:
[[14652     0     1     3     0     0     0     2     0     2     0     0     0     0     0     0     2     0     0     0     0     0     0     0     0     0     0]
 [    3   231     0     0     0     0     0     0     0     0     0     0     0     0     0     0     0     0     0     0     0     0     0     0     0     0     0]
 [    2     0   295     0     0     0     0     0     0     0     0     0     0     0     0     0     0     0     0     0     0     0     0     0     0     0     0]
 [    5     0     0   191     0     0     0     0     0     0     0     0     0     0     0     0     0     0     0     0     0     0     0     0     0     0     0]
 [    2     0     0     0   203     0     0     0     0     0     0     0     0     0     0     0     0     0     0     0     0     0     0     0     0     0     0]
 [    2     0     0     0     0   101     0     0     0     0     0     0     7     2     6     0     0     3     5    25     0     0     0     0     0     0     0]
 [    1     0     0     0     0     0   114     0     0     0     0     0     0     0     0     0     0     0     0     0     0     0     0     0     0     1     0]
 [    4     0     0     0     0     0     0  1023     0     0     0     0     0     0     0     0     0     0     0     0     2     0     0     0     0     0     0]
 [    0     0     0     0     0     0     0     0   181     0     0     0     0     0     0     0     0     0     0     0     0     0     0     0     0     0     0]
 [   71     0     0     0     0     0     0     0     0  6727     0     0     0     0     0     0     0     0     0     0     0     0     0     0     0     0     0]
 [    2     0     0     0     0     0     0     0     0     0   220     0     0     0     0     0     0     0     0     0     0     0     0     0     0     0     0]
 [    8     0     0     0     0     0     0     0     0     0     0  1168     0     0     0     0     0     0     0     0     0     0     0     0     0     0     0]
 [    0     0     0     0     0     4     0     0     0     0     0     0    69     4     0     0     0     4     0    18     0     0     0     0     0     0     0]
 [    1     0     0     0     0     5     0     0     0     0     0     0     0    71     1     0     0     2     0     9     0     0     0     0     0     0     0]
 [    2     0     0     0     0     0     0     0     0     0     0     0     2     1   314     0     0     0     0     6     0     0     0     0     0     0     0]
 [    0     0     0     0     0     0     0     0     0     0     0     0     0     0     0    57     0     0     0     0     0     0     0     0     0     0     0]
 [    3     0     0     0     0     0     0     0     0     0     0     0     0     0     0     0   412     0     0     0     0     0     0     0     0     0     0]
 [    9     0     0     0     0    12     0     0     0     0     0     0    10     9     0     0     0   213     2    23     0     0     0     0     0     0     0]
 [    1     0     0     0     0     0     0     0     0     0     0     0     1     2    21     0     0     1    95    10     0     0     0     0     0     0     0]
 [    2     0     0     0     0    11     0     0     0     0     0     0    19     9     4     0     0    43     2   293     0     0     0     0     0     0     0]
 [   19     0     0     0     0     0     0     1     0     0     0     0     0     0     0     0     0     0     0     0   977     0     0     0     0     0     0]
 [    3     0     0     0     0     0     0     0     0     0     0     0     0     0     0     0     0     0     0     0     0   219     0     0     0     0     0]
 [    1     0     0     0     0     0     0     0     1     0     0     0     0     0     0     0     0     0     0     0     0     0  2122     0     0     0     0]
 [    3     0     0     0     0     0     0     0     0     0     0     0     0     0     0     0     0     0     0     0     0     0     0    29     0     0     0]
 [    0     0     0     0     0     0     0     0     0     0     0     0     0     0     0     0     0     0     0     0     0     0     0     0    32     0     0]
 [    0     0     0     0     0     0     0     1     0     0     0     0     0     0     0     0     0     0     0     0     0     0     0     0     0    61     0]
 [    1     0     0     0     0     0     0     0     0     0     0     0     0     0     0     0     0     0     0     0     1     0     0     0     0     0   181]]

Accuracy: 0.9757623143080532

Precision: [0.9840 1.0000 0.9516 0.9565 0.9592 0.6176 1.0000 1.0000 1.0000 0.9994 0.9792 1.0000 0.6552 0.6522 0.8481 1.0000 0.9697 0.7391 0.9444 0.5745 0.9722 0.9388 1.0000 1.0000 0.8333 1.0000 0.9783]
Mean: 0.9093809528969362
Std: 0.13332390118069049

Recall: [0.9965 0.9844 0.9365 0.9167 1.0000 0.5122 0.9429 0.9861 0.9767 0.9846 1.0000 0.9867 0.5278 0.7895 0.9178 0.9091 0.9796 0.6892 0.6296 0.6506 0.9761 0.9583 1.0000 0.8462 0.8333 1.0000 0.9184]
Mean: 0.8832852128899505
Std: 0.1471734785038309

F1 score: [0.9902 0.9921 0.9440 0.9362 0.9792 0.5600 0.9706 0.9930 0.9882 0.9920 0.9895 0.9933 0.5846 0.7143 0.8816 0.9524 0.9746 0.7133 0.7556 0.6102 0.9742 0.9485 1.0000 0.9167 0.8333 1.0000 0.9474]
Mean: 0.8938771180489729
Std: 0.13668761501960616

Cohen Kappa score: 0.9656300082782384
Confusion matrix:
[[3679    0    1    2    0    0    0    0    0    1    1    0    0    0    1    0    3    0    0    0    0    3    0    0    1    0    0]
 [   1   63    0    0    0    0    0    0    0    0    0    0    0    0    0    0    0    0    0    0    0    0    0    0    0    0    0]
 [   1    0   59    0    0    0    0    0    0    0    0    0    0    0    0    0    0    0    0    0    2    0    0    0    0    0    1]
 [   4    0    0   44    0    0    0    0    0    0    0    0    0    0    0    0    0    0    0    0    0    0    0    0    0    0    0]
 [   0    0    0    0   47    0    0    0    0    0    0    0    0    0    0    0    0    0    0    0    0    0    0    0    0    0    0]
 [   1    0    0    0    0   21    0    0    0    0    0    0    1    0    3    0    0    1    1   13    0    0    0    0    0    0    0]
 [   2    0    0    0    0    0   33    0    0    0    0    0    0    0    0    0    0    0    0    0    0    0    0    0    0    0    0]
 [   0    0    0    0    0    0    0  213    0    0    0    0    0    0    0    0    0    0    0    0    3    0    0    0    0    0    0]
 [   1    0    0    0    0    0    0    0   42    0    0    0    0    0    0    0    0    0    0    0    0    0    0    0    0    0    0]
 [  27    0    0    0    0    0    0    0    0 1727    0    0    0    0    0    0    0    0    0    0    0    0    0    0    0    0    0]
 [   0    0    0    0    0    0    0    0    0    0   47    0    0    0    0    0    0    0    0    0    0    0    0    0    0    0    0]
 [   4    0    0    0    0    0    0    0    0    0    0  297    0    0    0    0    0    0    0    0    0    0    0    0    0    0    0]
 [   0    0    0    0    0    4    0    0    0    0    0    0   19    5    0    0    0    1    0    7    0    0    0    0    0    0    0]
 [   0    0    0    0    0    0    0    0    0    0    0    0    0   15    1    0    0    0    0    3    0    0    0    0    0    0    0]
 [   3    0    0    0    0    0    0    0    0    0    0    0    0    0   67    0    0    1    0    2    0    0    0    0    0    0    0]
 [   1    0    0    0    0    0    0    0    0    0    0    0    0    0    0   10    0    0    0    0    0    0    0    0    0    0    0]
 [   2    0    0    0    0    0    0    0    0    0    0    0    0    0    0    0   96    0    0    0    0    0    0    0    0    0    0]
 [   1    0    0    0    0    2    0    0    0    0    0    0    5    2    1    0    0   51    0   12    0    0    0    0    0    0    0]
 [   0    0    0    0    0    1    0    0    0    0    0    0    1    0    4    0    0    1   17    3    0    0    0    0    0    0    0]
 [   3    0    0    0    0    6    0    0    0    0    0    0    3    1    2    0    0   14    0   54    0    0    0    0    0    0    0]
 [   5    0    1    0    0    0    0    0    0    0    0    0    0    0    0    0    0    0    0    0  245    0    0    0    0    0    0]
 [   0    0    0    0    0    0    0    0    0    0    0    0    0    0    0    0    0    0    0    0    2   46    0    0    0    0    0]
 [   0    0    0    0    0    0    0    0    0    0    0    0    0    0    0    0    0    0    0    0    0    0  522    0    0    0    0]
 [   2    0    0    0    0    0    0    0    0    0    0    0    0    0    0    0    0    0    0    0    0    0    0   11    0    0    0]
 [   1    0    0    0    0    0    0    0    0    0    0    0    0    0    0    0    0    0    0    0    0    0    0    0    5    0    0]
 [   0    0    0    0    0    0    0    0    0    0    0    0    0    0    0    0    0    0    0    0    0    0    0    0    0   13    0]
 [   1    0    1    0    2    0    0    0    0    0    0    0    0    0    0    0    0    0    0    0    0    0    0    0    0    0   45]]

