Classifier: MultinomialNB
Params: {'alpha': 1.0, 'class_prior': None, 'fit_prior': True}

Labels: None

Training accuracy: 0.9127247849882721
Training confusion matrix:
[[13446   122    13   115     8     0     6   248     5    30   173    16     0     0    86     0    24    41    11   132    28    24    26    35    20    24    29]
 [    7   227     0     0     0     0     0     0     0     0     0     0     0     0     0     0     0     0     0     0     0     0     0     0     0     0     0]
 [    2     0   272     0     5     0     2     6     0     0     0     0     0     0     0     0     1     0     0     0     7     0     2     0     0     0     0]
 [   26     0     0   157     0     0     0     0     0     0     0     0     0     0     0     0    13     0     0     0     0     0     0     0     0     0     0]
 [    2     0     0     0   160     0     4    27     0     0     0     0     0     0     0     0     0     0     0     0     1     0    11     0     0     0     0]
 [    0     0     0     0     0     9     0     0     0     0     0     0     0     0     3     0     0     0     0   139     0     0     0     0     0     0     0]
 [    0     0     0     0     2     0    86     8     0     0     0     0     0     0     0     0     1     0     0     0     0     0    19     0     0     0     0]
 [    0     0     0     0     9     0     0   997     0     0     0     0     0     0     0     0     1     0     0     0    20     0     2     0     0     0     0]
 [    1     0     0     0     0     0     1     1   171     0     0     0     0     0     0     0     0     0     0     0     0     0     7     0     0     0     0]
 [   82     0     0     3     0     0     0     0     0  6665     4     1     0     0     1     0     2     0     0     0     3     3    21     1     1    10     1]
 [    8     0     0     0     0     0     0     0     0     0   214     0     0     0     0     0     0     0     0     0     0     0     0     0     0     0     0]
 [   15     0     0     0     0     0     0     0     0     4     0  1157     0     0     0     0     0     0     0     0     0     0     0     0     0     0     0]
 [    0     0     0     0     0     0     0     0     0     0     0     0     0     0     0     0     0     0     0    99     0     0     0     0     0     0     0]
 [    0     0     0     0     0     0     0     0     0     0     0     0     0     2     0     0     0     0     0    87     0     0     0     0     0     0     0]
 [    0     0     0     0     0     0     0     0     0     0     0     0     0     0   175     0     0     4     0   122     1     0    23     0     0     0     0]
 [    0     0     0     0     2     0     1     3     0     0     0     0     0     0     0    27     0     0     0     0     0     0    24     0     0     0     0]
 [   47     0     0     1     2     0     1     1     0     0     0     0     0     0     0     0   362     0     0     0     0     0     0     0     1     0     0]
 [    6     0     0     0     0     0     0     0     0     0     0     0     0     0     1     0     0    56     2   213     0     0     0     0     0     0     0]
 [    1     0     0     0     0     0     0     0     0     0     0     0     0     0     6     0     0     7    19    98     0     0     0     0     0     0     0]
 [    4     0     0     0     0     0     0     0     0     0     0     0     0     0     2     0     1     8     0   364     0     0     4     0     0     0     0]
 [    3     0     0     0     0     0     0     3     0     0     0     0     0     0     0     0     0     0     0     0   988     0     3     0     0     0     0]
 [    1     0     0     0     0     0     0    19     0     0     0     0     0     0     0     0     0     0     0     0     9   188     5     0     0     0     0]
 [    4     0     2     0     5     0     4     5     1     0     0     0     0     0     0     0     2     0     0     0     0     0  2101     0     0     0     0]
 [    4    16     0     0     0     0     0     0     0     0     0     0     0     0     0     0     0     0     0     0     0     0     0    12     0     0     0]
 [    2     0     0     0     0     0     0     0     0     0     0     0     0     0     0     0     0     0     0     0     0     0     0     0    30     0     0]
 [    0     0     0     0     6     0     0     9     0     0     0     0     0     0     0     0     3     0     0     0     0     0    39     0     0     5     0]
 [    0     0     0     0     2     0     1     6     0     0     0     0     0     0     0     0     0     0     0     0     5     0    42     0     0     0   127]]

Accuracy: 0.9116497263487099

Precision: [0.9794 0.6354 0.8983 0.5238 0.7917 1.0000 0.8800 0.7244 1.0000 0.9953 0.5733 0.9835 0.0000 0.0000 0.5323 0.8889 0.8485 0.5806 0.2500 0.2550 0.9114 0.7551 0.8929 0.3571 0.5556 0.5000 0.9333]
Mean: 0.6757766871350727
Std: 0.29440674442717774

Recall: [0.9277 0.9531 0.8413 0.6875 0.8085 0.0732 0.6286 0.9491 0.9767 0.9755 0.9149 0.9900 0.0000 0.0000 0.4521 0.7273 0.8571 0.2432 0.0370 0.9157 0.9841 0.7708 0.9904 0.3846 0.8333 0.2308 0.5714]
Mean: 0.6564421179224648
Std: 0.3402060306995539

F1 score: [0.9528 0.7625 0.8689 0.5946 0.8000 0.1364 0.7333 0.8216 0.9882 0.9853 0.7049 0.9868 0.0000 0.0000 0.4889 0.8000 0.8528 0.3429 0.0645 0.3990 0.9464 0.7629 0.9391 0.3704 0.6667 0.3158 0.7089]
Mean: 0.6293866644100939
Std: 0.3116501930568702

Cohen Kappa score: 0.8772147453447725
Confusion matrix:
[[3425   30    5   29    1    0    0   55    0    8   31    5    0    0   23    0    6    9    3   27    4    8    6    9    4    2    2]
 [   3   61    0    0    0    0    0    0    0    0    0    0    0    0    0    0    0    0    0    0    0    0    0    0    0    0    0]
 [   1    0   53    0    2    0    2    3    0    0    0    0    0    0    0    0    0    0    0    0    2    0    0    0    0    0    0]
 [  11    0    0   33    0    0    0    0    0    0    0    0    0    0    0    0    4    0    0    0    0    0    0    0    0    0    0]
 [   0    0    0    0   38    0    1    5    0    0    0    0    0    0    0    0    0    0    0    0    0    0    3    0    0    0    0]
 [   0    0    0    0    0    3    0    0    0    0    0    0    0    0    0    0    0    0    0   38    0    0    0    0    0    0    0]
 [   0    0    0    0    1    0   22    2    0    0    0    0    0    0    0    0    0    0    0    0    0    0   10    0    0    0    0]
 [   1    0    0    0    2    0    0  205    0    0    0    0    0    0    0    0    1    0    0    0    7    0    0    0    0    0    0]
 [   0    0    0    0    0    0    0    1   42    0    0    0    0    0    0    0    0    0    0    0    0    0    0    0    0    0    0]
 [  29    0    0    0    0    0    0    0    0 1711    0    0    0    0    1    1    0    0    0    0    1    4    6    0    0    1    0]
 [   4    0    0    0    0    0    0    0    0    0   43    0    0    0    0    0    0    0    0    0    0    0    0    0    0    0    0]
 [   3    0    0    0    0    0    0    0    0    0    0  298    0    0    0    0    0    0    0    0    0    0    0    0    0    0    0]
 [   0    0    0    0    0    0    0    0    0    0    0    0    0    0    0    0    0    0    0   36    0    0    0    0    0    0    0]
 [   0    0    0    0    0    0    0    0    0    0    0    0    0    0    0    0    0    0    0   19    0    0    0    0    0    0    0]
 [   0    0    0    0    0    0    0    1    0    0    0    0    0    0   33    0    0    2    0   27    1    0    9    0    0    0    0]
 [   0    0    0    0    0    0    0    1    0    0    0    0    0    0    0    8    0    0    0    0    0    0    2    0    0    0    0]
 [  11    0    0    1    1    0    0    1    0    0    0    0    0    0    0    0   84    0    0    0    0    0    0    0    0    0    0]
 [   1    0    0    0    0    0    0    0    0    0    1    0    0    0    0    0    0   18    0   54    0    0    0    0    0    0    0]
 [   0    0    0    0    0    0    0    0    0    0    0    0    0    0    4    0    0    1    1   21    0    0    0    0    0    0    0]
 [   3    0    0    0    0    0    0    0    0    0    0    0    0    0    1    0    0    1    0   76    0    0    2    0    0    0    0]
 [   1    0    1    0    0    0    0    2    0    0    0    0    0    0    0    0    0    0    0    0  247    0    0    0    0    0    0]
 [   0    0    0    0    0    0    0    3    0    0    0    0    0    0    0    0    0    0    0    0    5   37    3    0    0    0    0]
 [   0    0    0    0    0    0    0    1    0    0    0    0    0    0    0    0    4    0    0    0    0    0  517    0    0    0    0]
 [   3    5    0    0    0    0    0    0    0    0    0    0    0    0    0    0    0    0    0    0    0    0    0    5    0    0    0]
 [   1    0    0    0    0    0    0    0    0    0    0    0    0    0    0    0    0    0    0    0    0    0    0    0    5    0    0]
 [   0    0    0    0    0    0    0    1    0    0    0    0    0    0    0    0    0    0    0    0    0    0    9    0    0    3    0]
 [   0    0    0    0    3    0    0    2    0    0    0    0    0    0    0    0    0    0    0    0    4    0   12    0    0    0   28]]

