Classifier: RandomForestClassifier
Params: {'bootstrap': True, 'class_weight': None, 'criterion': 'gini', 'max_depth': None, 'max_features': 'auto', 'max_leaf_nodes': None, 'min_impurity_decrease': 0.0, 'min_impurity_split': None, 'min_samples_leaf': 1, 'min_samples_split': 2, 'min_weight_fraction_leaf': 0.0, 'n_estimators': 100, 'n_jobs': 1, 'oob_score': False, 'random_state': None, 'verbose': 0, 'warm_start': False}

Labels: None

Training accuracy: 0.9930935626791765
Training confusion matrix:
[[14655     0     0     2     1     0     0     0     0     2     0     0     0     0     0     0     2     0     0     0     0     0     0     0     0     0     0]
 [    0   234     0     0     0     0     0     0     0     0     0     0     0     0     0     0     0     0     0     0     0     0     0     0     0     0     0]
 [    0     0   297     0     0     0     0     0     0     0     0     0     0     0     0     0     0     0     0     0     0     0     0     0     0     0     0]
 [    2     0     0   194     0     0     0     0     0     0     0     0     0     0     0     0     0     0     0     0     0     0     0     0     0     0     0]
 [    0     0     0     0   205     0     0     0     0     0     0     0     0     0     0     0     0     0     0     0     0     0     0     0     0     0     0]
 [    0     0     0     0     0   138     0     0     0     0     0     0     0     1     1     0     0     2     0     9     0     0     0     0     0     0     0]
 [    0     0     0     0     0     0   116     0     0     0     0     0     0     0     0     0     0     0     0     0     0     0     0     0     0     0     0]
 [    0     0     0     0     0     0     0  1028     0     0     0     0     0     0     0     0     0     0     0     0     1     0     0     0     0     0     0]
 [    0     0     0     0     0     0     0     0   181     0     0     0     0     0     0     0     0     0     0     0     0     0     0     0     0     0     0]
 [   64     0     0     0     0     0     0     0     0  6734     0     0     0     0     0     0     0     0     0     0     0     0     0     0     0     0     0]
 [    0     0     0     0     0     0     0     0     0     0   222     0     0     0     0     0     0     0     0     0     0     0     0     0     0     0     0]
 [    0     0     0     0     0     0     0     0     0     0     0  1176     0     0     0     0     0     0     0     0     0     0     0     0     0     0     0]
 [    0     0     0     0     0     0     0     0     0     0     0     0    89     0     0     0     0     2     0     8     0     0     0     0     0     0     0]
 [    0     0     0     0     0     2     0     0     0     0     0     0     1    84     0     0     0     2     0     0     0     0     0     0     0     0     0]
 [    0     0     0     0     0     2     0     0     0     0     0     0     0     0   318     0     0     0     4     1     0     0     0     0     0     0     0]
 [    0     0     0     0     0     0     0     0     0     0     0     0     0     0     0    57     0     0     0     0     0     0     0     0     0     0     0]
 [    2     0     0     0     0     0     0     0     0     0     0     0     0     0     0     0   413     0     0     0     0     0     0     0     0     0     0]
 [    8     0     0     0     0     1     0     0     0     0     0     0     3     3     0     0     0   249     1    13     0     0     0     0     0     0     0]
 [    0     0     0     0     0     2     0     0     0     0     0     0     0     2    10     0     0     1   111     5     0     0     0     0     0     0     0]
 [    1     0     0     0     0     3     0     0     0     0     0     0    11     3     3     0     0    28     1   333     0     0     0     0     0     0     0]
 [    1     0     0     0     0     0     0     0     0     0     0     0     0     0     0     0     0     0     0     0   996     0     0     0     0     0     0]
 [    0     0     0     0     0     0     0     0     0     0     0     0     0     0     0     0     0     0     0     0     0   222     0     0     0     0     0]
 [    0     0     0     0     0     0     0     0     1     0     0     0     0     0     0     0     0     0     0     0     0     0  2123     0     0     0     0]
 [    0     0     0     0     0     0     0     0     0     0     0     0     0     0     0     0     0     0     0     0     0     0     0    32     0     0     0]
 [    0     0     0     0     0     0     0     0     0     0     0     0     0     0     0     0     0     0     0     0     0     0     0     0    32     0     0]
 [    0     0     0     0     0     0     0     0     0     0     0     0     0     0     0     0     0     0     0     0     0     0     0     0     0    62     0]
 [    0     0     0     0     0     0     0     0     0     0     0     0     0     0     0     0     0     0     0     0     0     0     0     0     0     0   183]]

Accuracy: 0.9683346364347146

Precision: [0.9815 1.0000 0.9286 0.9474 0.8393 0.6667 1.0000 0.9814 1.0000 0.9983 1.0000 1.0000 0.5000 0.4000 0.8955 0.7692 0.9684 0.7105 0.7727 0.5140 0.9533 0.9388 0.9981 0.6429 0.8333 0.7500 1.0000]
Mean: 0.8514773483373124
Std: 0.17432030970666046

Recall: [0.9930 0.9531 0.8254 0.7500 1.0000 0.4878 0.8857 0.9769 0.9767 0.9852 0.9574 1.0000 0.4167 0.3158 0.8219 0.9091 0.9388 0.7297 0.6296 0.6627 0.9761 0.9583 1.0000 0.6923 0.8333 0.9231 0.8776]
Mean: 0.8324506137242108
Std: 0.1863512679143816

F1 score: [0.9872 0.9760 0.8739 0.8372 0.9126 0.5634 0.9394 0.9791 0.9882 0.9917 0.9783 1.0000 0.4545 0.3529 0.8571 0.8333 0.9534 0.7200 0.6939 0.5789 0.9646 0.9485 0.9990 0.6667 0.8333 0.8276 0.9348]
Mean: 0.8387275719509695
Std: 0.17603635359333936

Cohen Kappa score: 0.9551045595000456
Confusion matrix:
[[3666    0    1    2    1    1    0    1    0    3    0    0    0    0    1    0    2    0    1    1    1    2    1    5    1    2    0]
 [   3   61    0    0    0    0    0    0    0    0    0    0    0    0    0    0    0    0    0    0    0    0    0    0    0    0    0]
 [   1    0   52    0    4    0    0    1    0    0    0    0    0    0    0    0    0    0    0    0    3    1    0    0    0    1    0]
 [  11    0    0   36    0    0    0    0    0    0    0    0    0    0    0    0    1    0    0    0    0    0    0    0    0    0    0]
 [   0    0    0    0   47    0    0    0    0    0    0    0    0    0    0    0    0    0    0    0    0    0    0    0    0    0    0]
 [   1    0    0    0    0   20    0    0    0    0    0    0    2    1    1    0    0    2    1   13    0    0    0    0    0    0    0]
 [   0    0    0    0    0    0   31    0    0    0    0    0    0    0    0    3    0    0    0    0    0    0    0    0    0    1    0]
 [   1    0    0    0    1    0    0  211    0    0    0    0    0    0    0    0    0    0    0    0    3    0    0    0    0    0    0]
 [   0    0    1    0    0    0    0    0   42    0    0    0    0    0    0    0    0    0    0    0    0    0    0    0    0    0    0]
 [  26    0    0    0    0    0    0    0    0 1728    0    0    0    0    0    0    0    0    0    0    0    0    0    0    0    0    0]
 [   2    0    0    0    0    0    0    0    0    0   45    0    0    0    0    0    0    0    0    0    0    0    0    0    0    0    0]
 [   0    0    0    0    0    0    0    0    0    0    0  301    0    0    0    0    0    0    0    0    0    0    0    0    0    0    0]
 [   0    0    0    0    0    4    0    0    0    0    0    0   15    4    0    0    0    0    1   12    0    0    0    0    0    0    0]
 [   0    0    0    0    0    1    0    0    0    0    0    0    1    6    1    0    0    3    0    7    0    0    0    0    0    0    0]
 [   4    0    0    0    0    0    0    0    0    0    0    0    0    1   60    0    0    1    1    6    0    0    0    0    0    0    0]
 [   1    0    0    0    0    0    0    0    0    0    0    0    0    0    0   10    0    0    0    0    0    0    0    0    0    0    0]
 [   5    0    0    0    1    0    0    0    0    0    0    0    0    0    0    0   92    0    0    0    0    0    0    0    0    0    0]
 [   2    0    0    0    0    2    0    0    0    0    0    0    6    1    0    0    0   54    0    9    0    0    0    0    0    0    0]
 [   1    0    0    0    0    0    0    0    0    0    0    0    1    0    2    0    0    2   17    4    0    0    0    0    0    0    0]
 [   2    0    0    0    0    2    0    0    0    0    0    0    5    2    2    0    0   14    1   55    0    0    0    0    0    0    0]
 [   3    0    1    0    0    0    0    2    0    0    0    0    0    0    0    0    0    0    0    0  245    0    0    0    0    0    0]
 [   0    0    0    0    0    0    0    0    0    0    0    0    0    0    0    0    0    0    0    0    2   46    0    0    0    0    0]
 [   0    0    0    0    0    0    0    0    0    0    0    0    0    0    0    0    0    0    0    0    0    0  522    0    0    0    0]
 [   4    0    0    0    0    0    0    0    0    0    0    0    0    0    0    0    0    0    0    0    0    0    0    9    0    0    0]
 [   1    0    0    0    0    0    0    0    0    0    0    0    0    0    0    0    0    0    0    0    0    0    0    0    5    0    0]
 [   0    0    0    0    0    0    0    0    0    0    0    0    0    0    0    0    0    0    0    0    1    0    0    0    0   12    0]
 [   1    0    1    0    2    0    0    0    0    0    0    0    0    0    0    0    0    0    0    0    2    0    0    0    0    0   43]]

