Classifier: GradientBoostingClassifier
Params: {'criterion': 'friedman_mse', 'init': None, 'learning_rate': 0.1, 'loss': 'deviance', 'max_depth': 3, 'max_features': None, 'max_leaf_nodes': None, 'min_impurity_decrease': 0.0, 'min_impurity_split': None, 'min_samples_leaf': 1, 'min_samples_split': 2, 'min_weight_fraction_leaf': 0.0, 'n_estimators': 100, 'presort': 'auto', 'random_state': None, 'subsample': 1.0, 'verbose': 0, 'warm_start': False}

Labels: None

Training accuracy: 0.9862197028928851
Training confusion matrix:
[[14645     7     1     4     0     0     0     5     0     6     0     4     0     0     9     0     1     0     0     0     3     0     2     8     0     0     0]
 [   13   218     0     0     0     0     0     0     0     0     0     0     0     0     0     0     0     0     0     0     0     0     0     0     0     0     0]
 [    0     0   288     0     0     0     0     0     0     0     0     0     0     0     0     0     0     0     0     0     0     0     0     0     0     0     0]
 [   25     0     0   172     0     0     0     0     0     0     0     0     0     0     0     0     0     0     0     0     0     0     0     0     0     0     0]
 [    0     0     0     0   186     0     0     0     0     0     0     0     0     0     0     0     0     0     0     0     0     0     0     0     0     0     0]
 [    2     0     0     0     0   121     0     0     0     0     0     0     5     2     0     0     0     2     1    16     0     0     0     0     0     0     0]
 [    0     0     0     0     0     0   115     0     0     0     0     0     0     0     0     0     0     0     0     0     0     0     0     0     0     0     0]
 [    2     0     0     0     0     0     0  1010     0     0     0     0     0     0     0     0     0     0     0     0     1     0     0     0     0     0     0]
 [    0     0     0     0     0     0     0     0   171     0     0     0     0     0     0     0     0     0     0     0     0     0     0     0     0     0     0]
 [   72     0     0     0     0     0     0     0     0  6780     0     0     0     0     0     0     0     0     0     0     0     0     0     0     0     0     0]
 [    1     0     0     0     0     0     0     0     0     0   207     0     0     0     0     0     0     0     0     0     0     0     0     0     0     0     0]
 [   10     0     0     0     0     0     0     0     0     0     0  1175     0     0     0     0     0     0     0     0     0     0     0     0     0     0     0]
 [    0     0     0     0     0     2     0     0     0     0     0     0    96     0     1     0     0     5     0     4     0     0     0     0     0     0     0]
 [    0     0     0     0     0     2     0     0     0     0     0     0     2    80     0     0     0     0     0     1     0     0     0     0     0     0     0]
 [    2     0     0     0     0     7     0     0     0     0     0     0     1     1   305     0     0     1     9     4     0     0     0     0     0     0     0]
 [    0     0     0     0     0     0     0     0     0     0     0     0     0     0     0    52     0     0     0     0     0     0     0     0     0     0     0]
 [   19     0     0     0     0     0     0     0     0     0     0     0     0     0     0     0   379     0     0     0     0     0     0     0     0     0     0]
 [    0     0     0     0     0     3     0     0     0     0     0     0     8     5     0     0     0   253     1    16     0     0     0     0     0     0     0]
 [    4     0     0     0     0     5     0     0     0     0     0     0     0     1    12     0     0     2    99     7     0     0     0     0     0     0     0]
 [    0     0     0     0     0     8     0     0     0     0     0     0    26     4     4     0     0    51     0   282     0     0     0     0     0     0     0]
 [    1     0     0     0     0     0     0     1     0     0     0     0     0     0     0     0     0     0     0     0  1016     0     0     0     0     0     0]
 [    0     0     0     0     0     0     0     0     0     0     0     0     0     0     0     0     0     0     0     0     0   221     0     0     0     0     0]
 [    0     0     0     0     0     0     0     0     0     0     0     0     0     0     0     0     0     0     0     0     0     0  2088     0     0     0     0]
 [    1     0     0     0     0     0     0     0     0     0     0     0     0     0     0     0     0     0     0     0     0     0     0    35     0     0     0]
 [    0     0     0     0     0     0     0     0     0     0     0     0     0     0     0     0     0     0     0     0     0     0     0     0    30     0     0]
 [    0     0     0     0     0     0     0     0     0     0     0     0     0     0     0     0     0     0     0     0     0     0     0     0     0    62     0]
 [    0     0     0     0     0     0     0     0     0     0     0     0     0     0     0     0     0     0     0     0     0     0     0     0     0     0   187]]

Accuracy: 0.973286421683607

Precision: [0.9805 0.9118 1.0000 0.9302 1.0000 0.8235 1.0000 0.9824 0.9811 0.9976 0.9677 0.9862 0.5750 0.5667 0.8986 1.0000 0.9907 0.7067 0.5652 0.7534 0.9542 0.9792 0.9964 1.0000 0.8889 1.0000 1.0000]
Mean: 0.9050377879630928
Std: 0.1403896485323876

Recall: [0.9902 0.9254 0.9722 0.8511 1.0000 0.6512 1.0000 0.9612 0.9811 0.9841 0.9836 0.9795 0.8519 0.7391 0.9118 1.0000 0.9304 0.8030 0.4643 0.6044 0.9957 0.9592 0.9964 0.7778 1.0000 1.0000 0.9778]
Mean: 0.8996740379598476
Std: 0.1384888764107254

F1 score: [0.9853 0.9185 0.9859 0.8889 1.0000 0.7273 1.0000 0.9717 0.9811 0.9908 0.9756 0.9828 0.6866 0.6415 0.9051 1.0000 0.9596 0.7518 0.5098 0.6707 0.9745 0.9691 0.9964 0.8750 0.9412 1.0000 0.9888]
Mean: 0.8991851783515676
Std: 0.1347207670930341

Cohen Kappa score: 0.9625026189316761
Confusion matrix:
[[3623    6    0    3    0    0    0    3    0    4    2    4    0    0    3    0    1    0    3    0    5    1    1    0    0    0    0]
 [   5   62    0    0    0    0    0    0    0    0    0    0    0    0    0    0    0    0    0    0    0    0    0    0    0    0    0]
 [   1    0   70    0    0    0    0    0    0    0    0    0    0    0    0    0    0    0    0    0    1    0    0    0    0    0    0]
 [   7    0    0   40    0    0    0    0    0    0    0    0    0    0    0    0    0    0    0    0    0    0    0    0    0    0    0]
 [   0    0    0    0   66    0    0    0    0    0    0    0    0    0    0    0    0    0    0    0    0    0    0    0    0    0    0]
 [   1    0    0    0    0   28    0    0    0    0    0    0    2    0    0    0    0    7    0    5    0    0    0    0    0    0    0]
 [   0    0    0    0    0    0   36    0    0    0    0    0    0    0    0    0    0    0    0    0    0    0    0    0    0    0    0]
 [   3    0    0    0    0    0    0  223    1    0    0    0    0    0    0    0    0    0    0    0    5    0    0    0    0    0    0]
 [   0    0    0    0    0    0    0    0   52    0    0    0    0    0    0    0    0    0    0    0    0    0    1    0    0    0    0]
 [  27    0    0    0    0    0    0    0    0 1673    0    0    0    0    0    0    0    0    0    0    0    0    0    0    0    0    0]
 [   1    0    0    0    0    0    0    0    0    0   60    0    0    0    0    0    0    0    0    0    0    0    0    0    0    0    0]
 [   6    0    0    0    0    0    0    0    0    0    0  286    0    0    0    0    0    0    0    0    0    0    0    0    0    0    0]
 [   0    0    0    0    0    0    0    0    0    0    0    0   23    2    0    0    0    0    0    2    0    0    0    0    0    0    0]
 [   0    0    0    0    0    2    0    0    0    0    0    0    1   17    0    0    0    0    0    3    0    0    0    0    0    0    0]
 [   2    0    0    0    0    0    0    0    0    0    0    0    0    0   62    0    0    0    4    0    0    0    0    0    0    0    0]
 [   0    0    0    0    0    0    0    0    0    0    0    0    0    0    0   16    0    0    0    0    0    0    0    0    0    0    0]
 [   7    0    0    0    0    0    0    0    0    0    0    0    0    0    0    0  107    0    0    0    0    0    0    0    1    0    0]
 [   2    0    0    0    0    0    0    0    0    0    0    0    3    3    0    0    0   53    1    4    0    0    0    0    0    0    0]
 [   2    0    0    0    0    2    0    0    0    0    0    0    2    1    4    0    0    0   13    4    0    0    0    0    0    0    0]
 [   1    0    0    0    0    2    0    0    0    0    0    0    9    7    0    0    0   15    2   55    0    0    0    0    0    0    0]
 [   1    0    0    0    0    0    0    0    0    0    0    0    0    0    0    0    0    0    0    0  229    0    0    0    0    0    0]
 [   1    0    0    0    0    0    0    1    0    0    0    0    0    0    0    0    0    0    0    0    0   47    0    0    0    0    0]
 [   2    0    0    0    0    0    0    0    0    0    0    0    0    0    0    0    0    0    0    0    0    0  556    0    0    0    0]
 [   2    0    0    0    0    0    0    0    0    0    0    0    0    0    0    0    0    0    0    0    0    0    0    7    0    0    0]
 [   0    0    0    0    0    0    0    0    0    0    0    0    0    0    0    0    0    0    0    0    0    0    0    0    8    0    0]
 [   0    0    0    0    0    0    0    0    0    0    0    0    0    0    0    0    0    0    0    0    0    0    0    0    0   13    0]
 [   1    0    0    0    0    0    0    0    0    0    0    0    0    0    0    0    0    0    0    0    0    0    0    0    0    0   44]]

