Classifier: LinearSVC
Params: {'C': 1.0, 'class_weight': None, 'dual': True, 'fit_intercept': True, 'intercept_scaling': 1, 'loss': 'squared_hinge', 'max_iter': 1000, 'multi_class': 'ovr', 'penalty': 'l2', 'random_state': None, 'tol': 0.0001, 'verbose': 0}

Labels: None

Training accuracy: 0.9864803231691426
Training confusion matrix:
[[14647     4     2     4     0     0     0     3     0     0     0     3     0     0     5     1     7     0     3     1     2     1     1    10     1     0     0]
 [   12   219     0     0     0     0     0     0     0     0     0     0     0     0     0     0     0     0     0     0     0     0     0     0     0     0     0]
 [    1     0   287     0     0     0     0     0     0     0     0     0     0     0     0     0     0     0     0     0     0     0     0     0     0     0     0]
 [   23     0     0   174     0     0     0     0     0     0     0     0     0     0     0     0     0     0     0     0     0     0     0     0     0     0     0]
 [    0     0     0     0   186     0     0     0     0     0     0     0     0     0     0     0     0     0     0     0     0     0     0     0     0     0     0]
 [    2     0     0     0     0    97     0     0     0     0     0     0    10     2     5     0     0     4     3    26     0     0     0     0     0     0     0]
 [    0     0     0     0     0     0   115     0     0     0     0     0     0     0     0     0     0     0     0     0     0     0     0     0     0     0     0]
 [    0     0     0     0     0     0     0  1011     0     0     0     0     0     0     0     0     0     0     0     0     2     0     0     0     0     0     0]
 [    0     0     0     0     0     0     0     0   171     0     0     0     0     0     0     0     0     0     0     0     0     0     0     0     0     0     0]
 [    1     0     0     0     0     0     0     0     0  6851     0     0     0     0     0     0     0     0     0     0     0     0     0     0     0     0     0]
 [    1     0     0     0     0     0     0     0     0     0   207     0     0     0     0     0     0     0     0     0     0     0     0     0     0     0     0]
 [    5     0     0     0     0     0     0     0     0     0     0  1180     0     0     0     0     0     0     0     0     0     0     0     0     0     0     0]
 [    0     0     0     0     0     3     0     0     0     0     0     0    94     5     0     0     0     0     0     6     0     0     0     0     0     0     0]
 [    0     0     0     0     0     5     0     0     0     0     0     0     0    75     1     0     0     2     0     2     0     0     0     0     0     0     0]
 [    3     0     0     0     0     2     0     0     0     0     0     0     1     2   308     0     0     1     8     5     0     0     0     0     0     0     0]
 [    1     0     0     0     0     0     0     0     0     0     0     0     0     0     0    51     0     0     0     0     0     0     0     0     0     0     0]
 [   13     0     0     0     0     0     0     0     0     0     0     0     0     0     0     0   385     0     0     0     0     0     0     0     0     0     0]
 [    0     0     0     0     0    10     0     0     0     0     0     0    18     7     1     0     0   219     0    31     0     0     0     0     0     0     0]
 [    2     0     0     0     0     1     0     0     0     0     0     0     1     1    11     0     0     3   102     9     0     0     0     0     0     0     0]
 [    1     0     0     0     0    15     0     0     0     0     0     0    36    10     5     0     0    42     2   264     0     0     0     0     0     0     0]
 [    1     0     0     0     0     0     0     0     0     0     0     0     0     0     0     0     0     0     0     0  1017     0     0     0     0     0     0]
 [    1     0     0     0     0     0     0     0     0     0     0     0     0     0     0     0     0     0     0     0     0   220     0     0     0     0     0]
 [    0     0     0     0     0     0     0     0     1     0     0     0     0     0     0     0     0     0     0     0     0     0  2087     0     0     0     0]
 [    1     0     0     0     0     0     0     0     0     0     0     0     0     0     0     0     0     0     0     0     0     0     0    35     0     0     0]
 [    0     0     0     0     0     0     0     0     0     0     0     0     0     0     0     0     0     0     0     0     0     0     0     0    30     0     0]
 [    0     0     0     0     0     0     0     0     0     0     0     0     0     0     0     0     0     0     0     0     0     0     0     0     0    62     0]
 [    0     0     0     0     0     0     0     0     0     0     0     0     0     0     0     0     0     0     0     0     0     0     0     0     0     0   187]]

Accuracy: 0.9790200677612718

Precision: [0.9896 0.9254 0.9859 0.9512 1.0000 0.8571 1.0000 0.9913 0.9811 1.0000 1.0000 0.9897 0.5122 0.5588 0.8514 0.8889 0.9397 0.7869 0.6250 0.7368 0.9914 0.9796 0.9982 0.9000 0.8750 1.0000 0.9783]
Mean: 0.8997590202578128
Std: 0.13749857054693676

Recall: [0.9918 0.9254 0.9722 0.8298 1.0000 0.6977 1.0000 0.9828 0.9811 0.9982 1.0000 0.9863 0.7778 0.8261 0.9265 1.0000 0.9478 0.7273 0.5357 0.6154 1.0000 0.9796 0.9964 1.0000 0.8750 1.0000 1.0000]
Mean: 0.9101046686326626
Std: 0.12925934911713038

F1 score: [0.9907 0.9254 0.9790 0.8864 1.0000 0.7692 1.0000 0.9870 0.9811 0.9991 1.0000 0.9880 0.6176 0.6667 0.8873 0.9412 0.9437 0.7559 0.5769 0.6707 0.9957 0.9796 0.9973 0.9474 0.8750 1.0000 0.9890]
Mean: 0.9018495404907166
Std: 0.12987974186911927

Cohen Kappa score: 0.9705992075368547
Confusion matrix:
[[3629    5    0    2    0    0    0    1    0    0    0    3    0    0    4    2    7    0    1    1    1    1    0    1    0    0    1]
 [   5   62    0    0    0    0    0    0    0    0    0    0    0    0    0    0    0    0    0    0    0    0    0    0    0    0    0]
 [   2    0   70    0    0    0    0    0    0    0    0    0    0    0    0    0    0    0    0    0    0    0    0    0    0    0    0]
 [   8    0    0   39    0    0    0    0    0    0    0    0    0    0    0    0    0    0    0    0    0    0    0    0    0    0    0]
 [   0    0    0    0   66    0    0    0    0    0    0    0    0    0    0    0    0    0    0    0    0    0    0    0    0    0    0]
 [   1    0    0    0    0   30    0    0    0    0    0    0    2    0    3    0    0    2    0    5    0    0    0    0    0    0    0]
 [   0    0    0    0    0    0   36    0    0    0    0    0    0    0    0    0    0    0    0    0    0    0    0    0    0    0    0]
 [   2    0    0    0    0    0    0  228    1    0    0    0    0    0    0    0    0    0    0    0    1    0    0    0    0    0    0]
 [   0    0    0    0    0    0    0    0   52    0    0    0    0    0    0    0    0    0    0    0    0    0    1    0    0    0    0]
 [   3    0    0    0    0    0    0    0    0 1697    0    0    0    0    0    0    0    0    0    0    0    0    0    0    0    0    0]
 [   0    0    0    0    0    0    0    0    0    0   61    0    0    0    0    0    0    0    0    0    0    0    0    0    0    0    0]
 [   4    0    0    0    0    0    0    0    0    0    0  288    0    0    0    0    0    0    0    0    0    0    0    0    0    0    0]
 [   0    0    0    0    0    0    0    0    0    0    0    0   21    3    0    0    0    1    0    2    0    0    0    0    0    0    0]
 [   0    0    0    0    0    2    0    0    0    0    0    0    1   19    0    0    0    0    0    1    0    0    0    0    0    0    0]
 [   2    0    0    0    0    0    0    0    0    0    0    0    1    0   63    0    0    0    2    0    0    0    0    0    0    0    0]
 [   0    0    0    0    0    0    0    0    0    0    0    0    0    0    0   16    0    0    0    0    0    0    0    0    0    0    0]
 [   5    0    0    0    0    0    0    0    0    0    0    0    0    0    0    0  109    0    0    0    0    0    0    0    1    0    0]
 [   1    0    0    0    0    0    0    0    0    0    0    0    4    3    0    0    0   48    2    8    0    0    0    0    0    0    0]
 [   2    0    0    0    0    1    0    0    0    0    0    0    2    1    4    0    0    0   15    3    0    0    0    0    0    0    0]
 [   1    0    0    0    0    2    0    0    0    0    0    0   10    8    0    0    0   10    4   56    0    0    0    0    0    0    0]
 [   0    0    0    0    0    0    0    0    0    0    0    0    0    0    0    0    0    0    0    0  230    0    0    0    0    0    0]
 [   0    0    0    0    0    0    0    1    0    0    0    0    0    0    0    0    0    0    0    0    0   48    0    0    0    0    0]
 [   1    0    1    0    0    0    0    0    0    0    0    0    0    0    0    0    0    0    0    0    0    0  556    0    0    0    0]
 [   0    0    0    0    0    0    0    0    0    0    0    0    0    0    0    0    0    0    0    0    0    0    0    9    0    0    0]
 [   1    0    0    0    0    0    0    0    0    0    0    0    0    0    0    0    0    0    0    0    0    0    0    0    7    0    0]
 [   0    0    0    0    0    0    0    0    0    0    0    0    0    0    0    0    0    0    0    0    0    0    0    0    0   13    0]
 [   0    0    0    0    0    0    0    0    0    0    0    0    0    0    0    0    0    0    0    0    0    0    0    0    0    0   45]]

