Classifier: LogisticRegression
Params: {'C': 1.0, 'class_weight': None, 'dual': False, 'fit_intercept': True, 'intercept_scaling': 1, 'max_iter': 100, 'multi_class': 'ovr', 'n_jobs': 1, 'penalty': 'l2', 'random_state': None, 'solver': 'liblinear', 'tol': 0.0001, 'verbose': 0, 'warm_start': False}

Labels: None

Training accuracy: 0.9829945269741986
Training confusion matrix:
[[14624     8     6     5     0     0     0     7     0     2     1     4     0     0     8     0     2     1     3     1     8     1     4     9     1     0     0]
 [   14   217     0     0     0     0     0     0     0     0     0     0     0     0     0     0     0     0     0     0     0     0     0     0     0     0     0]
 [    2     0   286     0     0     0     0     0     0     0     0     0     0     0     0     0     0     0     0     0     0     0     0     0     0     0     0]
 [   32     0     0   165     0     0     0     0     0     0     0     0     0     0     0     0     0     0     0     0     0     0     0     0     0     0     0]
 [    0     0     0     0   186     0     0     0     0     0     0     0     0     0     0     0     0     0     0     0     0     0     0     0     0     0     0]
 [    2     0     0     0     0    92     0     0     0     0     0     0    10     1     7     0     0     5     3    29     0     0     0     0     0     0     0]
 [    0     0     0     0     0     0   115     0     0     0     0     0     0     0     0     0     0     0     0     0     0     0     0     0     0     0     0]
 [    3     0     1     0     0     0     0  1004     0     0     0     0     0     0     0     0     0     0     0     0     5     0     0     0     0     0     0]
 [    0     0     0     0     0     0     0     0   171     0     0     0     0     0     0     0     0     0     0     0     0     0     0     0     0     0     0]
 [   10     0     0     0     0     0     0     0     0  6842     0     0     0     0     0     0     0     0     0     0     0     0     0     0     0     0     0]
 [    6     0     0     0     0     0     0     0     0     0   202     0     0     0     0     0     0     0     0     0     0     0     0     0     0     0     0]
 [    6     0     0     0     0     0     0     0     0     0     0  1179     0     0     0     0     0     0     0     0     0     0     0     0     0     0     0]
 [    0     0     0     0     0     3     0     0     0     0     0     0    88     6     0     0     0     3     0     8     0     0     0     0     0     0     0]
 [    0     0     0     0     0     7     0     0     0     0     0     0     0    71     1     0     0     2     0     4     0     0     0     0     0     0     0]
 [    5     0     0     0     0     1     0     0     0     0     0     0     1     2   310     0     0     1     5     5     0     0     0     0     0     0     0]
 [    1     0     0     0     0     0     0     0     0     0     0     0     0     0     0    51     0     0     0     0     0     0     0     0     0     0     0]
 [   21     0     0     0     0     0     0     0     0     0     0     0     0     0     0     0   377     0     0     0     0     0     0     0     0     0     0]
 [    2     0     0     0     0    10     0     0     0     0     0     0    13     7     1     0     0   216     2    35     0     0     0     0     0     0     0]
 [    6     0     0     1     0     1     0     0     0     0     0     0     1     1    16     0     0     3    90    11     0     0     0     0     0     0     0]
 [    1     0     0     0     0    16     0     0     0     0     0     0    35     6     7     0     0    40     1   269     0     0     0     0     0     0     0]
 [    4     0     0     0     0     0     0     1     0     0     0     0     0     0     0     0     0     0     0     0  1013     0     0     0     0     0     0]
 [    1     0     0     0     0     0     0     0     0     0     0     0     0     0     0     0     0     0     0     0     0   220     0     0     0     0     0]
 [    1     0     0     0     0     0     0     0     1     0     0     0     0     0     0     0     0     0     0     0     0     0  2086     0     0     0     0]
 [    5     0     0     0     0     0     0     0     0     1     0     0     0     0     0     0     0     0     0     0     0     0     0    30     0     0     0]
 [    1     0     0     0     0     0     0     0     0     0     0     0     0     0     0     0     0     0     0     0     0     0     0     0    29     0     0]
 [    0     0     0     0     0     0     0     1     0     0     0     0     0     0     0     0     0     0     0     0     0     0     0     0     0    61     0]
 [    7     0     0     0     0     0     0     0     0     0     0     0     0     0     0     0     0     0     0     0     0     0     0     0     0     0   180]]

Accuracy: 0.9766744852749544

Precision: [0.9848 0.9118 0.9859 0.9512 1.0000 0.7632 1.0000 0.9870 1.0000 0.9994 1.0000 0.9829 0.5405 0.5938 0.8400 1.0000 0.9906 0.7679 0.6500 0.7439 0.9703 0.9600 0.9982 1.0000 0.8750 1.0000 0.9778]
Mean: 0.9064481668054981
Std: 0.13516201678759385

Recall: [0.9918 0.9254 0.9722 0.8298 1.0000 0.6744 1.0000 0.9784 0.9811 0.9971 0.9508 0.9863 0.7407 0.8261 0.9265 1.0000 0.9130 0.6515 0.4643 0.6703 0.9957 0.9796 0.9964 0.7778 0.8750 1.0000 0.9778]
Mean: 0.8919277810125388
Std: 0.1391725159724483

F1 score: [0.9883 0.9185 0.9790 0.8864 1.0000 0.7160 1.0000 0.9827 0.9905 0.9982 0.9748 0.9846 0.6250 0.6909 0.8811 1.0000 0.9502 0.7049 0.5417 0.7052 0.9828 0.9697 0.9973 0.8750 0.8750 1.0000 0.9778]
Mean: 0.8961369991393487
Std: 0.13340905155836627

Cohen Kappa score: 0.9672619613651648
Confusion matrix:
[[3629    6    0    2    0    0    0    2    0    1    0    5    0    0    4    0    1    0    1    0    5    2    0    0    0    0    1]
 [   5   62    0    0    0    0    0    0    0    0    0    0    0    0    0    0    0    0    0    0    0    0    0    0    0    0    0]
 [   2    0   70    0    0    0    0    0    0    0    0    0    0    0    0    0    0    0    0    0    0    0    0    0    0    0    0]
 [   8    0    0   39    0    0    0    0    0    0    0    0    0    0    0    0    0    0    0    0    0    0    0    0    0    0    0]
 [   0    0    0    0   66    0    0    0    0    0    0    0    0    0    0    0    0    0    0    0    0    0    0    0    0    0    0]
 [   1    0    0    0    0   29    0    0    0    0    0    0    2    0    3    0    0    3    0    5    0    0    0    0    0    0    0]
 [   0    0    0    0    0    0   36    0    0    0    0    0    0    0    0    0    0    0    0    0    0    0    0    0    0    0    0]
 [   3    0    0    0    0    0    0  227    0    0    0    0    0    0    0    0    0    0    0    0    2    0    0    0    0    0    0]
 [   0    0    0    0    0    0    0    0   52    0    0    0    0    0    0    0    0    0    0    0    0    0    1    0    0    0    0]
 [   5    0    0    0    0    0    0    0    0 1695    0    0    0    0    0    0    0    0    0    0    0    0    0    0    0    0    0]
 [   3    0    0    0    0    0    0    0    0    0   58    0    0    0    0    0    0    0    0    0    0    0    0    0    0    0    0]
 [   4    0    0    0    0    0    0    0    0    0    0  288    0    0    0    0    0    0    0    0    0    0    0    0    0    0    0]
 [   0    0    0    0    0    0    0    0    0    0    0    0   20    3    0    0    0    1    1    2    0    0    0    0    0    0    0]
 [   0    0    0    0    0    3    0    0    0    0    0    0    0   19    0    0    0    0    0    1    0    0    0    0    0    0    0]
 [   2    0    0    0    0    0    0    0    0    0    0    0    1    0   63    0    0    0    2    0    0    0    0    0    0    0    0]
 [   0    0    0    0    0    0    0    0    0    0    0    0    0    0    0   16    0    0    0    0    0    0    0    0    0    0    0]
 [   9    0    0    0    0    0    0    0    0    0    0    0    0    0    0    0  105    0    0    0    0    0    0    0    1    0    0]
 [   5    0    0    0    0    1    0    0    0    0    0    0    4    3    0    0    0   43    1    9    0    0    0    0    0    0    0]
 [   2    0    0    0    0    1    0    0    0    0    0    0    2    1    5    0    0    0   13    4    0    0    0    0    0    0    0]
 [   1    0    0    0    0    4    0    0    0    0    0    0    8    6    0    0    0    9    2   61    0    0    0    0    0    0    0]
 [   1    0    0    0    0    0    0    0    0    0    0    0    0    0    0    0    0    0    0    0  229    0    0    0    0    0    0]
 [   0    0    0    0    0    0    0    1    0    0    0    0    0    0    0    0    0    0    0    0    0   48    0    0    0    0    0]
 [   1    0    1    0    0    0    0    0    0    0    0    0    0    0    0    0    0    0    0    0    0    0  556    0    0    0    0]
 [   2    0    0    0    0    0    0    0    0    0    0    0    0    0    0    0    0    0    0    0    0    0    0    7    0    0    0]
 [   1    0    0    0    0    0    0    0    0    0    0    0    0    0    0    0    0    0    0    0    0    0    0    0    7    0    0]
 [   0    0    0    0    0    0    0    0    0    0    0    0    0    0    0    0    0    0    0    0    0    0    0    0    0   13    0]
 [   1    0    0    0    0    0    0    0    0    0    0    0    0    0    0    0    0    0    0    0    0    0    0    0    0    0   44]]

