Classifier: MLPClassifier
Params: {'activation': 'relu', 'alpha': 0.0001, 'batch_size': 'auto', 'beta_1': 0.9, 'beta_2': 0.999, 'early_stopping': False, 'epsilon': 1e-08, 'hidden_layer_sizes': (100,), 'learning_rate': 'constant', 'learning_rate_init': 0.001, 'max_iter': 200, 'momentum': 0.9, 'nesterovs_momentum': True, 'power_t': 0.5, 'random_state': None, 'shuffle': True, 'solver': 'adam', 'tol': 0.0001, 'validation_fraction': 0.1, 'verbose': False, 'warm_start': False}

Labels: None

Training accuracy: 0.9881743549648163
Training confusion matrix:
[[14665     3     1     1     0     2     0     0     0     0     0     2     0     0     6     1     3     0     3     0     2     0     0     6     0     0     0]
 [   13   218     0     0     0     0     0     0     0     0     0     0     0     0     0     0     0     0     0     0     0     0     0     0     0     0     0]
 [    1     0   287     0     0     0     0     0     0     0     0     0     0     0     0     0     0     0     0     0     0     0     0     0     0     0     0]
 [   20     0     0   177     0     0     0     0     0     0     0     0     0     0     0     0     0     0     0     0     0     0     0     0     0     0     0]
 [    0     0     0     0   186     0     0     0     0     0     0     0     0     0     0     0     0     0     0     0     0     0     0     0     0     0     0]
 [    0     0     0     0     0    81     0     0     0     0     0     0    11     9     4     0     0     3     5    36     0     0     0     0     0     0     0]
 [    0     0     0     0     0     0   115     0     0     0     0     0     0     0     0     0     0     0     0     0     0     0     0     0     0     0     0]
 [    1     0     0     0     0     0     0  1011     0     0     0     0     0     0     0     0     0     0     0     0     1     0     0     0     0     0     0]
 [    0     0     0     0     0     0     0     0   171     0     0     0     0     0     0     0     0     0     0     0     0     0     0     0     0     0     0]
 [    1     0     0     0     0     0     0     0     0  6851     0     0     0     0     0     0     0     0     0     0     0     0     0     0     0     0     0]
 [    1     0     0     0     0     0     0     0     0     0   207     0     0     0     0     0     0     0     0     0     0     0     0     0     0     0     0]
 [    5     0     0     0     0     0     0     0     0     0     0  1180     0     0     0     0     0     0     0     0     0     0     0     0     0     0     0]
 [    0     0     0     0     0     0     0     0     0     0     0     0   104     2     0     0     0     0     0     2     0     0     0     0     0     0     0]
 [    0     0     0     0     0     1     0     0     0     0     0     0     4    76     1     0     0     2     0     1     0     0     0     0     0     0     0]
 [    2     0     0     0     0     0     0     0     0     0     0     0     1     1   310     0     0     0    10     6     0     0     0     0     0     0     0]
 [    0     0     0     0     0     0     0     0     0     0     0     0     0     0     0    52     0     0     0     0     0     0     0     0     0     0     0]
 [   21     0     0     0     0     0     0     0     0     0     0     0     0     0     0     0   377     0     0     0     0     0     0     0     0     0     0]
 [    0     0     0     0     0     4     0     0     0     0     0     0    18     8     1     0     0   202     0    53     0     0     0     0     0     0     0]
 [    2     0     0     0     0     0     0     0     0     0     0     0     0     1     7     0     0     2   114     4     0     0     0     0     0     0     0]
 [    0     0     0     0     0     3     0     0     0     0     0     0    31     7     1     0     0    18     3   312     0     0     0     0     0     0     0]
 [    1     0     0     0     0     0     0     0     0     0     0     0     0     0     0     0     0     0     0     0  1017     0     0     0     0     0     0]
 [    0     0     0     0     0     0     0     0     0     0     0     0     0     0     0     0     0     0     0     0     0   221     0     0     0     0     0]
 [    0     0     0     0     0     0     0     0     0     0     0     0     0     0     0     0     0     0     0     0     0     0  2088     0     0     0     0]
 [    4     0     0     0     0     0     0     0     0     0     0     0     0     0     0     0     0     0     0     0     0     0     0    32     0     0     0]
 [    0     0     0     0     0     0     0     0     0     0     0     0     0     0     0     0     0     0     0     0     0     0     0     0    30     0     0]
 [    0     0     0     0     0     0     0     0     0     0     0     0     0     0     0     0     0     0     0     0     0     0     0     0     0    62     0]
 [    0     0     0     0     0     0     0     0     0     0     0     0     0     0     0     0     0     0     0     0     0     0     0     0     0     0   187]]

Accuracy: 0.9773260359655981

Precision: [0.9878 0.9231 1.0000 0.9302 1.0000 0.9231 1.0000 0.9956 1.0000 1.0000 1.0000 0.9897 0.5000 0.5294 0.8451 0.9412 0.9550 0.7857 0.5312 0.7143 0.9871 0.9796 0.9982 0.8889 0.8750 1.0000 0.9574]
Mean: 0.8976876496804732
Std: 0.1506696739902603

Recall: [0.9921 0.8955 0.9722 0.8511 1.0000 0.5581 1.0000 0.9784 0.9811 0.9982 0.9836 0.9863 0.8148 0.7826 0.8824 1.0000 0.9217 0.6667 0.6071 0.6593 1.0000 0.9796 0.9964 0.8889 0.8750 1.0000 1.0000]
Mean: 0.8989373387539369
Std: 0.13138839083499287

F1 score: [0.9899 0.9091 0.9859 0.8889 1.0000 0.6957 1.0000 0.9870 0.9905 0.9991 0.9917 0.9880 0.6197 0.6316 0.8633 0.9697 0.9381 0.7213 0.5667 0.6857 0.9935 0.9796 0.9973 0.8889 0.8750 1.0000 0.9783]
Mean: 0.8938650505320109
Std: 0.13700295875215335

Cohen Kappa score: 0.9682037654962102
Confusion matrix:
[[3630    5    0    3    0    1    0    0    0    0    0    3    0    0    4    1    5    0    2    0    1    1    0    1    0    0    2]
 [   7   60    0    0    0    0    0    0    0    0    0    0    0    0    0    0    0    0    0    0    0    0    0    0    0    0    0]
 [   2    0   70    0    0    0    0    0    0    0    0    0    0    0    0    0    0    0    0    0    0    0    0    0    0    0    0]
 [   7    0    0   40    0    0    0    0    0    0    0    0    0    0    0    0    0    0    0    0    0    0    0    0    0    0    0]
 [   0    0    0    0   66    0    0    0    0    0    0    0    0    0    0    0    0    0    0    0    0    0    0    0    0    0    0]
 [   1    0    0    0    0   24    0    0    0    0    0    0    2    3    3    0    0    3    1    6    0    0    0    0    0    0    0]
 [   0    0    0    0    0    0   36    0    0    0    0    0    0    0    0    0    0    0    0    0    0    0    0    0    0    0    0]
 [   3    0    0    0    0    0    0  227    0    0    0    0    0    0    0    0    0    0    0    0    2    0    0    0    0    0    0]
 [   0    0    0    0    0    0    0    0   52    0    0    0    0    0    0    0    0    0    0    0    0    0    1    0    0    0    0]
 [   3    0    0    0    0    0    0    0    0 1697    0    0    0    0    0    0    0    0    0    0    0    0    0    0    0    0    0]
 [   1    0    0    0    0    0    0    0    0    0   60    0    0    0    0    0    0    0    0    0    0    0    0    0    0    0    0]
 [   4    0    0    0    0    0    0    0    0    0    0  288    0    0    0    0    0    0    0    0    0    0    0    0    0    0    0]
 [   0    0    0    0    0    0    0    0    0    0    0    0   22    2    0    0    0    1    0    2    0    0    0    0    0    0    0]
 [   0    0    0    0    0    0    0    0    0    0    0    0    3   18    0    0    0    0    0    2    0    0    0    0    0    0    0]
 [   1    0    0    0    0    0    0    0    0    0    0    0    1    0   60    0    0    0    6    0    0    0    0    0    0    0    0]
 [   0    0    0    0    0    0    0    0    0    0    0    0    0    0    0   16    0    0    0    0    0    0    0    0    0    0    0]
 [   8    0    0    0    0    0    0    0    0    0    0    0    0    0    0    0  106    0    0    0    0    0    0    0    1    0    0]
 [   2    0    0    0    0    0    0    0    0    0    0    0    3    3    0    0    0   44    2   12    0    0    0    0    0    0    0]
 [   2    0    0    0    0    0    0    0    0    0    0    0    2    1    4    0    0    0   17    2    0    0    0    0    0    0    0]
 [   0    0    0    0    0    1    0    0    0    0    0    0   11    7    0    0    0    8    4   60    0    0    0    0    0    0    0]
 [   0    0    0    0    0    0    0    0    0    0    0    0    0    0    0    0    0    0    0    0  230    0    0    0    0    0    0]
 [   0    0    0    0    0    0    0    1    0    0    0    0    0    0    0    0    0    0    0    0    0   48    0    0    0    0    0]
 [   2    0    0    0    0    0    0    0    0    0    0    0    0    0    0    0    0    0    0    0    0    0  556    0    0    0    0]
 [   1    0    0    0    0    0    0    0    0    0    0    0    0    0    0    0    0    0    0    0    0    0    0    8    0    0    0]
 [   1    0    0    0    0    0    0    0    0    0    0    0    0    0    0    0    0    0    0    0    0    0    0    0    7    0    0]
 [   0    0    0    0    0    0    0    0    0    0    0    0    0    0    0    0    0    0    0    0    0    0    0    0    0   13    0]
 [   0    0    0    0    0    0    0    0    0    0    0    0    0    0    0    0    0    0    0    0    0    0    0    0    0    0   45]]

