Classifier: MultinomialNB
Params: {'alpha': 1.0, 'class_prior': None, 'fit_prior': True}

Labels: None

Training accuracy: 0.9144188167839458
Training confusion matrix:
[[13489   107    16    71     5     0     4   260     0    63   225     9     0     0   137     0    48    57     2   115    44     4    16    17     1     0     5]
 [    8   223     0     0     0     0     0     0     0     0     0     0     0     0     0     0     0     0     0     0     0     0     0     0     0     0     0]
 [    1     1   239     0     5     0     6    31     0     0     0     0     0     0     0     0     1     0     0     0     4     0     0     0     0     0     0]
 [   62     0     0   129     0     0     0     0     0     0     0     0     0     0     0     0     6     0     0     0     0     0     0     0     0     0     0]
 [    0     0     0     0   177     0     7     0     0     0     0     0     0     0     0     0     0     0     0     0     1     0     1     0     0     0     0]
 [    1     0     0     0     0     1     0     0     0     0     0     0     0     0     1     0     0     0     0   146     0     0     0     0     0     0     0]
 [    0     0     0     0     0     0   114     0     0     0     0     0     0     0     0     0     1     0     0     0     0     0     0     0     0     0     0]
 [    2     0     1     0     7     0     0   997     0     0     0     0     0     0     0     0     0     0     0     0     6     0     0     0     0     0     0]
 [    1     0     0     0     0     0     1     1   168     0     0     0     0     0     0     0     0     0     0     0     0     0     0     0     0     0     0]
 [  128     0     0     3     0     0     0     1     0  6692     1     1     0     0     5     0     4     0     0     0     0     0    17     0     0     0     0]
 [   20     0     0     0     0     0     0     0     0     0   188     0     0     0     0     0     0     0     0     0     0     0     0     0     0     0     0]
 [   23     0     0     0     0     0     0     0     0     2     0  1160     0     0     0     0     0     0     0     0     0     0     0     0     0     0     0]
 [    0     0     0     0     0     0     0     0     0     0     0     0     2     0     0     0     0     0     0   106     0     0     0     0     0     0     0]
 [    0     0     0     0     0     0     0     0     0     0     0     0     0     0     1     0     0     0     0    84     0     0     0     0     0     0     0]
 [    2     0     0     0     0     0     0     0     0     0     0     0     0     0   196     0     0    10     0   119     0     0     3     0     0     0     0]
 [    0     0     1     0     2     0     3     0     0     0     0     0     0     0     0    35     1     0     0     0     1     0     9     0     0     0     0]
 [   45     0     0     0     3     0     1     0     0     0     0     0     0     0     0     0   349     0     0     0     0     0     0     0     0     0     0]
 [    8     0     0     0     0     0     0     0     0     0     0     0     0     0     4     0     0    54     0   220     0     0     0     0     0     0     0]
 [    1     0     0     0     0     0     0     0     0     0     0     0     0     0    21     0     0    12     2    94     0     0     0     0     0     0     0]
 [    2     0     0     0     0     0     0     0     0     0     0     0     0     0     3     0     0     9     0   355     1     0     5     0     0     0     0]
 [    3     0     0     0     0     0     0     9     0     0     0     0     0     0     0     0     0     0     0     0  1006     0     0     0     0     0     0]
 [    1     0     1     0     0     0     0    11     0     0     0     0     0     0     0     0     0     0     0     0    34   173     1     0     0     0     0]
 [    3     0     1     0     2     0     6     2     1     0     0     0     0     0     0     0     0     0     0     0     0     0  2073     0     0     0     0]
 [    6    18     0     0     0     0     0     0     0     0     0     0     0     0     0     0     0     0     0     0     0     0     0    12     0     0     0]
 [    3     0     0     0     0     0     0     0     0     0     0     0     0     0     0     0     0     0     0     0     0     0     0     0    27     0     0]
 [    0     0     2     0     5     0     0    15     0     0     0     0     0     0     0     0     0     0     0     0     4     0     0     0     0    33     3]
 [    0     0     2     0     1     0     1     6     0     0     0     0     0     0     0     0     0     0     0     0     2     0     0     0     0     0   175]]

Accuracy: 0.9136043784206411

Precision: [0.9697 0.7111 0.9333 0.6491 0.9524 0.0000 0.7556 0.7290 1.0000 0.9898 0.4904 0.9861 0.0000 0.0000 0.4945 1.0000 0.8929 0.5000 0.0000 0.2901 0.8692 0.9474 0.9771 0.6667 1.0000 1.0000 0.9545]
Mean: 0.694774081266356
Std: 0.34675831916116273

Recall: [0.9194 0.9552 0.7778 0.7872 0.9091 0.0000 0.9444 0.9741 0.9811 0.9700 0.8361 0.9692 0.0000 0.0000 0.6618 0.7500 0.8696 0.2576 0.0000 0.9341 0.9826 0.7347 0.9946 0.4444 0.8750 0.4615 0.9333]
Mean: 0.7008472473781192
Std: 0.34247420290264347

F1 score: [0.9439 0.8153 0.8485 0.7115 0.9302 0.0000 0.8395 0.8339 0.9905 0.9798 0.6182 0.9775 0.0000 0.0000 0.5660 0.8571 0.8811 0.3400 0.0000 0.4427 0.9224 0.8276 0.9858 0.5333 0.9333 0.6316 0.9438]
Mean: 0.6797674590689046
Std: 0.3303034557877434

Cohen Kappa score: 0.8809924572012077
Confusion matrix:
[[3364   23    3   19    0    0    1   65    0   17   53    3    0    0   41    0    9   12    0   25   16    2    4    2    0    0    0]
 [   3   64    0    0    0    0    0    0    0    0    0    0    0    0    0    0    0    0    0    0    0    0    0    0    0    0    0]
 [   3    0   56    0    1    0    1   10    0    0    0    0    0    0    0    0    0    0    0    0    1    0    0    0    0    0    0]
 [  10    0    0   37    0    0    0    0    0    0    0    0    0    0    0    0    0    0    0    0    0    0    0    0    0    0    0]
 [   0    0    0    0   60    0    5    0    0    0    0    0    0    0    0    0    0    0    0    0    0    0    1    0    0    0    0]
 [   0    0    0    0    0    0    0    0    0    0    0    0    0    0    1    0    0    0    0   42    0    0    0    0    0    0    0]
 [   0    0    0    0    0    0   34    0    0    0    0    0    0    0    0    0    2    0    0    0    0    0    0    0    0    0    0]
 [   0    0    0    0    0    0    1  226    0    0    0    0    0    0    0    0    0    0    0    0    5    0    0    0    0    0    0]
 [   0    0    0    0    0    0    0    0   52    0    0    0    0    0    0    0    0    0    0    0    0    0    1    0    0    0    0]
 [  46    0    0    1    0    0    0    0    0 1649    0    1    0    0    0    0    0    0    0    0    0    0    3    0    0    0    0]
 [  10    0    0    0    0    0    0    0    0    0   51    0    0    0    0    0    0    0    0    0    0    0    0    0    0    0    0]
 [   9    0    0    0    0    0    0    0    0    0    0  283    0    0    0    0    0    0    0    0    0    0    0    0    0    0    0]
 [   0    0    0    0    0    0    0    0    0    0    0    0    0    0    0    0    0    0    0   27    0    0    0    0    0    0    0]
 [   0    0    0    0    0    0    0    0    0    0    0    0    0    0    0    0    0    0    0   23    0    0    0    0    0    0    0]
 [   1    0    0    0    0    0    0    0    0    0    0    0    0    0   45    0    0    0    0   22    0    0    0    0    0    0    0]
 [   0    0    0    0    0    0    1    0    0    0    0    0    0    0    0   12    0    0    0    0    0    0    3    0    0    0    0]
 [  13    0    0    0    1    0    1    0    0    0    0    0    0    0    0    0  100    0    0    0    0    0    0    0    0    0    0]
 [   1    0    0    0    0    0    0    0    0    0    0    0    0    0    0    0    0   17    0   48    0    0    0    0    0    0    0]
 [   2    0    0    0    0    0    0    0    0    0    0    0    0    0    3    0    0    2    0   21    0    0    0    0    0    0    0]
 [   2    0    0    0    0    0    0    0    0    0    0    0    0    0    1    0    0    3    0   85    0    0    0    0    0    0    0]
 [   1    0    0    0    0    0    0    3    0    0    0    0    0    0    0    0    0    0    0    0  226    0    0    0    0    0    0]
 [   0    0    0    0    0    0    0    3    0    0    0    0    0    0    0    0    0    0    0    0   10   36    0    0    0    0    0]
 [   1    0    0    0    1    0    1    0    0    0    0    0    0    0    0    0    0    0    0    0    0    0  555    0    0    0    0]
 [   2    3    0    0    0    0    0    0    0    0    0    0    0    0    0    0    0    0    0    0    0    0    0    4    0    0    0]
 [   1    0    0    0    0    0    0    0    0    0    0    0    0    0    0    0    0    0    0    0    0    0    0    0    7    0    0]
 [   0    0    0    0    0    0    0    2    0    0    0    0    0    0    0    0    1    0    0    0    1    0    1    0    0    6    2]
 [   0    0    1    0    0    0    0    1    0    0    0    0    0    0    0    0    0    0    0    0    1    0    0    0    0    0   42]]

