Classifier: RandomForestClassifier
Params: {'bootstrap': True, 'class_weight': None, 'criterion': 'gini', 'max_depth': None, 'max_features': 'auto', 'max_leaf_nodes': None, 'min_impurity_decrease': 0.0, 'min_impurity_split': None, 'min_samples_leaf': 1, 'min_samples_split': 2, 'min_weight_fraction_leaf': 0.0, 'n_estimators': 100, 'n_jobs': 1, 'oob_score': False, 'random_state': None, 'verbose': 0, 'warm_start': False}

Labels: None

Training accuracy: 0.9924420119885327
Training confusion matrix:
[[14673     3     1     1     0     0     0     1     0     0     0     0     0     0     4     0     4     0     0     0     0     0     0     8     0     0     0]
 [    9   222     0     0     0     0     0     0     0     0     0     0     0     0     0     0     0     0     0     0     0     0     0     0     0     0     0]
 [    0     0   288     0     0     0     0     0     0     0     0     0     0     0     0     0     0     0     0     0     0     0     0     0     0     0     0]
 [   18     0     0   179     0     0     0     0     0     0     0     0     0     0     0     0     0     0     0     0     0     0     0     0     0     0     0]
 [    0     0     0     0   186     0     0     0     0     0     0     0     0     0     0     0     0     0     0     0     0     0     0     0     0     0     0]
 [    2     0     0     0     0   137     0     0     0     0     0     0     0     1     0     0     0     2     0     7     0     0     0     0     0     0     0]
 [    0     0     0     0     0     0   115     0     0     0     0     0     0     0     0     0     0     0     0     0     0     0     0     0     0     0     0]
 [    0     0     0     0     0     0     0  1012     0     0     0     0     0     0     0     0     0     0     0     0     1     0     0     0     0     0     0]
 [    0     0     0     0     0     0     0     0   171     0     0     0     0     0     0     0     0     0     0     0     0     0     0     0     0     0     0]
 [    1     0     0     0     0     0     0     0     0  6851     0     0     0     0     0     0     0     0     0     0     0     0     0     0     0     0     0]
 [    1     0     0     0     0     0     0     0     0     0   207     0     0     0     0     0     0     0     0     0     0     0     0     0     0     0     0]
 [    7     0     0     0     0     0     0     0     0     0     0  1178     0     0     0     0     0     0     0     0     0     0     0     0     0     0     0]
 [    0     0     0     0     0     1     0     0     0     0     0     0    92     1     0     0     0     6     0     8     0     0     0     0     0     0     0]
 [    0     0     0     0     0     3     0     0     0     0     0     0     0    79     0     0     0     2     0     1     0     0     0     0     0     0     0]
 [    2     0     0     0     0     2     0     0     0     0     0     0     0     1   319     0     0     1     4     1     0     0     0     0     0     0     0]
 [    0     0     0     0     0     0     0     0     0     0     0     0     0     0     0    52     0     0     0     0     0     0     0     0     0     0     0]
 [   14     0     0     0     0     0     0     0     0     0     0     0     0     0     0     0   384     0     0     0     0     0     0     0     0     0     0]
 [    0     0     0     0     0     1     0     0     0     0     0     0     1     1     0     0     0   264     0    19     0     0     0     0     0     0     0]
 [    4     0     0     0     0     1     0     0     0     0     0     0     0     1    10     0     0     2   106     6     0     0     0     0     0     0     0]
 [    0     0     0     0     0    11     0     0     0     0     0     0    17     4     4     0     0    31     0   308     0     0     0     0     0     0     0]
 [    1     0     0     0     0     0     0     0     0     0     0     0     0     0     0     0     0     0     0     0  1017     0     0     0     0     0     0]
 [    0     0     0     0     0     0     0     0     0     0     0     0     0     0     0     0     0     0     0     0     0   221     0     0     0     0     0]
 [    0     0     0     0     0     0     0     0     0     0     0     0     0     0     0     0     0     0     0     0     0     0  2088     0     0     0     0]
 [    0     0     0     0     0     0     0     0     0     0     0     0     0     0     0     0     0     0     0     0     0     0     0    36     0     0     0]
 [    0     0     0     0     0     0     0     0     0     0     0     0     0     0     0     0     0     0     0     0     0     0     0     0    30     0     0]
 [    0     0     0     0     0     0     0     0     0     0     0     0     0     0     0     0     0     0     0     0     0     0     0     0     0    62     0]
 [    0     0     0     0     0     0     0     0     0     0     0     0     0     0     0     0     0     0     0     0     0     0     0     0     0     0   187]]

Accuracy: 0.9708105290591608

Precision: [0.9792 0.9219 1.0000 0.9268 0.9412 0.7812 0.9706 0.9740 1.0000 0.9982 1.0000 0.9965 0.5667 0.5000 0.8472 0.8889 0.9623 0.6714 0.6667 0.7191 0.9383 1.0000 0.9982 0.8750 1.0000 1.0000 0.9545]
Mean: 0.8917746702962696
Std: 0.14179804867848878

Recall: [0.9918 0.8806 0.8889 0.8085 0.9697 0.5814 0.9167 0.9698 0.9811 0.9959 0.9344 0.9623 0.6296 0.5652 0.8971 1.0000 0.8870 0.7121 0.5000 0.7033 0.9913 0.9184 0.9982 0.7778 0.7500 0.8462 0.9333]
Mean: 0.8515029035575655
Std: 0.14596765566766282

F1 score: [0.9855 0.9008 0.9412 0.8636 0.9552 0.6667 0.9429 0.9719 0.9905 0.9971 0.9661 0.9791 0.5965 0.5306 0.8714 0.9412 0.9231 0.6912 0.5714 0.7111 0.9641 0.9574 0.9982 0.8235 0.8571 0.9167 0.9438]
Mean: 0.8688081451391776
Std: 0.13912092171267965

Cohen Kappa score: 0.9589576197723031
Confusion matrix:
[[3629    5    0    2    0    0    0    1    0    3    0    1    0    0    5    1    3    1    1    0    4    0    0    1    0    0    2]
 [   8   59    0    0    0    0    0    0    0    0    0    0    0    0    0    0    0    0    0    0    0    0    0    0    0    0    0]
 [   4    0   64    0    1    0    0    1    0    0    0    0    0    0    0    0    0    0    0    0    2    0    0    0    0    0    0]
 [   9    0    0   38    0    0    0    0    0    0    0    0    0    0    0    0    0    0    0    0    0    0    0    0    0    0    0]
 [   0    0    0    0   64    0    1    0    0    0    0    0    0    0    0    0    0    0    0    0    1    0    0    0    0    0    0]
 [   1    0    0    0    0   25    0    0    0    0    0    0    2    1    2    0    0    7    0    5    0    0    0    0    0    0    0]
 [   0    0    0    0    2    0   33    1    0    0    0    0    0    0    0    0    0    0    0    0    0    0    0    0    0    0    0]
 [   2    0    0    0    0    0    0  225    0    0    0    0    0    0    0    0    0    0    0    0    5    0    0    0    0    0    0]
 [   0    0    0    0    0    0    0    0   52    0    0    0    0    0    0    0    0    0    0    0    0    0    1    0    0    0    0]
 [   7    0    0    0    0    0    0    0    0 1693    0    0    0    0    0    0    0    0    0    0    0    0    0    0    0    0    0]
 [   4    0    0    0    0    0    0    0    0    0   57    0    0    0    0    0    0    0    0    0    0    0    0    0    0    0    0]
 [  11    0    0    0    0    0    0    0    0    0    0  281    0    0    0    0    0    0    0    0    0    0    0    0    0    0    0]
 [   0    0    0    0    0    2    0    0    0    0    0    0   17    4    0    0    0    1    0    3    0    0    0    0    0    0    0]
 [   0    0    0    0    0    2    0    0    0    0    0    0    2   13    0    0    0    3    0    3    0    0    0    0    0    0    0]
 [   2    0    0    0    0    0    0    0    0    0    0    0    1    0   61    0    0    0    4    0    0    0    0    0    0    0    0]
 [   0    0    0    0    0    0    0    0    0    0    0    0    0    0    0   16    0    0    0    0    0    0    0    0    0    0    0]
 [  11    0    0    1    0    0    0    1    0    0    0    0    0    0    0    0  102    0    0    0    0    0    0    0    0    0    0]
 [   3    0    0    0    0    0    0    0    0    0    0    0    1    3    1    0    0   47    2    9    0    0    0    0    0    0    0]
 [   2    0    0    0    0    2    0    0    0    0    0    0    2    1    2    0    0    0   14    5    0    0    0    0    0    0    0]
 [   5    0    0    0    0    1    0    0    0    0    0    0    5    4    1    0    0   11    0   64    0    0    0    0    0    0    0]
 [   2    0    0    0    0    0    0    0    0    0    0    0    0    0    0    0    0    0    0    0  228    0    0    0    0    0    0]
 [   0    0    0    0    0    0    0    2    0    0    0    0    0    0    0    0    0    0    0    0    2   45    0    0    0    0    0]
 [   1    0    0    0    0    0    0    0    0    0    0    0    0    0    0    0    0    0    0    0    0    0  557    0    0    0    0]
 [   2    0    0    0    0    0    0    0    0    0    0    0    0    0    0    0    0    0    0    0    0    0    0    7    0    0    0]
 [   2    0    0    0    0    0    0    0    0    0    0    0    0    0    0    0    0    0    0    0    0    0    0    0    6    0    0]
 [   0    0    0    0    0    0    0    0    0    0    0    0    0    0    0    1    1    0    0    0    0    0    0    0    0   11    0]
 [   1    0    0    0    1    0    0    0    0    0    0    0    0    0    0    0    0    0    0    0    1    0    0    0    0    0   42]]

