Classifier: GradientBoostingClassifier
Params: {'criterion': 'friedman_mse', 'init': None, 'learning_rate': 0.1, 'loss': 'deviance', 'max_depth': 3, 'max_features': None, 'max_leaf_nodes': None, 'min_impurity_decrease': 0.0, 'min_impurity_split': None, 'min_samples_leaf': 1, 'min_samples_split': 2, 'min_weight_fraction_leaf': 0.0, 'n_estimators': 100, 'presort': 'auto', 'random_state': None, 'subsample': 1.0, 'verbose': 0, 'warm_start': False}

Labels: None

Training accuracy: 0.9980751208217719
Training confusion matrix:
[[133853      0      0      0      0      0      0      3      0     15      0      0      0      0      0      0     68      0      0      0      1      0      1      0      0      0      0]
 [     2   1507      0      0      0      0      0      0      0      0      0      0      0      0      0      0      0      0      0      0      0      0      0      0      0      0      0]
 [     0      0    904      0      0      0      0      0      0      0      0      0      0      0      0      0      0      0      0      0      0      0      0      0      0      0      0]
 [     3      0      0   3844      0      0      0      0      0      0      0      0      0      0      0      0      1      0      0      0      0      0      0      0      0      0      0]
 [     1      0      0      0    191      0      0      0      0      0      0      0      0      0      0      0      0      0      0      0      0      0      0      0      0      0      0]
 [     0      0      0      0      0    492      0      0      0      0      0      0      2      3      2      0      0      0      0      3      0      0      0      0      0      0      0]
 [     0      0      0      0      0      0     98      0      0      0      0      0      0      0      0      0      0      0      0      0      0      0      0      0      0      0      0]
 [     1      0      0      0      0      0      0   1188      0      0      0      0      0      0      0      0      0      0      0      0      0      0      0      0      0      0      0]
 [     0      0      0      0      0      0      0      0    376      0      0      0      0      0      0      0      0      0      0      0      0      0      0      0      0      0      0]
 [    52      0      0      0      0      0      0      0      0  50095      0      0      0      0      0      0      0      0      0      0      0      0      0      0      0      0      0]
 [     0      0      0      0      0      0      0      0      0      0   3745      0      0      0      0      0      0      0      0      0      0      0      0      0      0      0      0]
 [    34      0      0      0      0      0      0      0      0      1      0   1508      0      0      0      0      0      0      0      0      0      0      0      0      0      0      0]
 [     0      0      0      0      0      2      0      0      0      0      0      0    177      0      0      0      0      5      0     25      0      0      0      0      0      0      0]
 [     0      0      0      0      0      0      0      0      0      0      0      0      1    404      0      0      0      1      0      0      0      0      0      0      0      0      0]
 [     5      0      0      0      0      3      0      0      0      0      0      0      1      0   2681      0      0      1     10      4      0      0      0      0      0      0      0]
 [     0      0      0      0      0      0      0      0      0      0      0      0      0      0      0     95      0      0      0      0      0      0      0      0      0      0      0]
 [    12      0      0      1      0      0      0      0      0      0      0      0      0      0      0      0   2435      0      0      0      0      0      0      0      0      0      0]
 [     0      0      0      0      0      5      0      0      0      0      0      0      4      3      1      0      0   1120      1     38      0      0      0      0      0      0      0]
 [     9      0      0      0      0      4      0      0      0      0      0      0      2      3      7      0      0      2    709      8      0      0      0      0      0      0      0]
 [     0      0      0      0      0     16      0      0      0      0      0      0      1     10      4      0      0     36      0   1098      0      0      0      0      0      0      0]
 [     1      0      0      0      0      0      0      0      0      0      0      0      0      0      0      0      0      0      0      0   5078      0      0      0      0      0      0]
 [     0      0      0      0      0      0      0      0      0      0      0      0      0      0      0      0      0      0      0      0      0    891      0      0      0      0      0]
 [     0      0      0      0      0      0      0      0      0      0      0      0      0      0      0      0      0      0      0      0      0      0   3169      0      0      0      0]
 [     0      0      0      0      0      0      0      0      0      0      0      0      0      0      0      0      0      0      0      0      0      0      0    464      0      0      0]
 [     0      0      0      0      0      0      0      0      0      0      0      0      0      0      0      0      0      0      0      0      0      0      0      0    572      0      0]
 [     0      0      0      0      0      0      0      0      0      0      0      0      0      0      0      0      0      0      0      0      0      0      0      0      0    134      0]
 [     0      0      0      0      0      0      0      0      0      0      0      0      0      0      0      0      0      0      0      0      0      0      0      0      0      0    429]]

Accuracy: 0.9970690518520561

Precision: [0.9988 0.9957 0.9962 0.9992 1.0000 0.9232 1.0000 0.9917 0.9973 0.9996 0.9989 0.9966 0.8140 0.9217 0.9890 1.0000 0.9740 0.9502 0.9641 0.9093 0.9992 0.9987 0.9984 0.9978 0.9983 1.0000 1.0000]
Mean: 0.9782186653430562
Std: 0.04161260320997457

Recall: [0.9990 0.9975 0.9975 0.9979 0.9816 0.9249 0.9928 0.9871 1.0000 0.9992 0.9989 0.9821 0.8028 0.9694 0.9827 0.9773 0.9959 0.9453 0.9389 0.9115 0.9977 0.9962 0.9994 0.9978 1.0000 0.9758 0.9928]
Mean: 0.9756311734563582
Std: 0.04144656163096408

F1 score: [0.9989 0.9966 0.9968 0.9986 0.9907 0.9241 0.9964 0.9894 0.9987 0.9994 0.9989 0.9893 0.8083 0.9450 0.9859 0.9885 0.9848 0.9478 0.9514 0.9104 0.9984 0.9974 0.9989 0.9978 0.9992 0.9878 0.9964]
Mean: 0.9768729379185386
Std: 0.040965818742412875

Cohen Kappa score: 0.9950487401026561
Confusion matrix:
[[125700      7      2      3      0      0      0      4      0     14      4      5      0      0      4      0     68      0      0      1      4      1      5      1      0      0      0]
 [     3   1606      0      0      0      0      0      1      0      0      0      0      0      0      0      0      0      0      0      0      0      0      0      0      0      0      0]
 [     1      0    783      0      0      0      0      0      0      1      0      0      0      0      0      0      0      0      0      0      0      0      0      0      0      0      0]
 [     5      0      0   3836      0      0      0      0      0      0      0      0      0      0      0      0      3      0      0      0      0      0      0      0      0      0      0]
 [     3      0      0      0    160      0      0      0      0      0      0      0      0      0      0      0      0      0      0      0      0      0      0      0      0      0      0]
 [     0      0      0      0      0    505      0      0      0      0      0      0      7     13      3      0      0      4      1     13      0      0      0      0      0      0      0]
 [     1      0      0      0      0      0    138      0      0      0      0      0      0      0      0      0      0      0      0      0      0      0      0      0      0      0      0]
 [    13      0      0      0      0      0      0   1073      0      1      0      0      0      0      0      0      0      0      0      0      0      0      0      0      0      0      0]
 [     0      0      0      0      0      0      0      0    372      0      0      0      0      0      0      0      0      0      0      0      0      0      0      0      0      0      0]
 [    46      0      0      0      0      0      0      0      0  58371      0      1      0      0      0      0      0      0      0      0      0      0      0      0      0      0      0]
 [     3      0      0      0      0      0      0      0      0      1   3642      0      0      0      0      0      0      0      0      0      0      0      0      0      0      0      0]
 [    28      0      0      0      0      0      0      0      0      4      0   1757      0      0      0      0      0      0      0      0      0      0      0      0      0      0      0]
 [     0      0      0      0      0      3      0      0      0      0      0      0    175      1      0      0      0      3      0     36      0      0      0      0      0      0      0]
 [     0      0      0      0      0      0      0      0      0      0      0      0      6    412      1      0      0      5      0      1      0      0      0      0      0      0      0]
 [    11      0      0      0      0      3      0      0      0      0      0      0      2      2   2617      0      0      0     19      9      0      0      0      0      0      0      0]
 [     2      0      0      0      0      0      0      0      0      0      0      0      0      0      0     86      0      0      0      0      0      0      0      0      0      0      0]
 [     9      0      0      0      0      0      0      0      0      1      0      0      0      0      0      0   2656      0      0      0      0      0      0      0      1      0      0]
 [     0      0      0      0      0      7      0      0      0      0      0      0      9      4      0      0      0   1107      2     42      0      0      0      0      0      0      0]
 [    11      0      0      0      0      6      0      0      0      0      0      0      0      3     18      0      0      2    753      9      0      0      0      0      0      0      0]
 [     4      0      0      0      0     23      0      0      0      0      0      0     16     12      3      0      0     44      6   1113      0      0      0      0      0      0      0]
 [     7      0      1      0      0      0      0      3      0      0      0      0      0      0      0      0      0      0      0      0   4714      0      0      0      0      0      0]
 [     3      0      0      0      0      0      0      0      0      0      0      0      0      0      0      0      0      0      0      0      0    777      0      0      0      0      0]
 [     1      0      0      0      0      0      0      0      1      0      0      0      0      0      0      0      0      0      0      0      0      0   3091      0      0      0      0]
 [     1      0      0      0      0      0      0      0      0      0      0      0      0      0      0      0      0      0      0      0      0      0      0    460      0      0      0]
 [     0      0      0      0      0      0      0      0      0      0      0      0      0      0      0      0      0      0      0      0      0      0      0      0    598      0      0]
 [     2      0      0      0      0      0      0      1      0      0      0      0      0      0      0      0      0      0      0      0      0      0      0      0      0    121      0]
 [     3      0      0      0      0      0      0      0      0      0      0      0      0      0      0      0      0      0      0      0      0      0      0      0      0      0    416]]

