Classifier: LinearSVC
Params: {'C': 1.0, 'class_weight': None, 'dual': True, 'fit_intercept': True, 'intercept_scaling': 1, 'loss': 'squared_hinge', 'max_iter': 1000, 'multi_class': 'ovr', 'penalty': 'l2', 'random_state': None, 'tol': 0.0001, 'verbose': 0}

Labels: None

Training accuracy: 0.9984656094378801
Training confusion matrix:
[[133869      0      1      1      0      0      0      3      0      0      0      0      0      0      0      0     65      0      0      0      0      0      1      0      1      0      0]
 [     0   1509      0      0      0      0      0      0      0      0      0      0      0      0      0      0      0      0      0      0      0      0      0      0      0      0      0]
 [     1      0    903      0      0      0      0      0      0      0      0      0      0      0      0      0      0      0      0      0      0      0      0      0      0      0      0]
 [     3      0      0   3845      0      0      0      0      0      0      0      0      0      0      0      0      0      0      0      0      0      0      0      0      0      0      0]
 [     0      0      0      0    192      0      0      0      0      0      0      0      0      0      0      0      0      0      0      0      0      0      0      0      0      0      0]
 [     0      0      0      0      0    469      0      0      0      0      0      0      5      4      4      0      0      1      2     17      0      0      0      0      0      0      0]
 [     0      0      0      0      0      0     98      0      0      0      0      0      0      0      0      0      0      0      0      0      0      0      0      0      0      0      0]
 [     0      0      0      0      0      0      0   1189      0      0      0      0      0      0      0      0      0      0      0      0      0      0      0      0      0      0      0]
 [     0      0      0      0      0      0      0      0    376      0      0      0      0      0      0      0      0      0      0      0      0      0      0      0      0      0      0]
 [     0      0      0      0      0      0      0      0      0  50147      0      0      0      0      0      0      0      0      0      0      0      0      0      0      0      0      0]
 [     0      0      0      0      0      0      0      0      0      0   3745      0      0      0      0      0      0      0      0      0      0      0      0      0      0      0      0]
 [     0      0      0      0      0      0      0      0      0      0      0   1543      0      0      0      0      0      0      0      0      0      0      0      0      0      0      0]
 [     0      0      0      0      0      1      0      0      0      0      0      0    173      1      0      0      0      3      0     31      0      0      0      0      0      0      0]
 [     0      0      0      0      0      2      0      0      0      0      0      0      8    394      0      0      0      1      1      0      0      0      0      0      0      0      0]
 [     0      0      0      0      0      0      0      0      0      0      0      0      0      0   2694      0      0      1      3      7      0      0      0      0      0      0      0]
 [     0      0      0      0      0      0      0      0      0      0      0      0      0      0      0     95      0      0      0      0      0      0      0      0      0      0      0]
 [     2      0      0      0      0      0      0      0      0      0      0      0      0      0      0      0   2446      0      0      0      0      0      0      0      0      0      0]
 [     0      0      0      0      0      7      0      0      0      0      0      0     12      7      1      0      0   1118      1     26      0      0      0      0      0      0      0]
 [     0      0      0      0      0      0      0      0      0      0      0      0      2      0     12      0      0      3    722      5      0      0      0      0      0      0      0]
 [     0      0      0      0      0     17      0      0      0      0      0      0      0     14      1      0      0     54      1   1078      0      0      0      0      0      0      0]
 [     1      0      0      0      0      0      0      0      0      0      0      0      0      0      0      0      0      0      0      0   5078      0      0      0      0      0      0]
 [     0      0      0      0      0      0      0      0      0      0      0      0      0      0      0      0      0      0      0      0      0    891      0      0      0      0      0]
 [     0      0      0      0      0      0      0      0      0      0      0      0      0      0      0      0      0      0      0      0      0      0   3169      0      0      0      0]
 [     0      0      0      0      0      0      0      0      0      0      0      0      0      0      0      0      0      0      0      0      0      0      0    464      0      0      0]
 [     0      0      0      0      0      0      0      0      0      0      0      0      0      0      0      0      0      0      0      0      0      0      0      0    572      0      0]
 [     0      0      0      0      0      0      0      0      0      0      0      0      0      0      0      0      0      0      0      0      0      0      0      0      0    134      0]
 [     0      0      0      0      0      0      0      0      0      0      0      0      0      0      0      0      0      0      0      0      0      0      0      0      0      0    429]]

Accuracy: 0.9975835756648612

Precision: [0.9996 0.9963 0.9962 0.9990 0.9815 0.9188 1.0000 0.9881 0.9973 0.9999 0.9995 0.9994 0.7678 0.9157 0.9865 1.0000 0.9765 0.9461 0.9820 0.8996 0.9992 1.0000 0.9997 1.0000 0.9983 1.0000 1.0000]
Mean: 0.9758080639658445
Std: 0.04959167973355064

Recall: [0.9993 0.9988 0.9975 0.9987 0.9755 0.9322 1.0000 0.9963 1.0000 0.9999 0.9995 1.0000 0.7431 0.9459 0.9876 0.9886 0.9955 0.9445 0.9501 0.9025 0.9979 0.9974 0.9997 0.9978 0.9967 0.9839 0.9928]
Mean: 0.9748745190348955
Std: 0.05192547202309526

F1 score: [0.9994 0.9975 0.9968 0.9988 0.9785 0.9255 1.0000 0.9922 0.9987 0.9999 0.9995 0.9997 0.7552 0.9306 0.9871 0.9943 0.9859 0.9453 0.9658 0.9011 0.9985 0.9987 0.9997 0.9989 0.9975 0.9919 0.9964]
Mean: 0.9753043706811801
Std: 0.05048081248876971

Cohen Kappa score: 0.9959190872074485
Confusion matrix:
[[125730      6      2      4      1      0      0      4      0      2      1      1      0      0      2      0     64      0      0      3      2      0      1      0      0      0      0]
 [     2   1608      0      0      0      0      0      0      0      0      0      0      0      0      0      0      0      0      0      0      0      0      0      0      0      0      0]
 [     2      0    783      0      0      0      0      0      0      0      0      0      0      0      0      0      0      0      0      0      0      0      0      0      0      0      0]
 [     5      0      0   3839      0      0      0      0      0      0      0      0      0      0      0      0      0      0      0      0      0      0      0      0      0      0      0]
 [     4      0      0      0    159      0      0      0      0      0      0      0      0      0      0      0      0      0      0      0      0      0      0      0      0      0      0]
 [     0      0      0      0      0    509      0      0      0      0      0      0      7      9      5      0      0      1      1     14      0      0      0      0      0      0      0]
 [     0      0      0      0      0      0    139      0      0      0      0      0      0      0      0      0      0      0      0      0      0      0      0      0      0      0      0]
 [     2      0      0      0      0      0      0   1083      0      0      0      0      0      0      0      0      0      0      0      0      2      0      0      0      0      0      0]
 [     0      0      0      0      0      0      0      0    372      0      0      0      0      0      0      0      0      0      0      0      0      0      0      0      0      0      0]
 [     6      0      0      0      0      0      0      0      0  58411      0      0      0      0      0      0      0      0      0      1      0      0      0      0      0      0      0]
 [     2      0      0      0      0      0      0      0      0      0   3644      0      0      0      0      0      0      0      0      0      0      0      0      0      0      0      0]
 [     0      0      0      0      0      0      0      0      0      0      0   1789      0      0      0      0      0      0      0      0      0      0      0      0      0      0      0]
 [     1      0      0      0      0      5      0      0      0      0      0      0    162      0      0      0      0      0      0     50      0      0      0      0      0      0      0]
 [     0      0      0      0      0      1      0      0      0      0      0      0     14    402      2      0      0      3      1      2      0      0      0      0      0      0      0]
 [     6      0      0      0      2      2      0      0      0      0      0      0      3      2   2630      0      0      0      4     14      0      0      0      0      0      0      0]
 [     1      0      0      0      0      0      0      0      0      0      0      0      0      0      0     87      0      0      0      0      0      0      0      0      0      0      0]
 [     4      0      0      0      0      0      0      6      0      0      0      0      1      0      0      0   2655      0      0      0      0      0      0      0      1      0      0]
 [     0      0      0      0      0      9      0      0      0      0      0      0     14      7      0      0      0   1106      2     33      0      0      0      0      0      0      0]
 [     0      0      0      0      0      5      0      0      0      1      0      0      0      1     24      0      0      3    762      6      0      0      0      0      0      0      0]
 [     2      0      0      0      0     23      0      0      0      0      1      0     10     18      3      0      0     56      6   1102      0      0      0      0      0      0      0]
 [     7      0      1      0      0      0      0      2      0      0      0      0      0      0      0      0      0      0      0      0   4715      0      0      0      0      0      0]
 [     2      0      0      0      0      0      0      0      0      0      0      0      0      0      0      0      0      0      0      0      0    778      0      0      0      0      0]
 [     0      0      0      0      0      0      0      0      1      0      0      0      0      0      0      0      0      0      0      0      0      0   3092      0      0      0      0]
 [     1      0      0      0      0      0      0      0      0      0      0      0      0      0      0      0      0      0      0      0      0      0      0    460      0      0      0]
 [     2      0      0      0      0      0      0      0      0      0      0      0      0      0      0      0      0      0      0      0      0      0      0      0    596      0      0]
 [     1      0      0      0      0      0      0      1      0      0      0      0      0      0      0      0      0      0      0      0      0      0      0      0      0    122      0]
 [     3      0      0      0      0      0      0      0      0      0      0      0      0      0      0      0      0      0      0      0      0      0      0      0      0      0    416]]

