Classifier: LogisticRegression
Params: {'C': 1.0, 'class_weight': None, 'dual': False, 'fit_intercept': True, 'intercept_scaling': 1, 'max_iter': 100, 'multi_class': 'ovr', 'n_jobs': 1, 'penalty': 'l2', 'random_state': None, 'solver': 'liblinear', 'tol': 0.0001, 'verbose': 0, 'warm_start': False}

Labels: None

Training accuracy: 0.9980934967566475
Training confusion matrix:
[[133850      2      2      1      0      0      0      6      0      2      1      0      0      0      0      0     66      0      0      0      4      1      3      0      2      0      1]
 [     2   1507      0      0      0      0      0      0      0      0      0      0      0      0      0      0      0      0      0      0      0      0      0      0      0      0      0]
 [     2      0    902      0      0      0      0      0      0      0      0      0      0      0      0      0      0      0      0      0      0      0      0      0      0      0      0]
 [     7      0      0   3841      0      0      0      0      0      0      0      0      0      0      0      0      0      0      0      0      0      0      0      0      0      0      0]
 [     0      0      0      0    192      0      0      0      0      0      0      0      0      0      0      0      0      0      0      0      0      0      0      0      0      0      0]
 [     0      0      0      0      0    469      0      0      0      0      0      0      5      3      3      0      0      1      3     18      0      0      0      0      0      0      0]
 [     2      0      0      0      0      0     96      0      0      0      0      0      0      0      0      0      0      0      0      0      0      0      0      0      0      0      0]
 [     5      0      1      0      0      0      0   1180      0      0      0      0      0      0      0      0      0      0      0      0      3      0      0      0      0      0      0]
 [     0      0      0      0      0      0      0      0    376      0      0      0      0      0      0      0      0      0      0      0      0      0      0      0      0      0      0]
 [     3      0      0      0      0      0      0      0      0  50143      0      0      0      0      0      0      1      0      0      0      0      0      0      0      0      0      0]
 [     1      0      0      0      0      0      0      0      0      0   3744      0      0      0      0      0      0      0      0      0      0      0      0      0      0      0      0]
 [     0      0      0      0      0      0      0      0      0      8      0   1535      0      0      0      0      0      0      0      0      0      0      0      0      0      0      0]
 [     0      0      0      0      0      2      0      0      0      0      0      0    168      5      0      0      0      4      0     30      0      0      0      0      0      0      0]
 [     0      0      0      0      0      2      0      0      0      0      0      0      4    393      1      0      0      4      2      0      0      0      0      0      0      0      0]
 [     0      0      0      0      0      3      0      0      0      0      0      0      0      0   2691      0      0      1      3      7      0      0      0      0      0      0      0]
 [     0      0      0      0      0      0      0      0      0      0      0      0      0      0      0     95      0      0      0      0      0      0      0      0      0      0      0]
 [     2      0      0      0      0      0      0      0      0      0      0      0      0      0      0      0   2446      0      0      0      0      0      0      0      0      0      0]
 [     0      0      0      0      0      7      0      0      0      0      0      0     11      5      1      0      0   1131      0     17      0      0      0      0      0      0      0]
 [     0      0      0      1      0      0      0      0      0      0      0      0      5      0     12      0      0      3    709     14      0      0      0      0      0      0      0]
 [     0      0      0      0      0     18      0      0      0      0      0      0      4     16      3      0      0     60      1   1063      0      0      0      0      0      0      0]
 [     1      0      0      0      0      0      0      0      0      0      0      0      0      0      0      0      0      0      0      0   5078      0      0      0      0      0      0]
 [     1      0      0      0      0      0      0      0      0      0      0      0      0      0      0      0      0      0      0      0      0    890      0      0      0      0      0]
 [     1      0      0      0      0      0      0      0      0      0      0      0      0      0      0      0      0      0      0      0      0      0   3168      0      0      0      0]
 [     0      0      0      0      0      0      0      0      0      0      0      0      0      0      0      0      0      0      0      0      0      0      0    464      0      0      0]
 [     1      0      0      0      0      0      0      0      0      0      0      0      0      0      0      0      0      0      0      0      0      0      0      0    571      0      0]
 [     3      0      0      0      0      0      0      0      0      0      0      0      0      0      0      0      0      0      0      0      0      0      0      0      0    131      0]
 [     1      0      0      0      0      0      0      0      0      0      0      0      0      0      0      0      0      0      0      0      0      0      0      0      0      0    428]]

Accuracy: 0.9973952231976736

Precision: [0.9993 0.9963 0.9962 0.9990 0.9937 0.9183 1.0000 0.9954 0.9973 0.9996 0.9997 1.0000 0.7793 0.9256 0.9858 1.0000 0.9765 0.9388 0.9807 0.9070 0.9983 0.9987 0.9984 1.0000 0.9983 1.0000 1.0000]
Mean: 0.9771159018538093
Std: 0.04729683925624092

Recall: [0.9992 0.9981 0.9975 0.9984 0.9632 0.9267 0.9640 0.9890 1.0000 0.9998 0.9992 0.9933 0.7615 0.9365 0.9872 0.9886 0.9981 0.9556 0.9489 0.8943 0.9981 0.9974 0.9994 0.9978 0.9967 0.9516 0.9928]
Mean: 0.9715933609229706
Std: 0.04936828021900232

F1 score: [0.9993 0.9972 0.9968 0.9987 0.9782 0.9225 0.9817 0.9922 0.9987 0.9997 0.9995 0.9966 0.7703 0.9310 0.9865 0.9943 0.9872 0.9471 0.9645 0.9006 0.9982 0.9981 0.9989 0.9989 0.9975 0.9752 0.9964]
Mean: 0.9742844920258155
Std: 0.04773959362705179

Cohen Kappa score: 0.9956004541082977
Confusion matrix:
[[125720      6      2      4      1      0      0      3      0     11      0      0      0      0      2      0     63      0      0      0      5      1      5      0      0      0      0]
 [     3   1607      0      0      0      0      0      0      0      0      0      0      0      0      0      0      0      0      0      0      0      0      0      0      0      0      0]
 [     2      0    783      0      0      0      0      0      0      0      0      0      0      0      0      0      0      0      0      0      0      0      0      0      0      0      0]
 [     6      0      0   3838      0      0      0      0      0      0      0      0      0      0      0      0      0      0      0      0      0      0      0      0      0      0      0]
 [     6      0      0      0    157      0      0      0      0      0      0      0      0      0      0      0      0      0      0      0      0      0      0      0      0      0      0]
 [     0      0      0      0      0    506      0      0      0      0      0      0      7      6      4      0      0      1      3     19      0      0      0      0      0      0      0]
 [     5      0      0      0      0      0    134      0      0      0      0      0      0      0      0      0      0      0      0      0      0      0      0      0      0      0      0]
 [     9      0      0      0      0      0      0   1075      0      0      0      0      0      0      0      0      0      0      0      0      3      0      0      0      0      0      0]
 [     0      0      0      0      0      0      0      0    372      0      0      0      0      0      0      0      0      0      0      0      0      0      0      0      0      0      0]
 [     7      0      0      0      0      0      0      0      0  58409      0      0      0      0      0      0      1      0      0      1      0      0      0      0      0      0      0]
 [     3      0      0      0      0      0      0      0      0      0   3643      0      0      0      0      0      0      0      0      0      0      0      0      0      0      0      0]
 [     0      0      0      0      0      0      0      0      0     12      0   1777      0      0      0      0      0      0      0      0      0      0      0      0      0      0      0]
 [     1      0      0      0      0      6      0      0      0      0      0      0    166      0      0      0      0      1      0     44      0      0      0      0      0      0      0]
 [     0      0      0      0      0      0      0      0      0      0      0      0     11    398      3      0      0      9      2      2      0      0      0      0      0      0      0]
 [    10      0      0      0      0      2      0      0      0      0      0      0      1      2   2629      0      0      1      5     13      0      0      0      0      0      0      0]
 [     1      0      0      0      0      0      0      0      0      0      0      0      0      0      0     87      0      0      0      0      0      0      0      0      0      0      0]
 [     4      0      0      0      0      0      0      0      0      0      0      0      0      0      0      0   2662      0      0      0      0      0      0      0      1      0      0]
 [     0      0      0      0      0      9      0      0      0      0      0      0     13      4      0      0      0   1119      2     24      0      0      0      0      0      0      0]
 [     1      0      0      0      0      2      0      0      0      0      0      0      0      0     26      0      0      3    761      9      0      0      0      0      0      0      0]
 [     3      0      0      0      0     26      0      0      0      0      1      0     15     20      3      0      0     58      3   1092      0      0      0      0      0      0      0]
 [     7      0      1      0      0      0      0      1      0      0      0      0      0      0      0      0      0      0      0      0   4716      0      0      0      0      0      0]
 [     2      0      0      0      0      0      0      0      0      0      0      0      0      0      0      0      0      0      0      0      0    778      0      0      0      0      0]
 [     1      0      0      0      0      0      0      0      1      0      0      0      0      0      0      0      0      0      0      0      0      0   3091      0      0      0      0]
 [     1      0      0      0      0      0      0      0      0      0      0      0      0      0      0      0      0      0      0      0      0      0      0    460      0      0      0]
 [     2      0      0      0      0      0      0      0      0      0      0      0      0      0      0      0      0      0      0      0      0      0      0      0    596      0      0]
 [     5      0      0      0      0      0      0      1      0      0      0      0      0      0      0      0      0      0      0      0      0      0      0      0      0    118      0]
 [     3      0      0      0      0      0      0      0      0      0      0      0      0      0      0      0      0      0      0      0      0      0      0      0      0      0    416]]

