Classifier: MultinomialNB
Params: {'alpha': 1.0, 'class_prior': None, 'fit_prior': True}

Labels: None

Training accuracy: 0.8153540123853801
Training confusion matrix:
[[110190   1158     13   3087     16      3      1    958      1    178   5116     22      0      0   1604      3   6903    623    228     83     13     14      7    193   3324      0    203]
 [     5   1504      0      0      0      0      0      0      0      0      0      0      0      0      0      0      0      0      0      0      0      0      0      0      0      0      0]
 [     1      0    890      0      2      0      0      7      0      0      0      0      0      0      0      0      1      0      0      0      2      1      0      0      0      0      0]
 [    18      0      0   3791      0      0      0      0      0      0      0      0      0      0      0      0     39      0      0      0      0      0      0      0      0      0      0]
 [     0      0     15      0    175      0      0      0      0      0      0      0      0      0      0      0      0      0      0      0      0      0      2      0      0      0      0]
 [     1      0      0      0      0    244      0      0      0      0      0      0      0      1     81      0      0     99      0     76      0      0      0      0      0      0      0]
 [     0      0      0      0      2      0     93      0      1      0      0      0      0      0      0      0      1      0      0      0      0      0      1      0      0      0      0]
 [     1      0     13      0      9      0      0   1155      0      0      0      0      0      0      0      0      1      0      0      0      9      0      0      0      0      0      1]
 [     0      0      1      0      0      0      1      0    371      0      0      0      0      0      0      0      0      0      0      0      0      0      3      0      0      0      0]
 [ 12430      0      0      0      1      0      0      1      0  36642      0   1047      0      0      6      0      1      0      1      0      1      0     15      0      0      1      1]
 [    22      0      0      0      0      0      0      0      0      0   3723      0      0      0      0      0      0      0      0      0      0      0      0      0      0      0      0]
 [   458      0      0      0      0      0      0      0      0      0      0   1085      0      0      0      0      0      0      0      0      0      0      0      0      0      0      0]
 [     0      0      0      0      0      0      0      0      0      0      0      0      0      1     40      0      0     32      0    136      0      0      0      0      0      0      0]
 [     1      0      0      0      0      0      0      0      0      0      0      0      0    209     61      0      0     55      0     80      0      0      0      0      0      0      0]
 [     1      0      0      0      0      5      0      2      0      0      0      0      0      0   2438      0      0    223      4     25      0      0      7      0      0      0      0]
 [     0      0      4      0      1      0      0      0      0      0      0      0      0      0      0     68      0      0      0      0      0      0     22      0      0      0      0]
 [   145      0      2      0      3      0      0      0      0      0      0      0      0      0      0      0   2298      0      0      0      0      0      0      0      0      0      0]
 [   121      0      0      0      0      1      0      1      0      0      0      0      0      1    177      0      0    735      0    136      0      0      0      0      0      0      0]
 [     1      0      0      0      0      1      0      0      0      0      0      0      0      3    339      0      0    198    169     33      0      0      0      0      0      0      0]
 [     8      0      0      0      0      0      0      0      0      0     24      0      0      0      5      0      0     22      0   1103      0      0      3      0      0      0      0]
 [     2      0      0      0      0      0      0     39      0      0      0      0      0      0      0      0      0      0      0      0   5032      0      6      0      0      0      0]
 [     1      0      1      0      0      0      0     21      0      0      0      0      0      0      0      0      0      0      0      0      0    867      1      0      0      0      0]
 [     1      0      6      0      4      0      1      1      2      0      0      0      0      0      0      0      0      0      0      0      0      0   3154      0      0      0      0]
 [     1      0      0      0      0      0      0      0      0      0     20      0      0      0      0      0      0      0      0      0      0      0      0    443      0      0      0]
 [     2      0      0      0      0      0      0      0      0      0      0      0      0      0      0      0      6      0      0      0      0      0      0      0    564      0      0]
 [     0      0      0      0      3      0      0      7      0      0      0      0      0      0      0      0      1      0      0      0      2      0      3      0      0    118      0]
 [     1      0      2      0      0      0      1      3      0      0      0      0      0      0      0      0      0      0      0      0      0      0      0      0      0      0    422]]

Accuracy: 0.8091576050754099

Precision: [0.8690 0.6152 0.9377 0.5579 0.7714 0.9754 0.9583 0.5639 0.9919 0.9962 0.4534 0.5906 0.0000 0.9489 0.4890 1.0000 0.2679 0.3722 0.3612 0.6586 0.9953 0.9832 0.9809 0.6827 0.1431 1.0000 0.6178]
Mean: 0.6956330592787778
Std: 0.2902388205782861

Recall: [0.8194 0.9932 0.9771 0.9865 0.8282 0.4359 0.9928 0.9779 0.9892 0.7316 0.9956 0.7105 0.0000 0.3929 0.8926 0.8182 0.9595 0.6268 0.1883 0.9607 0.9898 0.9782 0.9964 0.9523 0.9783 0.8952 0.9761]
Mean: 0.8164138292092683
Std: 0.2622556465860018

F1 score: [0.8435 0.7598 0.9570 0.7127 0.7988 0.6025 0.9753 0.7153 0.9906 0.8436 0.6231 0.6450 0.0000 0.5557 0.6318 0.9000 0.4189 0.4671 0.2475 0.7815 0.9926 0.9807 0.9886 0.7953 0.2497 0.9447 0.7567]
Mean: 0.7102984641252985
Std: 0.2523581950204604

Cohen Kappa score: 0.6966028159949027
Confusion matrix:
[[103097   1000     11   3003     13      3      0    740      0    161   4331     18      0      0   1622      0   6938    546    263     92     12     13      7    204   3501      0    248]
 [     8   1599      0      0      0      0      0      3      0      0      0      0      0      0      0      0      0      0      0      0      0      0      0      0      0      0      0]
 [     2      0    767      0      3      0      0     13      0      0      0      0      0      0      0      0      0      0      0      0      0      0      0      0      0      0      0]
 [    12      0      0   3792      0      0      0      0      0      0      0      0      0      0      0      0     40      0      0      0      0      0      0      0      0      0      0]
 [     0      0     20      0    135      0      3      3      0      0      0      0      0      0      0      0      0      0      0      0      1      0      1      0      0      0      0]
 [     0      0      0      0      0    238      0      0      0      0      0      0      0      5     99      0      0    123      0     81      0      0      0      0      0      0      0]
 [     0      0      0      0      1      0    138      0      0      0      0      0      0      0      0      0      0      0      0      0      0      0      0      0      0      0      0]
 [     1      0      5      0     11      0      0   1063      0      0      0      0      0      0      0      0      1      0      0      0      5      0      1      0      0      0      0]
 [     0      0      0      0      0      0      2      0    368      0      0      0      0      0      0      0      0      0      0      0      0      0      2      0      0      0      0]
 [ 14782      0      0      0      2      0      0      1      0  42738      0    863      0      0      6      0      1      0      0      0      2      0     23      0      0      0      0]
 [    16      0      0      0      0      0      0      0      0      0   3630      0      0      0      0      0      0      0      0      0      0      0      0      0      0      0      0]
 [   518      0      0      0      0      0      0      0      0      0      0   1271      0      0      0      0      0      0      0      0      0      0      0      0      0      0      0]
 [     0      0      0      0      0      0      0      0      0      0      0      0      0      0     32      0      0     42      0    144      0      0      0      0      0      0      0]
 [     0      0      0      0      0      0      0      0      0      0      0      0      0    167     91      0      0     68      0     99      0      0      0      0      0      0      0]
 [     6      0      0      0      1      1      0      0      0      0      0      0      0      0   2377      0      0    231      4     35      1      0      7      0      0      0      0]
 [     0      0      4      0      1      0      0      0      0      0      0      0      0      0      0     72      0      0      0      0      0      0     10      0      0      0      1]
 [   104      0      1      2      0      0      0      0      0      0      0      0      0      0      0      0   2559      0      0      0      0      0      0      0      1      0      0]
 [    82      0      0      0      0      0      0      0      0      0      0      0      0      2    224      0      0    734      0    129      0      0      0      0      0      0      0]
 [     1      0      0      0      0      1      0      0      0      0      0      0      0      2    407      0      0    212    151     28      0      0      0      0      0      0      0]
 [     4      0      0      0      0      1      0      0      0      0     23      0      0      0      3      0      0     16      0   1173      0      0      0      0      0      0      1]
 [     1      0      1      0      0      0      0     37      0      0      0      0      0      0      0      0      0      0      0      0   4677      0      6      0      0      0      3]
 [     0      0      1      0      1      0      0     13      0      0      0      0      0      0      0      0      0      0      0      0      0    763      2      0      0      0      0]
 [     0      0      3      0      3      0      1      1      3      0      0      0      0      0      0      0      0      0      0      0      0      0   3082      0      0      0      0]
 [     0      0      0      0      0      0      0      0      0      0     22      0      0      0      0      0      0      0      0      0      0      0      0    439      0      0      0]
 [     0      0      0      0      0      0      0      0      0      0      0      0      0      0      0      0     13      0      0      0      0      0      0      0    585      0      0]
 [     0      0      1      0      2      0      0      8      0      0      0      0      0      0      0      0      0      0      0      0      1      0      1      0      0    111      0]
 [     1      0      4      0      2      0      0      3      0      0      0      0      0      0      0      0      0      0      0      0      0      0      0      0      0      0    409]]

