Classifier: RandomForestClassifier
Params: {'bootstrap': True, 'class_weight': None, 'criterion': 'gini', 'max_depth': None, 'max_features': 'auto', 'max_leaf_nodes': None, 'min_impurity_decrease': 0.0, 'min_impurity_split': None, 'min_samples_leaf': 1, 'min_samples_split': 2, 'min_weight_fraction_leaf': 0.0, 'n_estimators': 100, 'n_jobs': 1, 'oob_score': False, 'random_state': None, 'verbose': 0, 'warm_start': False}

Labels: None

Training accuracy: 0.9990766092724968
Training confusion matrix:
[[133877      0      0      0      0      0      0      0      0      0      0      0      0      0      0      0     64      0      0      0      0      0      0      0      0      0      0]
 [     0   1509      0      0      0      0      0      0      0      0      0      0      0      0      0      0      0      0      0      0      0      0      0      0      0      0      0]
 [     0      0    904      0      0      0      0      0      0      0      0      0      0      0      0      0      0      0      0      0      0      0      0      0      0      0      0]
 [     3      0      0   3845      0      0      0      0      0      0      0      0      0      0      0      0      0      0      0      0      0      0      0      0      0      0      0]
 [     0      0      0      0    192      0      0      0      0      0      0      0      0      0      0      0      0      0      0      0      0      0      0      0      0      0      0]
 [     0      0      0      0      0    497      0      0      0      0      0      0      0      0      1      0      0      1      0      3      0      0      0      0      0      0      0]
 [     0      0      0      0      0      0     98      0      0      0      0      0      0      0      0      0      0      0      0      0      0      0      0      0      0      0      0]
 [     0      0      0      0      0      0      0   1189      0      0      0      0      0      0      0      0      0      0      0      0      0      0      0      0      0      0      0]
 [     0      0      0      0      0      0      0      0    376      0      0      0      0      0      0      0      0      0      0      0      0      0      0      0      0      0      0]
 [     0      0      0      0      0      0      0      0      0  50147      0      0      0      0      0      0      0      0      0      0      0      0      0      0      0      0      0]
 [     0      0      0      0      0      0      0      0      0      0   3745      0      0      0      0      0      0      0      0      0      0      0      0      0      0      0      0]
 [     0      0      0      0      0      0      0      0      0      0      0   1543      0      0      0      0      0      0      0      0      0      0      0      0      0      0      0]
 [     0      0      0      0      0      0      0      0      0      0      0      0    186      0      0      0      0      0      0     23      0      0      0      0      0      0      0]
 [     0      0      0      0      0      1      0      0      0      0      0      0      0    403      0      0      0      1      1      0      0      0      0      0      0      0      0]
 [     0      0      0      0      0      3      0      0      0      0      0      0      0      0   2695      0      0      1      3      3      0      0      0      0      0      0      0]
 [     0      0      0      0      0      0      0      0      0      0      0      0      0      0      0     95      0      0      0      0      0      0      0      0      0      0      0]
 [     0      0      0      0      0      0      0      0      0      0      0      0      0      0      0      0   2448      0      0      0      0      0      0      0      0      0      0]
 [     0      0      0      0      0      2      0      0      0      0      0      0      3      0      0      0      0   1130      0     37      0      0      0      0      0      0      0]
 [     0      0      0      0      0      0      0      0      0      0      0      0      0      0     10      0      0      2    729      3      0      0      0      0      0      0      0]
 [     0      0      0      0      0     13      0      0      0      0      0      0      0      9      2      0      0     11      1   1129      0      0      0      0      0      0      0]
 [     0      0      0      0      0      0      0      0      0      0      0      0      0      0      0      0      0      0      0      0   5079      0      0      0      0      0      0]
 [     0      0      0      0      0      0      0      0      0      0      0      0      0      0      0      0      0      0      0      0      0    891      0      0      0      0      0]
 [     0      0      0      0      0      0      0      0      0      0      0      0      0      0      0      0      0      0      0      0      0      0   3169      0      0      0      0]
 [     0      0      0      0      0      0      0      0      0      0      0      0      0      0      0      0      0      0      0      0      0      0      0    464      0      0      0]
 [     0      0      0      0      0      0      0      0      0      0      0      0      0      0      0      0      0      0      0      0      0      0      0      0    572      0      0]
 [     0      0      0      0      0      0      0      0      0      0      0      0      0      0      0      0      0      0      0      0      0      0      0      0      0    134      0]
 [     0      0      0      0      0      0      0      0      0      0      0      0      0      0      0      0      0      0      0      0      0      0      0      0      0      0    429]]

Accuracy: 0.9971012095903563

Precision: [0.9990 0.9963 0.9936 0.9990 0.9207 0.9138 0.9854 0.9863 0.9973 0.9999 1.0000 1.0000 0.8342 0.9356 0.9838 1.0000 0.9757 0.9486 0.9793 0.8972 0.9966 0.9936 0.9984 1.0000 0.9983 1.0000 0.9976]
Mean: 0.9751848243193127
Std: 0.040258182777642336

Recall: [0.9992 0.9932 0.9873 0.9966 0.9264 0.9322 0.9712 0.9899 0.9946 0.9999 0.9975 0.9983 0.7385 0.9224 0.9827 0.9886 0.9940 0.9291 0.9451 0.9287 0.9972 0.9923 0.9990 0.9892 0.9933 0.9919 0.9761]
Mean: 0.968691458859327
Std: 0.05219938016062286

F1 score: [0.9991 0.9947 0.9904 0.9978 0.9235 0.9229 0.9783 0.9881 0.9960 0.9999 0.9988 0.9992 0.7835 0.9289 0.9833 0.9943 0.9848 0.9387 0.9619 0.9127 0.9969 0.9929 0.9987 0.9945 0.9958 0.9960 0.9867]
Mean: 0.9717865083380515
Std: 0.045813140810405335

Cohen Kappa score: 0.9951029537244139
Confusion matrix:
[[125721      6      2      2      0      0      0      2      0      4      0      0      0      0      3      0     66      6      1      0      2      3      5      0      0      0      0]
 [    11   1599      0      0      0      0      0      0      0      0      0      0      0      0      0      0      0      0      0      0      0      0      0      0      0      0      0]
 [     2      0    775      0      4      0      0      1      0      0      0      0      0      0      0      0      0      0      0      0      2      0      0      0      0      0      1]
 [    13      0      0   3831      0      0      0      0      0      0      0      0      0      0      0      0      0      0      0      0      0      0      0      0      0      0      0]
 [     4      0      0      1    151      0      1      2      0      0      0      0      0      0      0      0      0      0      0      0      3      1      0      0      0      0      0]
 [     2      0      0      0      0    509      0      0      0      0      0      0      3      7      3      0      0      4      1     17      0      0      0      0      0      0      0]
 [     0      0      0      0      3      0    135      1      0      0      0      0      0      0      0      0      0      0      0      0      0      0      0      0      0      0      0]
 [     5      0      0      0      2      0      0   1076      0      0      0      0      0      0      0      0      0      0      0      0      3      1      0      0      0      0      0]
 [     0      0      0      0      0      0      1      0    370      0      0      0      0      0      0      0      0      0      0      0      1      0      0      0      0      0      0]
 [     8      0      0      0      0      0      0      0      0  58410      0      0      0      0      0      0      0      0      0      0      0      0      0      0      0      0      0]
 [     9      0      0      0      0      0      0      0      0      0   3637      0      0      0      0      0      0      0      0      0      0      0      0      0      0      0      0]
 [     3      0      0      0      0      0      0      0      0      0      0   1786      0      0      0      0      0      0      0      0      0      0      0      0      0      0      0]
 [     1      0      0      0      0      8      0      0      0      0      0      0    161      3      0      0      0      4      0     41      0      0      0      0      0      0      0]
 [     1      0      0      0      0      6      0      0      0      0      0      0      9    392      3      0      0     11      1      2      0      0      0      0      0      0      0]
 [    19      0      0      0      0      6      0      0      0      0      0      0      0      2   2617      0      0      3      6     10      0      0      0      0      0      0      0]
 [     1      0      0      0      0      0      0      0      0      0      0      0      0      0      0     87      0      0      0      0      0      0      0      0      0      0      0]
 [    13      0      0      1      0      0      0      1      0      0      0      0      0      0      0      0   2651      0      0      0      0      0      0      0      1      0      0]
 [     7      0      0      0      0      7      0      0      0      0      0      0      8      1      2      0      0   1088      3     55      0      0      0      0      0      0      0]
 [     5      0      0      0      0      4      0      0      0      0      0      0      0      1     26      0      0      3    758      5      0      0      0      0      0      0      0]
 [     7      0      0      0      0     17      0      0      0      0      0      0     12     13      6      0      0     28      4   1134      0      0      0      0      0      0      0]
 [     4      0      0      0      0      0      0      7      0      2      0      0      0      0      0      0      0      0      0      0   4712      0      0      0      0      0      0]
 [     3      0      0      0      0      0      0      0      0      0      0      0      0      0      0      0      0      0      0      0      3    774      0      0      0      0      0]
 [     0      0      0      0      2      0      0      0      1      0      0      0      0      0      0      0      0      0      0      0      0      0   3090      0      0      0      0]
 [     5      0      0      0      0      0      0      0      0      0      0      0      0      0      0      0      0      0      0      0      0      0      0    456      0      0      0]
 [     4      0      0      0      0      0      0      0      0      0      0      0      0      0      0      0      0      0      0      0      0      0      0      0    594      0      0]
 [     0      0      0      0      0      0      0      1      0      0      0      0      0      0      0      0      0      0      0      0      0      0      0      0      0    123      0]
 [     3      0      3      0      2      0      0      0      0      0      0      0      0      0      0      0      0      0      0      0      2      0      0      0      0      0    409]]

