Classifier: LinearSVC
Params: {'C': 1.0, 'class_weight': None, 'dual': True, 'fit_intercept': True, 'intercept_scaling': 1, 'loss': 'squared_hinge', 'max_iter': 1000, 'multi_class': 'ovr', 'penalty': 'l2', 'random_state': None, 'tol': 0.0001, 'verbose': 0}

Labels: None

Training accuracy: 0.9670842332613391
Training confusion matrix:
[[2348    0    6    0    0    0    0    0    0    0    6    0    0    0    0    0]
 [   0  246    0    0    0    0    0    0    0    0    0    0    0    0    0    0]
 [   0    0  227    0    0    0    0    0    0    0    0    0    0    0    0    0]
 [   0    0    0  132    0    0    0   10    3    1    0    3    4   39    0    0]
 [   0    0    0    0 6882    0    0    0    0    0    0    0    0    0    0    0]
 [   0    0    0    0    0  185    0    0    0    0    0    0    0    0    0    0]
 [   0    0    0    0    0    0   36    0    0    0    0    0    0    0    0    0]
 [   0    0    0    3    0    0    0  107    7    0    0    6    0   12    0    0]
 [   0    0    0    6    0    0    0    3   91    1    0    3    0    4    0    0]
 [   0    0    0    5    0    0    0    2    2  259    0    0    7    5    0    0]
 [   1    0    0    0    0    0    0    0    0    0   53    0    0    0    0    0]
 [   0    0    0   14    0    0    0   15   10    1    0  208    2   32    0    0]
 [   0    0    0    3    0    0    0    3    2   14    0    2  101   10    0    0]
 [   0    0    0   16    0    0    0   34   16    6    0   59    3  293    0    0]
 [   0    0    0    0    0    0    0    0    0    0    0    0    0    0   24    0]
 [   0    0    0    0    0    0    0    0    0    0    0    0    0    0    0    2]]

Accuracy: 0.9111876591283511

Precision: [0.9368 0.1043 0.0165 0.0000 1.0000 0.0000 0.0000 0.0000 0.0000]
Mean: 0.22861957321673676
Std: 0.396973335256882

Recall: [0.9709 1.0000 0.0976 0.0000 0.0053 0.0000 0.0000 0.0000 0.0000]
Mean: 0.23042326199300975
Std: 0.40474339646124113

F1 score: [0.9535 0.1890 0.0282 0.0000 0.0106 0.0000 0.0000 0.0000 0.0000]
Mean: 0.13125574934751036
Std: 0.2964211370561275

Cohen Kappa score: 0.01379271609192545
Confusion matrix:
[[12148   103   238     0     0     2     6    12     3]
 [    0    12     0     0     0     0     0     0     0]
 [   37     0     4     0     0     0     0     0     0]
 [   34     0     1     0     0     0     0     0     0]
 [  744     0     0     0     4     1     0     0     0]
 [    0     0     0     0     0     0     0     0     0]
 [    0     0     0     0     0     0     0     0     0]
 [    0     0     0     0     0     0     0     0     0]
 [    5     0     0     0     0     0     0     0     0]]

