Classifier: LogisticRegression
Params: {'C': 1.0, 'class_weight': None, 'dual': False, 'fit_intercept': True, 'intercept_scaling': 1, 'max_iter': 100, 'multi_class': 'ovr', 'n_jobs': 1, 'penalty': 'l2', 'random_state': None, 'solver': 'liblinear', 'tol': 0.0001, 'verbose': 0, 'warm_start': False}

Labels: None

Training accuracy: 0.96414686825054
Training confusion matrix:
[[2349    1    5    0    0    1    0    0    0    0    4    0    0    0    0    0]
 [   1  245    0    0    0    0    0    0    0    0    0    0    0    0    0    0]
 [   3    0  224    0    0    0    0    0    0    0    0    0    0    0    0    0]
 [   0    0    0  131    0    0    0   10    2    4    0    3    4   38    0    0]
 [   1    0    0    0 6881    0    0    0    0    0    0    0    0    0    0    0]
 [   0    0    0    0    0  185    0    0    0    0    0    0    0    0    0    0]
 [   0    0    0    0    0    0   36    0    0    0    0    0    0    0    0    0]
 [   0    0    0    3    0    0    0   96    9    0    0    5    0   22    0    0]
 [   0    0    0    7    0    0    0    3   89    1    0    2    2    4    0    0]
 [   1    0    0    3    0    0    0    2    2  257    0    1    8    6    0    0]
 [   5    0    0    0    0    0    0    0    0    0   49    0    0    0    0    0]
 [   0    0    0   11    0    0    0   18   10    0    0  188    3   52    0    0]
 [   0    0    0    3    0    0    0    3    1   16    0    2   95   15    0    0]
 [   1    0    0   18    0    0    0   26   13    6    0   50    3  310    0    0]
 [   0    0    0    0    0    0    0    0    0    0    0    0    0    0   24    0]
 [   0    0    1    0    0    0    0    0    0    0    0    0    0    0    0    1]]

Accuracy: 0.9280365433577954

Precision: [0.9375 0.1034 0.1471 0.0000 0.0000 0.0000]
Mean: 0.19800197231354869
Std: 0.3356621029912794

Recall: [0.9891 1.0000 0.1220 0.0000 0.0000 0.0000]
Mean: 0.3518469423824673
Std: 0.4565219037772442

F1 score: [0.9626 0.1875 0.1333 0.0000 0.0000 0.0000]
Mean: 0.21390987373442746
Std: 0.34279198359704255

Cohen Kappa score: 0.024507352494598678
Confusion matrix:
[[12376   104    29     0     0     3]
 [    0    12     0     0     0     0]
 [   36     0     5     0     0     0]
 [   35     0     0     0     0     0]
 [  749     0     0     0     0     0]
 [    5     0     0     0     0     0]]

