Classifier: MultinomialNB
Params: {'alpha': 1.0, 'class_prior': None, 'fit_prior': True}

Labels: None

Training accuracy: 0.8723974082073435
Training confusion matrix:
[[2073   52    4    0   19   43    0    0    0   76    0    1    0   92    0    0]
 [  10  236    0    0    0    0    0    0    0    0    0    0    0    0    0    0]
 [  72    0  155    0    0    0    0    0    0    0    0    0    0    0    0    0]
 [   4    0    0   10    0    0    0    0    0    2    0    0    0  176    0    0]
 [  52    0    0    0 6829    1    0    0    0    0    0    0    0    0    0    0]
 [  20    0    0    0    0  165    0    0    0    0    0    0    0    0    0    0]
 [  21    0    0    0    0    0   15    0    0    0    0    0    0    0    0    0]
 [   2    0    0    0    0    0    0    0    0    0    0    0    0  133    0    0]
 [   2    0    0    0    0    0    0    0    0    0    0    0    0  106    0    0]
 [   6    0    2    0    0    0    0    0    0  182    0    3    0   87    0    0]
 [  50    0    1    0    0    0    0    0    0    0    3    0    0    0    0    0]
 [   6    0    0    0    0    0    0    0    0    0    0   13    0  263    0    0]
 [   2    0    0    0    0    0    0    0    0   51    0    0    0   82    0    0]
 [  10    0    0    0    0    0    0    0    0    0    0    0    0  417    0    0]
 [   7   17    0    0    0    0    0    0    0    0    0    0    0    0    0    0]
 [   2    0    0    0    0    0    0    0    0    0    0    0    0    0    0    0]]

Accuracy: 0.9100644001797215

Precision: [0.9363 0.0000 0.0335 0.0000 0.0000 0.0000 0.0000 0.0000 0.0000]
Mean: 0.10775771012478459
Std: 0.2931202692770451

Recall: [0.9703 0.0000 1.0000 0.0000 0.0000 0.0000 0.0000 0.0000 0.0000]
Mean: 0.218927607274794
Std: 0.40963567409243745

F1 score: [0.9530 0.0000 0.0649 0.0000 0.0000 0.0000 0.0000 0.0000 0.0000]
Mean: 0.11309833323256141
Std: 0.2976451522867828

Cohen Kappa score: 0.002701224766649468
Confusion matrix:
[[12141     9   346     7     1     0     0     8     0]
 [    0     0     0     0     0     0     0     0     0]
 [    0     0    12     0     0     0     0     0     0]
 [   41     0     0     0     0     0     0     0     0]
 [   35     0     0     0     0     0     0     0     0]
 [  745     1     0     0     0     0     3     0     0]
 [    0     0     0     0     0     0     0     0     0]
 [    0     0     0     0     0     0     0     0     0]
 [    5     0     0     0     0     0     0     0     0]]

