Classifier: GradientBoostingClassifier
Params: {'criterion': 'friedman_mse', 'init': None, 'learning_rate': 0.1, 'loss': 'deviance', 'max_depth': 3, 'max_features': None, 'max_leaf_nodes': None, 'min_impurity_decrease': 0.0, 'min_impurity_split': None, 'min_samples_leaf': 1, 'min_samples_split': 2, 'min_weight_fraction_leaf': 0.0, 'n_estimators': 100, 'presort': 'auto', 'random_state': None, 'subsample': 1.0, 'verbose': 0, 'warm_start': False}

Labels: None

Training accuracy: 0.9903244722439406
Training confusion matrix:
[[14739     0     1     4     0     0     0     6     0     1     0     0     0     0     1     0     2     0     0     0     2     0     1     0     0     0     0]
 [    2   228     0     0     0     0     0     0     0     0     0     0     0     0     0     0     0     0     0     0     0     0     0     0     0     0     0]
 [    0     0   283     0     0     0     0     0     0     0     0     0     0     0     0     0     0     0     0     0     0     0     0     0     0     0     0]
 [    5     0     0   188     0     0     0     0     0     0     0     0     0     0     0     0     0     0     0     0     0     0     0     0     0     0     0]
 [    0     0     0     0   207     0     0     0     0     0     0     0     0     0     0     0     0     0     0     0     0     0     0     0     0     0     0]
 [    0     0     0     0     0   129     0     0     0     0     0     0     4     2     2     0     0     0     0    19     0     0     0     0     0     0     0]
 [    0     0     0     0     0     0   131     0     0     0     0     0     0     0     0     0     0     0     0     0     0     0     0     0     0     0     0]
 [    0     0     0     0     0     0     0   994     0     0     0     0     0     0     0     0     0     0     0     0     0     0     0     0     0     0     0]
 [    0     0     0     0     0     0     0     0   185     0     0     0     0     0     0     0     0     0     0     0     0     0     0     0     0     0     0]
 [   76     0     0     0     0     0     0     0     0  6723     0     0     0     0     0     0     0     0     0     0     0     0     0     0     0     0     0]
 [    0     0     0     0     0     0     0     0     0     0   215     0     0     0     0     0     0     0     0     0     0     0     0     0     0     0     0]
 [    0     0     0     0     0     0     0     0     0     0     0  1186     0     0     0     0     0     0     0     0     0     0     0     0     0     0     0]
 [    0     0     0     0     0     3     0     0     0     0     0     0    94     1     0     0     0     3     0     4     0     0     0     0     0     0     0]
 [    0     0     0     0     0     2     0     0     0     0     0     0     0    88     0     0     0     1     0     2     0     0     0     0     0     0     0]
 [    3     0     0     0     0     5     0     0     0     0     0     0     1     2   292     0     0     1    10     3     0     0     0     0     0     0     0]
 [    0     0     0     0     0     0     0     0     0     0     0     0     0     0     0    53     0     0     0     0     0     0     0     0     0     0     0]
 [    2     0     0     0     0     0     0     0     0     0     0     0     0     0     0     0   403     0     0     0     0     0     0     0     0     0     0]
 [    0     0     0     0     0     7     0     0     0     0     0     0     5     5     0     0     0   232     1    14     0     0     0     0     0     0     0]
 [    0     0     0     0     0     2     0     0     0     0     0     0     1     1     5     0     0     2   104     7     0     0     0     0     0     0     0]
 [    0     0     0     0     0     6     0     0     0     0     0     0    16     7     3     0     0    42     0   298     0     0     0     0     0     0     0]
 [    1     0     0     0     0     0     0     1     0     0     0     0     0     0     0     0     0     0     0     0  1006     0     0     0     0     0     0]
 [    0     0     0     0     0     0     0     0     0     0     0     0     0     0     0     0     0     0     0     0     0   221     0     0     0     0     0]
 [    0     0     0     0     0     0     0     0     0     0     0     0     0     0     0     0     0     0     0     0     0     0  2084     0     0     0     0]
 [    0     0     0     0     0     0     0     0     0     0     0     0     0     0     0     0     0     0     0     0     0     0     0    34     0     0     0]
 [    0     0     0     0     0     0     0     0     0     0     0     0     0     0     0     0     0     0     0     0     0     0     0     0    34     0     0]
 [    0     0     0     0     0     0     0     0     0     0     0     0     0     0     0     0     0     0     0     0     0     0     0     0     0    59     0]
 [    0     0     0     0     0     0     0     0     0     0     0     0     0     0     0     0     0     0     0     0     0     0     0     0     0     0   189]]

Accuracy: 0.9788897576231431

Precision: [0.9868 0.9429 1.0000 0.9608 1.0000 0.6905 1.0000 0.9920 1.0000 0.9983 0.9808 0.9932 0.5116 0.6250 0.9701 1.0000 0.9904 0.8171 0.8065 0.6875 0.9958 0.9608 0.9982 0.9091 1.0000 1.0000 0.9773]
Mean: 0.9183117915111235
Std: 0.1333516902945319

Recall: [0.9944 0.9706 0.9870 0.9608 1.0000 0.8056 1.0000 0.9880 1.0000 0.9886 0.9444 0.9966 0.7333 0.6667 0.8025 0.9333 0.9537 0.7614 0.6944 0.7021 0.9875 1.0000 0.9964 0.9091 1.0000 0.8750 1.0000]
Mean: 0.913018585924654
Std: 0.11062666191367183

F1 score: [0.9906 0.9565 0.9935 0.9608 1.0000 0.7436 1.0000 0.9900 1.0000 0.9934 0.9623 0.9949 0.6027 0.6452 0.8784 0.9655 0.9717 0.7882 0.7463 0.6947 0.9916 0.9800 0.9973 0.9091 1.0000 0.9333 0.9885]
Mean: 0.9140043057852035
Std: 0.11979351519455372

Cohen Kappa score: 0.9705585914669819
Confusion matrix:
[[3577    4    0    2    0    0    0    0    0    3    1    2    0    0    0    0    1    0    0    3    1    1    1    1    0    0    0]
 [   2   66    0    0    0    0    0    0    0    0    0    0    0    0    0    0    0    0    0    0    0    0    0    0    0    0    0]
 [   0    0   76    0    0    0    0    0    0    0    0    0    0    0    0    0    0    0    0    0    0    1    0    0    0    0    0]
 [   2    0    0   49    0    0    0    0    0    0    0    0    0    0    0    0    0    0    0    0    0    0    0    0    0    0    0]
 [   0    0    0    0   45    0    0    0    0    0    0    0    0    0    0    0    0    0    0    0    0    0    0    0    0    0    0]
 [   0    0    0    0    0   29    0    0    0    0    0    0    2    1    0    0    0    0    0    4    0    0    0    0    0    0    0]
 [   0    0    0    0    0    0   20    0    0    0    0    0    0    0    0    0    0    0    0    0    0    0    0    0    0    0    0]
 [   3    0    0    0    0    0    0  248    0    0    0    0    0    0    0    0    0    0    0    0    0    0    0    0    0    0    0]
 [   0    0    0    0    0    0    0    0   39    0    0    0    0    0    0    0    0    0    0    0    0    0    0    0    0    0    0]
 [  20    0    0    0    0    0    0    0    0 1733    0    0    0    0    0    0    0    0    0    0    0    0    0    0    0    0    0]
 [   3    0    0    0    0    0    0    0    0    0   51    0    0    0    0    0    0    0    0    0    0    0    0    0    0    0    0]
 [   1    0    0    0    0    0    0    0    0    0    0  290    0    0    0    0    0    0    0    0    0    0    0    0    0    0    0]
 [   0    0    0    0    0    2    0    0    0    0    0    0   22    0    0    0    0    1    0    5    0    0    0    0    0    0    0]
 [   0    0    0    0    0    1    0    0    0    0    0    0    3   10    0    0    0    0    0    1    0    0    0    0    0    0    0]
 [   3    0    0    0    0    3    0    0    0    0    0    0    1    0   65    0    0    0    6    3    0    0    0    0    0    0    0]
 [   1    0    0    0    0    0    0    0    0    0    0    0    0    0    0   14    0    0    0    0    0    0    0    0    0    0    0]
 [   5    0    0    0    0    0    0    0    0    0    0    0    0    0    0    0  103    0    0    0    0    0    0    0    0    0    0]
 [   0    0    0    0    0    2    0    0    0    0    0    0    6    2    0    0    0   67    0   11    0    0    0    0    0    0    0]
 [   0    0    0    0    0    4    0    0    0    0    0    0    0    1    2    0    0    1   25    3    0    0    0    0    0    0    0]
 [   3    0    0    0    0    1    0    0    0    0    0    0    9    2    0    0    0   13    0   66    0    0    0    0    0    0    0]
 [   1    0    0    0    0    0    0    1    0    0    0    0    0    0    0    0    0    0    0    0  237    0    0    0    0    0    1]
 [   0    0    0    0    0    0    0    0    0    0    0    0    0    0    0    0    0    0    0    0    0   49    0    0    0    0    0]
 [   2    0    0    0    0    0    0    0    0    0    0    0    0    0    0    0    0    0    0    0    0    0  560    0    0    0    0]
 [   1    0    0    0    0    0    0    0    0    0    0    0    0    0    0    0    0    0    0    0    0    0    0   10    0    0    0]
 [   0    0    0    0    0    0    0    0    0    0    0    0    0    0    0    0    0    0    0    0    0    0    0    0    4    0    0]
 [   1    0    0    0    0    0    0    1    0    0    0    0    0    0    0    0    0    0    0    0    0    0    0    0    0   14    0]
 [   0    0    0    0    0    0    0    0    0    0    0    0    0    0    0    0    0    0    0    0    0    0    0    0    0    0   43]]

