Classifier: LinearSVC
Params: {'C': 1.0, 'class_weight': None, 'dual': True, 'fit_intercept': True, 'intercept_scaling': 1, 'loss': 'squared_hinge', 'max_iter': 1000, 'multi_class': 'ovr', 'penalty': 'l2', 'random_state': None, 'tol': 0.0001, 'verbose': 0}

Labels: None

Training accuracy: 0.9900312744331509
Training confusion matrix:
[[14741     0     1     6     0     0     0     4     0     0     0     0     0     0     1     0     3     0     0     0     0     0     0     0     1     0     0]
 [    0   230     0     0     0     0     0     0     0     0     0     0     0     0     0     0     0     0     0     0     0     0     0     0     0     0     0]
 [    2     0   281     0     0     0     0     0     0     0     0     0     0     0     0     0     0     0     0     0     0     0     0     0     0     0     0]
 [    1     0     0   192     0     0     0     0     0     0     0     0     0     0     0     0     0     0     0     0     0     0     0     0     0     0     0]
 [    0     0     0     0   207     0     0     0     0     0     0     0     0     0     0     0     0     0     0     0     0     0     0     0     0     0     0]
 [    0     0     0     0     0   115     0     0     0     0     0     0     6     2     0     0     0     3     3    27     0     0     0     0     0     0     0]
 [    0     0     0     0     0     0   131     0     0     0     0     0     0     0     0     0     0     0     0     0     0     0     0     0     0     0     0]
 [    0     0     0     0     0     0     0   994     0     0     0     0     0     0     0     0     0     0     0     0     0     0     0     0     0     0     0]
 [    0     0     0     0     0     0     0     0   185     0     0     0     0     0     0     0     0     0     0     0     0     0     0     0     0     0     0]
 [    0     0     0     0     0     0     0     0     0  6799     0     0     0     0     0     0     0     0     0     0     0     0     0     0     0     0     0]
 [    0     0     0     0     0     0     0     0     0     0   215     0     0     0     0     0     0     0     0     0     0     0     0     0     0     0     0]
 [    0     0     0     0     0     0     0     0     0     0     0  1186     0     0     0     0     0     0     0     0     0     0     0     0     0     0     0]
 [    0     0     0     0     0     5     0     0     0     0     0     0    89     6     0     0     0     1     0     4     0     0     0     0     0     0     0]
 [    0     0     0     0     0     4     0     0     0     0     0     0     0    84     1     0     0     2     0     2     0     0     0     0     0     0     0]
 [    0     0     0     0     0     4     0     0     0     0     0     0     1     2   306     0     0     0     3     1     0     0     0     0     0     0     0]
 [    0     0     0     0     0     0     0     0     0     0     0     0     0     0     0    53     0     0     0     0     0     0     0     0     0     0     0]
 [    1     0     0     0     0     0     0     0     0     0     0     0     0     0     0     0   404     0     0     0     0     0     0     0     0     0     0]
 [    0     0     0     0     0    12     0     0     0     0     0     0    14     8     0     0     0   199     1    30     0     0     0     0     0     0     0]
 [    0     0     0     0     0     1     0     0     0     0     0     0     1     1    18     0     0     3    89     9     0     0     0     0     0     0     0]
 [    0     0     0     0     0    13     0     0     0     0     0     0    30    14     4     0     0    44     2   265     0     0     0     0     0     0     0]
 [    1     0     0     0     0     0     0     1     0     0     0     0     0     0     0     0     0     0     0     0  1006     0     0     0     0     0     0]
 [    1     0     0     0     0     0     0     0     0     0     0     0     0     0     0     0     0     0     0     0     0   220     0     0     0     0     0]
 [    0     0     0     0     0     0     0     0     1     0     0     0     0     0     0     0     0     0     0     0     0     0  2083     0     0     0     0]
 [    0     0     0     0     0     0     0     0     0     0     0     0     0     0     0     0     0     0     0     0     0     0     0    34     0     0     0]
 [    0     0     0     0     0     0     0     0     0     0     0     0     0     0     0     0     0     0     0     0     0     0     0     0    34     0     0]
 [    0     0     0     0     0     0     0     0     0     0     0     0     0     0     0     0     0     0     0     0     0     0     0     0     0    59     0]
 [    0     0     0     0     0     0     0     0     0     0     0     0     0     0     0     0     0     0     0     0     0     0     0     0     0     0   189]]

Accuracy: 0.9816262705238468

Precision: [0.9953 0.9437 1.0000 0.9623 1.0000 0.6512 1.0000 0.9921 1.0000 0.9977 0.9811 1.0000 0.5106 0.5217 0.8202 1.0000 0.9717 0.8267 0.8636 0.7073 0.9958 1.0000 0.9965 1.0000 1.0000 1.0000 1.0000]
Mean: 0.9162025167064259
Std: 0.1456529052751229

Recall: [0.9947 0.9853 0.9870 1.0000 0.9778 0.7778 1.0000 0.9960 1.0000 0.9994 0.9630 1.0000 0.8000 0.8000 0.9012 0.9333 0.9537 0.7045 0.5278 0.6170 0.9917 0.9796 1.0000 0.9091 1.0000 0.9375 1.0000]
Mean: 0.9161649798345531
Std: 0.12588529385817254

F1 score: [0.9950 0.9640 0.9935 0.9808 0.9888 0.7089 1.0000 0.9940 1.0000 0.9986 0.9720 1.0000 0.6234 0.6316 0.8588 0.9655 0.9626 0.7607 0.6552 0.6591 0.9937 0.9897 0.9982 0.9524 1.0000 0.9677 1.0000]
Mean: 0.9116348830814638
Std: 0.13229352166257755

Cohen Kappa score: 0.9744179129129423
Confusion matrix:
[[3578    4    0    2    0    0    0    0    0    3    1    0    0    0    2    0    3    0    0    1    1    0    2    0    0    0    0]
 [   1   67    0    0    0    0    0    0    0    0    0    0    0    0    0    0    0    0    0    0    0    0    0    0    0    0    0]
 [   1    0   76    0    0    0    0    0    0    0    0    0    0    0    0    0    0    0    0    0    0    0    0    0    0    0    0]
 [   0    0    0   51    0    0    0    0    0    0    0    0    0    0    0    0    0    0    0    0    0    0    0    0    0    0    0]
 [   1    0    0    0   44    0    0    0    0    0    0    0    0    0    0    0    0    0    0    0    0    0    0    0    0    0    0]
 [   0    0    0    0    0   28    0    0    0    0    0    0    0    1    1    0    0    1    0    5    0    0    0    0    0    0    0]
 [   0    0    0    0    0    0   20    0    0    0    0    0    0    0    0    0    0    0    0    0    0    0    0    0    0    0    0]
 [   1    0    0    0    0    0    0  250    0    0    0    0    0    0    0    0    0    0    0    0    0    0    0    0    0    0    0]
 [   0    0    0    0    0    0    0    0   39    0    0    0    0    0    0    0    0    0    0    0    0    0    0    0    0    0    0]
 [   1    0    0    0    0    0    0    0    0 1752    0    0    0    0    0    0    0    0    0    0    0    0    0    0    0    0    0]
 [   2    0    0    0    0    0    0    0    0    0   52    0    0    0    0    0    0    0    0    0    0    0    0    0    0    0    0]
 [   0    0    0    0    0    0    0    0    0    0    0  291    0    0    0    0    0    0    0    0    0    0    0    0    0    0    0]
 [   1    0    0    0    0    2    0    0    0    0    0    0   24    1    0    0    0    0    0    2    0    0    0    0    0    0    0]
 [   0    0    0    0    0    3    0    0    0    0    0    0    0   12    0    0    0    0    0    0    0    0    0    0    0    0    0]
 [   0    0    0    0    0    1    0    0    0    0    0    0    1    0   73    0    0    1    2    3    0    0    0    0    0    0    0]
 [   1    0    0    0    0    0    0    0    0    0    0    0    0    0    0   14    0    0    0    0    0    0    0    0    0    0    0]
 [   5    0    0    0    0    0    0    0    0    0    0    0    0    0    0    0  103    0    0    0    0    0    0    0    0    0    0]
 [   0    0    0    0    0    2    0    0    0    0    0    0    9    3    3    0    0   62    0    9    0    0    0    0    0    0    0]
 [   0    0    0    0    0    4    0    0    0    0    0    0    0    1    7    0    0    1   19    4    0    0    0    0    0    0    0]
 [   0    0    0    0    0    3    0    0    0    1    0    0   13    5    3    0    0   10    1   58    0    0    0    0    0    0    0]
 [   2    0    0    0    0    0    0    0    0    0    0    0    0    0    0    0    0    0    0    0  238    0    0    0    0    0    0]
 [   0    0    0    0    0    0    0    1    0    0    0    0    0    0    0    0    0    0    0    0    0   48    0    0    0    0    0]
 [   0    0    0    0    0    0    0    0    0    0    0    0    0    0    0    0    0    0    0    0    0    0  562    0    0    0    0]
 [   1    0    0    0    0    0    0    0    0    0    0    0    0    0    0    0    0    0    0    0    0    0    0   10    0    0    0]
 [   0    0    0    0    0    0    0    0    0    0    0    0    0    0    0    0    0    0    0    0    0    0    0    0    4    0    0]
 [   0    0    0    0    0    0    0    1    0    0    0    0    0    0    0    0    0    0    0    0    0    0    0    0    0   15    0]
 [   0    0    0    0    0    0    0    0    0    0    0    0    0    0    0    0    0    0    0    0    0    0    0    0    0    0   43]]

