Classifier: LogisticRegression
Params: {'C': 1.0, 'class_weight': None, 'dual': False, 'fit_intercept': True, 'intercept_scaling': 1, 'max_iter': 100, 'multi_class': 'ovr', 'n_jobs': 1, 'penalty': 'l2', 'random_state': None, 'solver': 'liblinear', 'tol': 0.0001, 'verbose': 0, 'warm_start': False}

Labels: None

Training accuracy: 0.9880766223612197
Training confusion matrix:
[[14728     2     2     4     0     0     0     7     0     0     1     0     0     0     1     0     2     0     0     0     3     2     2     0     2     0     1]
 [    0   230     0     0     0     0     0     0     0     0     0     0     0     0     0     0     0     0     0     0     0     0     0     0     0     0     0]
 [    3     0   280     0     0     0     0     0     0     0     0     0     0     0     0     0     0     0     0     0     0     0     0     0     0     0     0]
 [    7     0     0   186     0     0     0     0     0     0     0     0     0     0     0     0     0     0     0     0     0     0     0     0     0     0     0]
 [    0     0     0     0   207     0     0     0     0     0     0     0     0     0     0     0     0     0     0     0     0     0     0     0     0     0     0]
 [    0     0     0     0     0   117     0     0     0     0     0     0     6     1     1     0     0     1     3    27     0     0     0     0     0     0     0]
 [    0     0     0     0     0     0   131     0     0     0     0     0     0     0     0     0     0     0     0     0     0     0     0     0     0     0     0]
 [    1     0     1     0     0     0     0   987     0     0     0     0     0     0     0     0     0     0     0     0     5     0     0     0     0     0     0]
 [    0     0     0     0     0     0     0     0   185     0     0     0     0     0     0     0     0     0     0     0     0     0     0     0     0     0     0]
 [    5     0     0     0     0     0     0     0     0  6794     0     0     0     0     0     0     0     0     0     0     0     0     0     0     0     0     0]
 [    4     0     0     0     0     0     0     0     0     0   211     0     0     0     0     0     0     0     0     0     0     0     0     0     0     0     0]
 [    0     0     0     0     0     0     0     0     0     0     0  1186     0     0     0     0     0     0     0     0     0     0     0     0     0     0     0]
 [    0     0     0     0     0     4     0     0     0     0     0     0    79     6     0     0     0     1     1    14     0     0     0     0     0     0     0]
 [    0     0     0     0     0     6     0     0     0     0     0     0     1    79     1     0     0     2     0     4     0     0     0     0     0     0     0]
 [    3     0     0     0     0     3     0     0     0     0     0     0     1     2   299     0     0     1     3     5     0     0     0     0     0     0     0]
 [    0     0     0     0     0     0     0     0     0     0     0     0     0     0     0    53     0     0     0     0     0     0     0     0     0     0     0]
 [    4     0     0     0     0     0     0     0     0     0     0     0     0     0     0     0   400     0     0     0     0     0     0     0     1     0     0]
 [    0     0     0     0     0    12     0     0     0     0     0     0    14     8     0     0     0   188     3    39     0     0     0     0     0     0     0]
 [    0     0     0     0     0     1     0     0     0     0     0     0     1     1    15     0     0     3    89    12     0     0     0     0     0     0     0]
 [    1     0     0     0     0    12     0     0     0     0     0     0    21    10     3     0     0    40     1   284     0     0     0     0     0     0     0]
 [    4     0     0     0     0     0     0     1     0     0     0     0     0     0     0     0     0     0     0     0  1003     0     0     0     0     0     0]
 [    1     0     0     0     0     0     0     0     0     0     0     0     0     0     0     0     0     0     0     0     0   220     0     0     0     0     0]
 [    1     0     0     0     0     0     0     0     1     0     0     0     0     0     0     0     0     0     0     0     0     0  2082     0     0     0     0]
 [    0     0     0     0     0     0     0     0     0     1     0     0     0     0     0     0     0     0     0     0     0     0     0    33     0     0     0]
 [    1     0     0     1     0     0     0     0     0     0     0     0     0     0     0     0     0     0     0     0     0     0     0     0    32     0     0]
 [    0     0     0     0     0     0     0     0     0     0     0     0     0     0     0     0     0     0     0     0     0     0     0     0     0    59     0]
 [    1     0     0     0     0     0     0     0     0     0     0     0     0     0     0     0     0     0     0     0     0     0     0     0     0     0   188]]

Accuracy: 0.9805837894188167

Precision: [0.9920 0.9565 1.0000 0.9423 1.0000 0.6098 1.0000 0.9920 1.0000 0.9983 1.0000 1.0000 0.5143 0.5714 0.8488 1.0000 0.9804 0.8592 0.8571 0.6602 0.9876 1.0000 0.9982 1.0000 1.0000 1.0000 1.0000]
Mean: 0.9173354781910267
Std: 0.145530459810454

Recall: [0.9964 0.9706 0.9740 0.9608 1.0000 0.6944 1.0000 0.9880 1.0000 0.9977 0.9444 1.0000 0.6000 0.8000 0.9012 0.9333 0.9259 0.6932 0.5000 0.7234 0.9917 0.9796 1.0000 0.8182 1.0000 0.9375 1.0000]
Mean: 0.9011281302755481
Std: 0.13791107155928398

F1 score: [0.9942 0.9635 0.9868 0.9515 1.0000 0.6494 1.0000 0.9900 1.0000 0.9980 0.9714 1.0000 0.5538 0.6667 0.8743 0.9655 0.9524 0.7673 0.6316 0.6904 0.9896 0.9897 0.9991 0.9000 1.0000 0.9677 1.0000]
Mean: 0.9056600000265159
Std: 0.13796458056532454

Cohen Kappa score: 0.972929799384876
Confusion matrix:
[[3584    3    0    2    0    0    0    0    0    2    0    0    0    0    1    0    2    0    0    0    2    0    1    0    0    0    0]
 [   2   66    0    0    0    0    0    0    0    0    0    0    0    0    0    0    0    0    0    0    0    0    0    0    0    0    0]
 [   2    0   75    0    0    0    0    0    0    0    0    0    0    0    0    0    0    0    0    0    0    0    0    0    0    0    0]
 [   2    0    0   49    0    0    0    0    0    0    0    0    0    0    0    0    0    0    0    0    0    0    0    0    0    0    0]
 [   0    0    0    0   45    0    0    0    0    0    0    0    0    0    0    0    0    0    0    0    0    0    0    0    0    0    0]
 [   0    0    0    0    0   25    0    0    0    0    0    0    0    1    1    0    0    1    0    8    0    0    0    0    0    0    0]
 [   0    0    0    0    0    0   20    0    0    0    0    0    0    0    0    0    0    0    0    0    0    0    0    0    0    0    0]
 [   2    0    0    0    0    0    0  248    0    0    0    0    0    0    0    0    0    0    0    0    1    0    0    0    0    0    0]
 [   0    0    0    0    0    0    0    0   39    0    0    0    0    0    0    0    0    0    0    0    0    0    0    0    0    0    0]
 [   4    0    0    0    0    0    0    0    0 1749    0    0    0    0    0    0    0    0    0    0    0    0    0    0    0    0    0]
 [   3    0    0    0    0    0    0    0    0    0   51    0    0    0    0    0    0    0    0    0    0    0    0    0    0    0    0]
 [   0    0    0    0    0    0    0    0    0    0    0  291    0    0    0    0    0    0    0    0    0    0    0    0    0    0    0]
 [   1    0    0    0    0    2    0    0    0    0    0    0   18    1    0    0    0    0    0    8    0    0    0    0    0    0    0]
 [   0    0    0    0    0    3    0    0    0    0    0    0    0   12    0    0    0    0    0    0    0    0    0    0    0    0    0]
 [   1    0    0    0    0    1    0    0    0    0    0    0    1    0   73    0    0    0    2    3    0    0    0    0    0    0    0]
 [   1    0    0    0    0    0    0    0    0    0    0    0    0    0    0   14    0    0    0    0    0    0    0    0    0    0    0]
 [   7    0    0    1    0    0    0    0    0    0    0    0    0    0    0    0  100    0    0    0    0    0    0    0    0    0    0]
 [   0    0    0    0    0    2    0    0    0    0    0    0    9    2    2    0    0   61    0   12    0    0    0    0    0    0    0]
 [   1    0    0    0    0    4    0    0    0    0    0    0    0    1    7    0    0    1   18    4    0    0    0    0    0    0    0]
 [   0    0    0    0    0    4    0    0    0    0    0    0    7    4    2    0    0    8    1   68    0    0    0    0    0    0    0]
 [   2    0    0    0    0    0    0    0    0    0    0    0    0    0    0    0    0    0    0    0  238    0    0    0    0    0    0]
 [   0    0    0    0    0    0    0    1    0    0    0    0    0    0    0    0    0    0    0    0    0   48    0    0    0    0    0]
 [   0    0    0    0    0    0    0    0    0    0    0    0    0    0    0    0    0    0    0    0    0    0  562    0    0    0    0]
 [   1    0    0    0    0    0    0    0    0    1    0    0    0    0    0    0    0    0    0    0    0    0    0    9    0    0    0]
 [   0    0    0    0    0    0    0    0    0    0    0    0    0    0    0    0    0    0    0    0    0    0    0    0    4    0    0]
 [   0    0    0    0    0    0    0    1    0    0    0    0    0    0    0    0    0    0    0    0    0    0    0    0    0   15    0]
 [   0    0    0    0    0    0    0    0    0    0    0    0    0    0    0    0    0    0    0    0    0    0    0    0    0    0   43]]

