Classifier: MultinomialNB
Params: {'alpha': 1.0, 'class_prior': None, 'fit_prior': True}

Labels: None

Training accuracy: 0.9118126140213708
Training confusion matrix:
[[13764    76    14    78     2     0     0   249     1    36   161    10     0     0    97     0    10    62     0   126    39     1    11     1     1     0    18]
 [    9   221     0     0     0     0     0     0     0     0     0     0     0     0     0     0     0     0     0     0     0     0     0     0     0     0     0]
 [    2     1   232     1     6     0     6    29     0     0     0     0     0     0     0     0     0     0     0     0     6     0     0     0     0     0     0]
 [   53     0     0   117     0     0     0     0     0     0     0     0     0     0     0     0    20     0     0     0     0     0     3     0     0     0     0]
 [    0     0     0     0   199     0     4     0     0     0     0     0     0     0     0     0     0     0     0     0     1     0     3     0     0     0     0]
 [    1     0     0     0     0     0     0     0     0     0     0     0     0     0     1     0     0     0     0   154     0     0     0     0     0     0     0]
 [    0     0     0     0     0     0   127     1     0     0     0     0     0     0     0     0     2     0     0     0     0     0     1     0     0     0     0]
 [    3     0     1     0     9     0     1   971     0     0     0     0     0     0     0     0     0     0     0     0     9     0     0     0     0     0     0]
 [    1     0     0     0     0     0     2     1   175     0     0     0     0     0     0     0     0     0     0     0     0     0     6     0     0     0     0]
 [  342     0     0     0     0     0     0     0     0  6426     1     2     0     0     6     0     4     0     0     0     0     0    18     0     0     0     0]
 [   26     0     0     0     0     0     0     0     0     0   189     0     0     0     0     0     0     0     0     0     0     0     0     0     0     0     0]
 [   26     0     0     0     0     0     0     0     0     3     0  1157     0     0     0     0     0     0     0     0     0     0     0     0     0     0     0]
 [    0     0     0     0     0     0     0     0     0     0     0     0     0     0     0     0     0     0     0   105     0     0     0     0     0     0     0]
 [    0     0     0     0     0     0     0     0     0     0     0     0     0     0     1     0     0     0     0    92     0     0     0     0     0     0     0]
 [    5     0     0     0     0     0     0     2     0     0     0     0     0     0   179     0     0     8     0   120     1     0     2     0     0     0     0]
 [    0     0     1     0     3     0     4     0     0     0     0     0     0     0     0    34     2     0     0     0     0     0     9     0     0     0     0]
 [   48     0     0     1     4     0     2     0     0     0     0     0     0     0     0     0   350     0     0     0     0     0     0     0     0     0     0]
 [    8     0     0     0     0     0     0     0     0     0     0     0     0     0     3     0     0    41     0   212     0     0     0     0     0     0     0]
 [    1     0     0     0     0     0     0     0     0     0     0     0     0     0    15     0     0    15     1    90     0     0     0     0     0     0     0]
 [    4     0     0     0     0     0     0     0     0     0     4     0     0     0     1     0     0     9     0   350     0     0     4     0     0     0     0]
 [    3     0     0     0     0     0     0     6     0     0     0     0     0     0     0     0     0     0     0     0   998     0     1     0     0     0     0]
 [    1     0     0     0     0     0     0    11     0     0     0     0     0     0     0     0     1     0     0     0    46   159     3     0     0     0     0]
 [    3     0     0     0     5     0     5     2     1     0     0     0     0     0     0     0     0     0     0     0     0     0  2068     0     0     0     0]
 [    8    17     0     0     0     0     0     0     0     0     0     0     0     0     0     0     0     0     0     0     0     0     0     9     0     0     0]
 [    7     0     0     0     0     0     0     0     0     0     0     0     0     0     0     0     0     0     0     0     0     0     0     0    27     0     0]
 [    0     0     6     0     3     0     0    21     0     0     0     0     0     0     0     0     1     0     0     0     4     0     1     0     0    23     0]
 [    2     0     3     0     2     0     2     3     0     0     0     0     0     0     0     0     0     0     0     0     5     0     0     0     0     0   172]]

Accuracy: 0.9103466249674225

Precision: [0.9542 0.7471 0.9296 0.7447 0.8980 1.0000 0.9000 0.7878 1.0000 0.9952 0.5114 0.9930 0.0000 0.0000 0.5581 1.0000 0.8835 0.3953 0.0000 0.2648 0.8906 1.0000 0.9755 1.0000 1.0000 1.0000 0.8667]
Mean: 0.7516810017307273
Std: 0.3289087802523436

Recall: [0.9383 0.9559 0.8571 0.6863 0.9778 0.0278 0.9000 0.9761 1.0000 0.9373 0.8333 0.9759 0.0000 0.0000 0.5926 0.7333 0.8426 0.1932 0.0000 0.9043 0.9833 0.6531 0.9929 0.2727 0.7500 0.1875 0.9070]
Mean: 0.6695629024361038
Std: 0.3583909561601756

F1 score: [0.9462 0.8387 0.8919 0.7143 0.9362 0.0541 0.9000 0.8719 1.0000 0.9653 0.6338 0.9844 0.0000 0.0000 0.5749 0.8462 0.8626 0.2595 0.0000 0.4096 0.9347 0.7901 0.9841 0.4286 0.8571 0.3158 0.8864]
Mean: 0.6624528130084334
Std: 0.33903083536763096

Cohen Kappa score: 0.8762044173517415
Confusion matrix:
[[3375   18    2   10    0    0    0   46    0    7   42    2    0    0   28    0    5   19    0   32    5    0    2    0    0    0    4]
 [   3   65    0    0    0    0    0    0    0    0    0    0    0    0    0    0    0    0    0    0    0    0    0    0    0    0    0]
 [   1    0   66    1    1    0    1    6    0    0    0    0    0    0    0    0    0    0    0    0    1    0    0    0    0    0    0]
 [  10    0    0   35    0    0    0    0    0    0    0    0    0    0    0    0    5    0    0    0    0    0    1    0    0    0    0]
 [   0    0    0    0   44    0    0    1    0    0    0    0    0    0    0    0    0    0    0    0    0    0    0    0    0    0    0]
 [   0    0    0    0    0    1    0    0    0    0    0    0    0    0    1    0    0    0    0   34    0    0    0    0    0    0    0]
 [   0    0    0    0    0    0   18    0    0    0    0    0    0    0    0    0    2    0    0    0    0    0    0    0    0    0    0]
 [   1    0    0    0    1    0    0  245    0    0    0    0    0    0    0    0    0    0    0    0    4    0    0    0    0    0    0]
 [   0    0    0    0    0    0    0    0   39    0    0    0    0    0    0    0    0    0    0    0    0    0    0    0    0    0    0]
 [ 103    0    0    1    0    0    0    0    0 1643    0    0    0    0    1    0    0    0    0    0    0    0    5    0    0    0    0]
 [   9    0    0    0    0    0    0    0    0    0   45    0    0    0    0    0    0    0    0    0    0    0    0    0    0    0    0]
 [   6    0    0    0    0    0    0    0    0    1    0  284    0    0    0    0    0    0    0    0    0    0    0    0    0    0    0]
 [   0    0    0    0    0    0    0    0    0    0    0    0    0    0    0    0    0    0    0   30    0    0    0    0    0    0    0]
 [   0    0    0    0    0    0    0    0    0    0    0    0    0    0    0    0    0    0    0   15    0    0    0    0    0    0    0]
 [   1    0    0    0    0    0    0    0    0    0    0    0    0    0   48    0    0    3    0   28    0    0    1    0    0    0    0]
 [   0    0    0    0    0    0    0    0    0    0    0    0    0    0    0   11    0    0    0    0    0    0    3    0    0    0    1]
 [  17    0    0    0    0    0    0    0    0    0    0    0    0    0    0    0   91    0    0    0    0    0    0    0    0    0    0]
 [   2    0    0    0    0    0    0    0    0    0    0    0    0    0    0    0    0   17    0   69    0    0    0    0    0    0    0]
 [   1    0    0    0    0    0    0    0    0    0    0    0    0    0    6    0    0    1    0   28    0    0    0    0    0    0    0]
 [   1    0    0    0    0    0    0    0    0    0    1    0    0    0    2    0    0    3    0   85    0    0    2    0    0    0    0]
 [   1    0    0    0    0    0    0    2    0    0    0    0    0    0    0    0    0    0    0    0  236    0    0    0    0    0    1]
 [   0    0    0    0    0    0    0    4    0    0    0    0    0    0    0    0    0    0    0    0   13   32    0    0    0    0    0]
 [   1    0    1    0    1    0    1    0    0    0    0    0    0    0    0    0    0    0    0    0    0    0  558    0    0    0    0]
 [   4    4    0    0    0    0    0    0    0    0    0    0    0    0    0    0    0    0    0    0    0    0    0    3    0    0    0]
 [   1    0    0    0    0    0    0    0    0    0    0    0    0    0    0    0    0    0    0    0    0    0    0    0    3    0    0]
 [   0    0    2    0    2    0    0    4    0    0    0    0    0    0    0    0    0    0    0    0    5    0    0    0    0    3    0]
 [   0    0    0    0    0    0    0    3    0    0    0    0    0    0    0    0    0    0    0    0    1    0    0    0    0    0   39]]

