Classifier: RandomForestClassifier
Params: {'bootstrap': True, 'class_weight': None, 'criterion': 'gini', 'max_depth': None, 'max_features': 'auto', 'max_leaf_nodes': None, 'min_impurity_decrease': 0.0, 'min_impurity_split': None, 'min_samples_leaf': 1, 'min_samples_split': 2, 'min_weight_fraction_leaf': 0.0, 'n_estimators': 100, 'n_jobs': 1, 'oob_score': False, 'random_state': None, 'verbose': 0, 'warm_start': False}

Labels: None

Training accuracy: 0.9953739900964295
Training confusion matrix:
[[14751     0     0     4     0     0     0     0     0     0     0     0     0     0     0     0     2     0     0     0     0     0     0     0     0     0     0]
 [    0   230     0     0     0     0     0     0     0     0     0     0     0     0     0     0     0     0     0     0     0     0     0     0     0     0     0]
 [    1     0   282     0     0     0     0     0     0     0     0     0     0     0     0     0     0     0     0     0     0     0     0     0     0     0     0]
 [    1     0     0   192     0     0     0     0     0     0     0     0     0     0     0     0     0     0     0     0     0     0     0     0     0     0     0]
 [    0     0     0     0   207     0     0     0     0     0     0     0     0     0     0     0     0     0     0     0     0     0     0     0     0     0     0]
 [    0     0     0     0     0   142     0     0     0     0     0     0     0     1     0     0     0     2     1    10     0     0     0     0     0     0     0]
 [    0     0     0     0     0     0   131     0     0     0     0     0     0     0     0     0     0     0     0     0     0     0     0     0     0     0     0]
 [    0     0     0     0     0     0     0   993     0     0     0     0     0     0     0     0     0     0     0     0     1     0     0     0     0     0     0]
 [    0     0     0     0     0     0     0     0   185     0     0     0     0     0     0     0     0     0     0     0     0     0     0     0     0     0     0]
 [    0     0     0     0     0     0     0     0     0  6799     0     0     0     0     0     0     0     0     0     0     0     0     0     0     0     0     0]
 [    0     0     0     0     0     0     0     0     0     0   215     0     0     0     0     0     0     0     0     0     0     0     0     0     0     0     0]
 [    0     0     0     0     0     0     0     0     0     0     0  1186     0     0     0     0     0     0     0     0     0     0     0     0     0     0     0]
 [    0     0     0     0     0     0     0     0     0     0     0     0    96     1     0     0     0     3     0     5     0     0     0     0     0     0     0]
 [    0     0     0     0     0     2     0     0     0     0     0     0     0    88     0     0     0     1     0     2     0     0     0     0     0     0     0]
 [    0     0     0     0     0     1     0     0     0     0     0     0     0     1   309     0     0     0     4     2     0     0     0     0     0     0     0]
 [    0     0     0     0     0     0     0     0     0     0     0     0     0     0     0    53     0     0     0     0     0     0     0     0     0     0     0]
 [    1     0     0     0     0     0     0     0     0     0     0     0     0     0     0     0   404     0     0     0     0     0     0     0     0     0     0]
 [    0     0     0     0     0     2     0     0     0     0     0     0     2     2     0     0     0   235     1    22     0     0     0     0     0     0     0]
 [    0     0     0     0     0     0     0     0     0     0     0     0     0     1     9     0     0     1   108     3     0     0     0     0     0     0     0]
 [    0     0     0     0     0     7     0     0     0     0     0     0    13     5     1     0     0    24     2   320     0     0     0     0     0     0     0]
 [    1     0     0     0     0     0     0     0     0     0     0     0     0     0     0     0     0     0     0     0  1007     0     0     0     0     0     0]
 [    0     0     0     0     0     0     0     0     0     0     0     0     0     0     0     0     0     0     0     0     0   221     0     0     0     0     0]
 [    0     0     0     0     0     0     0     0     0     0     0     0     0     0     0     0     0     0     0     0     0     0  2084     0     0     0     0]
 [    0     0     0     0     0     0     0     0     0     0     0     0     0     0     0     0     0     0     0     0     0     0     0    34     0     0     0]
 [    0     0     0     0     0     0     0     0     0     0     0     0     0     0     0     0     0     0     0     0     0     0     0     0    34     0     0]
 [    0     0     0     0     0     0     0     0     0     0     0     0     0     0     0     0     0     0     0     0     0     0     0     0     0    59     0]
 [    0     0     0     0     0     0     0     0     0     0     0     0     0     0     0     0     0     0     0     0     0     0     0     0     0     0   189]]

Accuracy: 0.9712014594735471

Precision: [0.9840 0.9394 0.9861 0.8824 0.9574 0.5385 1.0000 0.9724 1.0000 0.9983 1.0000 1.0000 0.3793 0.5000 0.7556 1.0000 0.9898 0.7260 0.6667 0.6355 0.9793 1.0000 0.9982 0.8750 1.0000 1.0000 1.0000]
Mean: 0.8801462980731716
Std: 0.18011213454124708

Recall: [0.9936 0.9118 0.9221 0.8824 1.0000 0.5833 0.9500 0.9841 1.0000 0.9966 0.9444 0.9966 0.3667 0.4667 0.8395 0.8667 0.8981 0.6023 0.4444 0.7234 0.9875 0.9592 0.9964 0.6364 1.0000 0.8750 0.9302]
Mean: 0.8428622459856826
Std: 0.19030978801730705

F1 score: [0.9888 0.9254 0.9530 0.8824 0.9783 0.5600 0.9744 0.9782 1.0000 0.9974 0.9714 0.9983 0.3729 0.4828 0.7953 0.9286 0.9417 0.6584 0.5333 0.6766 0.9834 0.9792 0.9973 0.7368 1.0000 0.9333 0.9639]
Mean: 0.8589282125519954
Std: 0.18322412151973375

Cohen Kappa score: 0.9597877541996795
Confusion matrix:
[[3574    4    0    4    0    0    0    1    0    3    0    0    0    0    7    0    1    0    0    1    0    0    1    1    0    0    0]
 [   6   62    0    0    0    0    0    0    0    0    0    0    0    0    0    0    0    0    0    0    0    0    0    0    0    0    0]
 [   3    0   71    0    1    0    0    1    0    0    0    0    0    0    0    0    0    0    0    0    1    0    0    0    0    0    0]
 [   6    0    0   45    0    0    0    0    0    0    0    0    0    0    0    0    0    0    0    0    0    0    0    0    0    0    0]
 [   0    0    0    0   45    0    0    0    0    0    0    0    0    0    0    0    0    0    0    0    0    0    0    0    0    0    0]
 [   0    0    0    0    0   21    0    0    0    0    0    0    3    0    1    0    0    2    2    7    0    0    0    0    0    0    0]
 [   1    0    0    0    0    0   19    0    0    0    0    0    0    0    0    0    0    0    0    0    0    0    0    0    0    0    0]
 [   2    0    0    0    0    0    0  247    0    0    0    0    0    0    0    0    0    0    0    0    2    0    0    0    0    0    0]
 [   0    0    0    0    0    0    0    0   39    0    0    0    0    0    0    0    0    0    0    0    0    0    0    0    0    0    0]
 [   6    0    0    0    0    0    0    0    0 1747    0    0    0    0    0    0    0    0    0    0    0    0    0    0    0    0    0]
 [   3    0    0    0    0    0    0    0    0    0   51    0    0    0    0    0    0    0    0    0    0    0    0    0    0    0    0]
 [   1    0    0    0    0    0    0    0    0    0    0  290    0    0    0    0    0    0    0    0    0    0    0    0    0    0    0]
 [   0    0    0    0    0    6    0    0    0    0    0    0   11    2    0    0    0    3    0    8    0    0    0    0    0    0    0]
 [   0    0    0    0    0    2    0    0    0    0    0    0    2    7    0    0    0    4    0    0    0    0    0    0    0    0    0]
 [   3    0    0    0    0    2    0    0    0    0    0    0    1    0   68    0    0    0    4    3    0    0    0    0    0    0    0]
 [   1    0    0    0    0    0    0    1    0    0    0    0    0    0    0   13    0    0    0    0    0    0    0    0    0    0    0]
 [   9    0    0    2    0    0    0    0    0    0    0    0    0    0    0    0   97    0    0    0    0    0    0    0    0    0    0]
 [   4    0    0    0    0    2    0    0    0    0    0    0    6    2    2    0    0   53    0   19    0    0    0    0    0    0    0]
 [   2    0    0    0    0    3    0    0    0    0    0    0    0    1   10    0    0    3   16    1    0    0    0    0    0    0    0]
 [   2    0    0    0    0    3    0    0    0    0    0    0    6    2    2    0    0    8    2   68    1    0    0    0    0    0    0]
 [   3    0    0    0    0    0    0    0    0    0    0    0    0    0    0    0    0    0    0    0  237    0    0    0    0    0    0]
 [   0    0    0    0    0    0    0    2    0    0    0    0    0    0    0    0    0    0    0    0    0   47    0    0    0    0    0]
 [   0    0    1    0    0    0    0    1    0    0    0    0    0    0    0    0    0    0    0    0    0    0  560    0    0    0    0]
 [   4    0    0    0    0    0    0    0    0    0    0    0    0    0    0    0    0    0    0    0    0    0    0    7    0    0    0]
 [   0    0    0    0    0    0    0    0    0    0    0    0    0    0    0    0    0    0    0    0    0    0    0    0    4    0    0]
 [   0    0    0    0    1    0    0    1    0    0    0    0    0    0    0    0    0    0    0    0    0    0    0    0    0   14    0]
 [   2    0    0    0    0    0    0    0    0    0    0    0    0    0    0    0    0    0    0    0    1    0    0    0    0    0   40]]

