Classifier: LogisticRegression
Params: {'C': 1.0, 'class_weight': None, 'dual': False, 'fit_intercept': True, 'intercept_scaling': 1, 'max_iter': 100, 'multi_class': 'ovr', 'n_jobs': 1, 'penalty': 'l2', 'random_state': None, 'solver': 'liblinear', 'tol': 0.0001, 'verbose': 0, 'warm_start': False}

Labels: None

Training accuracy: 0.9920185040396143
Training confusion matrix:
[[14712     0     0     3     0     0     0     1     0     0     0     0     0     0     0     0     3     0     0     0     0     0     0     0     0     0     0]
 [    0   234     0     0     0     0     0     0     0     0     0     0     0     0     0     0     0     0     0     0     0     0     0     0     0     0     0]
 [    0     0   294     0     0     0     0     0     0     0     0     0     0     0     0     0     0     0     0     0     0     0     0     0     0     0     0]
 [    1     0     0   193     0     0     0     0     0     0     0     0     0     0     0     0     0     0     0     0     0     0     0     0     0     0     0]
 [    0     0     0     0   193     0     0     0     0     0     0     0     0     0     0     0     0     0     0     0     0     0     0     0     0     0     0]
 [    0     0     0     0     0   128     0     0     0     0     0     0     4     1     0     0     0     3     4    26     0     0     0     0     0     0     0]
 [    0     0     0     0     0     0   117     0     0     0     0     0     0     0     0     0     0     0     0     0     0     0     0     0     0     0     0]
 [    0     0     0     0     0     0     0   999     0     0     0     0     0     0     0     0     0     0     0     0     0     0     0     0     0     0     0]
 [    0     0     0     0     0     0     0     0   181     0     0     0     0     0     0     0     0     0     0     0     0     0     0     0     0     0     0]
 [    0     0     0     0     0     0     0     0     0  6822     0     0     0     0     0     0     0     0     0     0     0     0     0     0     0     0     0]
 [    0     0     0     0     0     0     0     0     0     0   211     0     0     0     0     0     0     0     0     0     0     0     0     0     0     0     0]
 [    0     0     0     0     0     0     0     0     0     0     0  1181     0     0     0     0     0     0     0     0     0     0     0     0     0     0     0]
 [    0     0     0     0     0     1     0     0     0     0     0     0    87     3     0     0     0     6     0     8     0     0     0     0     0     0     0]
 [    0     0     0     0     0     5     0     0     0     0     0     0     2    72     0     0     0     2     0     5     0     0     0     0     0     0     0]
 [    0     0     0     0     0     2     0     0     0     0     0     0     0     1   310     0     0     1     2     4     0     0     0     0     0     0     0]
 [    0     0     0     0     0     0     0     0     0     0     0     0     0     0     0    51     0     0     0     0     0     0     0     0     0     0     0]
 [    2     0     0     0     0     0     0     0     0     0     0     0     0     0     0     0   402     0     0     0     0     0     0     0     0     0     0]
 [    0     0     0     0     0     8     0     0     0     0     0     0     4     9     1     0     0   241     0    23     0     0     0     0     0     0     0]
 [    0     0     0     0     0     3     0     0     0     0     0     0     0     0    11     0     0     1    95     8     0     0     0     0     0     0     0]
 [    1     0     0     0     0    10     0     0     0     0     0     0    18     8     3     0     0    42     2   296     0     0     0     0     0     0     0]
 [    1     0     0     0     0     0     0     0     0     0     0     0     0     0     0     0     0     0     0     0  1004     0     0     0     0     0     0]
 [    0     0     0     0     0     0     0     0     0     0     0     0     0     0     0     0     0     0     0     0     0   214     0     0     0     0     0]
 [    0     0     0     0     0     0     0     0     1     0     0     0     0     0     0     0     0     0     0     0     0     0  2106     0     0     0     0]
 [    1     0     0     0     0     0     0     0     0     0     0     0     0     0     0     0     0     0     0     0     0     0     0    35     0     0     0]
 [    0     0     0     0     0     0     0     0     0     0     0     0     0     0     0     0     0     0     0     0     0     0     0     0    32     0     0]
 [    0     0     0     0     0     0     0     0     0     0     0     0     0     0     0     0     0     0     0     0     0     0     0     0     0    59     0]
 [    0     0     0     0     0     0     0     0     0     0     0     0     0     0     0     0     0     0     0     0     0     0     0     0     0     0   182]]

Accuracy: 0.9809747198332031

Precision: [0.9959 0.9552 0.9559 0.9412 1.0000 0.5600 1.0000 0.9919 1.0000 0.9983 0.9831 0.9966 0.5000 0.6250 0.8659 1.0000 1.0000 0.6216 0.8889 0.6145 1.0000 1.0000 0.9963 1.0000 0.6250 1.0000 1.0000]
Mean: 0.8931531855604549
Std: 0.16628564144321623

Recall: [0.9961 1.0000 0.9848 0.9600 1.0000 0.5385 1.0000 0.9959 0.9302 0.9988 1.0000 1.0000 0.5333 0.6818 0.9103 1.0000 0.9725 0.6970 0.6000 0.5930 0.9918 0.9286 1.0000 0.8889 0.8333 0.9375 1.0000]
Mean: 0.8878670802842182
Std: 0.1580835373343347

F1 score: [0.9960 0.9771 0.9701 0.9505 1.0000 0.5490 1.0000 0.9939 0.9639 0.9986 0.9915 0.9983 0.5161 0.6522 0.8875 1.0000 0.9860 0.6571 0.7164 0.6036 0.9959 0.9630 0.9981 0.9412 0.7143 0.9677 1.0000]
Mean: 0.8884448307976615
Std: 0.15908498082672626

Cohen Kappa score: 0.9733994586937377
Confusion matrix:
[[3621    2    1    3    0    0    0    1    0    2    1    1    0    0    1    0    0    0    0    0    0    0    0    0    2    0    0]
 [   0   64    0    0    0    0    0    0    0    0    0    0    0    0    0    0    0    0    0    0    0    0    0    0    0    0    0]
 [   1    0   65    0    0    0    0    0    0    0    0    0    0    0    0    0    0    0    0    0    0    0    0    0    0    0    0]
 [   2    0    0   48    0    0    0    0    0    0    0    0    0    0    0    0    0    0    0    0    0    0    0    0    0    0    0]
 [   0    0    0    0   59    0    0    0    0    0    0    0    0    0    0    0    0    0    0    0    0    0    0    0    0    0    0]
 [   0    0    0    0    0   14    0    0    0    0    0    0    2    0    1    0    0    0    0    9    0    0    0    0    0    0    0]
 [   0    0    0    0    0    0   34    0    0    0    0    0    0    0    0    0    0    0    0    0    0    0    0    0    0    0    0]
 [   0    0    1    0    0    0    0  245    0    0    0    0    0    0    0    0    0    0    0    0    0    0    0    0    0    0    0]
 [   1    0    0    0    0    0    0    0   40    0    0    0    0    0    0    0    0    0    0    0    0    0    2    0    0    0    0]
 [   2    0    0    0    0    0    0    0    0 1728    0    0    0    0    0    0    0    0    0    0    0    0    0    0    0    0    0]
 [   0    0    0    0    0    0    0    0    0    0   58    0    0    0    0    0    0    0    0    0    0    0    0    0    0    0    0]
 [   0    0    0    0    0    0    0    0    0    0    0  296    0    0    0    0    0    0    0    0    0    0    0    0    0    0    0]
 [   0    0    0    0    0    1    0    0    0    0    0    0   16    3    0    0    0    5    0    5    0    0    0    0    0    0    0]
 [   0    0    0    0    0    4    0    0    0    0    0    0    2   15    0    0    0    0    0    1    0    0    0    0    0    0    0]
 [   0    0    0    0    0    0    0    0    0    0    0    0    2    1   71    0    0    0    2    2    0    0    0    0    0    0    0]
 [   0    0    0    0    0    0    0    0    0    0    0    0    0    0    0   17    0    0    0    0    0    0    0    0    0    0    0]
 [   2    0    0    0    0    0    0    0    0    0    0    0    0    0    0    0  106    0    0    0    0    0    0    0    1    0    0]
 [   2    0    0    0    0    5    0    0    0    0    0    0    2    1    0    0    0   46    0   10    0    0    0    0    0    0    0]
 [   0    0    0    0    0    1    0    0    0    0    0    0    0    1    8    0    0    1   24    5    0    0    0    0    0    0    0]
 [   0    0    0    0    0    0    0    0    0    0    0    0    8    3    1    0    0   22    1   51    0    0    0    0    0    0    0]
 [   1    0    0    0    0    0    0    1    0    0    0    0    0    0    0    0    0    0    0    0  241    0    0    0    0    0    0]
 [   4    0    0    0    0    0    0    0    0    0    0    0    0    0    0    0    0    0    0    0    0   52    0    0    0    0    0]
 [   0    0    0    0    0    0    0    0    0    0    0    0    0    0    0    0    0    0    0    0    0    0  539    0    0    0    0]
 [   0    0    0    0    0    0    0    0    0    1    0    0    0    0    0    0    0    0    0    0    0    0    0    8    0    0    0]
 [   0    1    0    0    0    0    0    0    0    0    0    0    0    0    0    0    0    0    0    0    0    0    0    0    5    0    0]
 [   0    0    1    0    0    0    0    0    0    0    0    0    0    0    0    0    0    0    0    0    0    0    0    0    0   15    0]
 [   0    0    0    0    0    0    0    0    0    0    0    0    0    0    0    0    0    0    0    0    0    0    0    0    0    0   50]]

