Classifier: MLPClassifier
Params: {'activation': 'relu', 'alpha': 0.0001, 'batch_size': 'auto', 'beta_1': 0.9, 'beta_2': 0.999, 'early_stopping': False, 'epsilon': 1e-08, 'hidden_layer_sizes': (100,), 'learning_rate': 'constant', 'learning_rate_init': 0.001, 'max_iter': 200, 'momentum': 0.9, 'nesterovs_momentum': True, 'power_t': 0.5, 'random_state': None, 'shuffle': True, 'solver': 'adam', 'tol': 0.0001, 'validation_fraction': 0.1, 'verbose': False, 'warm_start': False}

Labels: None

Training accuracy: 0.9881743549648163
Training confusion matrix:
[[14679     0     0     3     0     0     0     3     0    17     0     0     3     0     0     0     5     0     0     3     0     0     1     2     3     0     0]
 [    0   234     0     0     0     0     0     0     0     0     0     0     0     0     0     0     0     0     0     0     0     0     0     0     0     0     0]
 [    0     0   294     0     0     0     0     0     0     0     0     0     0     0     0     0     0     0     0     0     0     0     0     0     0     0     0]
 [    6     0     0   186     0     0     0     0     0     0     0     0     0     0     0     0     0     0     0     0     0     0     0     0     2     0     0]
 [    0     0     0     0   193     0     0     0     0     0     0     0     0     0     0     0     0     0     0     0     0     0     0     0     0     0     0]
 [    0     0     0     0     0   111     0     0     0     0     0     0     8     3     2     0     0     2     5    35     0     0     0     0     0     0     0]
 [    0     0     0     0     0     0   117     0     0     0     0     0     0     0     0     0     0     0     0     0     0     0     0     0     0     0     0]
 [    0     0     0     0     0     0     0   999     0     0     0     0     0     0     0     0     0     0     0     0     0     0     0     0     0     0     0]
 [    0     0     0     0     0     0     0     0   181     0     0     0     0     0     0     0     0     0     0     0     0     0     0     0     0     0     0]
 [    0     0     0     0     0     0     0     0     0  6822     0     0     0     0     0     0     0     0     0     0     0     0     0     0     0     0     0]
 [    0     0     0     0     0     0     0     0     0     0   211     0     0     0     0     0     0     0     0     0     0     0     0     0     0     0     0]
 [    0     0     0     0     0     0     0     0     0     0     0  1181     0     0     0     0     0     0     0     0     0     0     0     0     0     0     0]
 [    0     0     0     0     0     1     0     0     0     0     0     0    98     0     0     0     0     0     1     5     0     0     0     0     0     0     0]
 [    0     0     0     0     0     3     0     0     0     0     0     0    11    57     2     0     0     3     2     8     0     0     0     0     0     0     0]
 [    0     0     0     0     0     1     0     0     0     0     0     0     0     0   315     0     0     0     0     4     0     0     0     0     0     0     0]
 [    0     0     0     0     0     0     0     3     0     0     0     0     0     0     0    48     0     0     0     0     0     0     0     0     0     0     0]
 [    5     0     0     0     0     0     0     0     0     0     0     0     0     0     0     0   399     0     0     0     0     0     0     0     0     0     0]
 [    0     0     0     0     0     8     0     0     0     0     0     0    19     8     1     0     0   170     2    78     0     0     0     0     0     0     0]
 [    1     0     0     0     0     0     0     0     0     0     0     0     1     0    19     0     0     0    91     6     0     0     0     0     0     0     0]
 [    0     0     0     0     0     7     0     0     0     0     0     0    35     6     9     0     0    10     1   312     0     0     0     0     0     0     0]
 [    0     0     0     0     0     0     0     0     0     0     0     0     0     0     0     0     0     0     0     0  1005     0     0     0     0     0     0]
 [    0     0     0     0     0     0     0     0     0     0     0     0     0     0     0     0     0     0     0     0     0   214     0     0     0     0     0]
 [    0     0     0     0     0     0     0     0     0     0     0     0     0     0     0     0     0     0     0     0     0     0  2107     0     0     0     0]
 [    0     0     0     0     0     0     0     0     0     0     0     0     0     0     0     0     0     0     0     0     0     0     0    36     0     0     0]
 [    0     0     0     0     0     0     0     0     0     0     0     0     0     0     0     0     0     0     0     0     0     0     0     0    32     0     0]
 [    0     0     0     0     0     0     0     0     0     0     0     0     0     0     0     0     0     0     0     0     0     0     0     0     0    59     0]
 [    0     0     0     0     0     0     0     0     0     0     0     0     0     0     0     0     0     0     0     0     0     0     0     0     0     0   182]]

Accuracy: 0.979410998175658

Precision: [0.9969 0.9545 0.9559 0.9216 1.0000 0.6087 1.0000 0.9879 1.0000 0.9897 1.0000 0.9932 0.5294 0.6667 0.8111 1.0000 0.9813 0.9024 0.8519 0.6300 0.9918 0.9636 0.9981 1.0000 0.5455 1.0000 1.0000]
Mean: 0.8992711765835366
Std: 0.1533096237639312

Recall: [0.9890 0.9844 0.9848 0.9400 1.0000 0.5385 1.0000 0.9959 0.9767 1.0000 0.9828 0.9932 0.9000 0.6364 0.9359 1.0000 0.9633 0.5606 0.5750 0.7326 0.9959 0.9464 1.0000 0.7778 1.0000 1.0000 0.9800]
Mean: 0.9033030019872618
Std: 0.15045959672813386

F1 score: [0.9930 0.9692 0.9701 0.9307 1.0000 0.5714 1.0000 0.9919 0.9882 0.9948 0.9913 0.9932 0.6667 0.6512 0.8690 1.0000 0.9722 0.6916 0.6866 0.6774 0.9938 0.9550 0.9991 0.8750 0.7059 1.0000 0.9899]
Mean: 0.8936034341047525
Std: 0.14109424120196798

Cohen Kappa score: 0.9712669925165247
Confusion matrix:
[[3595    3    1    4    0    0    0    2    0   14    0    2    1    0    1    0    2    0    1    2    1    2    0    0    4    0    0]
 [   1   63    0    0    0    0    0    0    0    0    0    0    0    0    0    0    0    0    0    0    0    0    0    0    0    0    0]
 [   1    0   65    0    0    0    0    0    0    0    0    0    0    0    0    0    0    0    0    0    0    0    0    0    0    0    0]
 [   3    0    0   47    0    0    0    0    0    0    0    0    0    0    0    0    0    0    0    0    0    0    0    0    0    0    0]
 [   0    0    0    0   59    0    0    0    0    0    0    0    0    0    0    0    0    0    0    0    0    0    0    0    0    0    0]
 [   0    0    0    0    0   14    0    0    0    0    0    0    4    1    1    0    0    0    0    6    0    0    0    0    0    0    0]
 [   0    0    0    0    0    0   34    0    0    0    0    0    0    0    0    0    0    0    0    0    0    0    0    0    0    0    0]
 [   0    0    1    0    0    0    0  245    0    0    0    0    0    0    0    0    0    0    0    0    0    0    0    0    0    0    0]
 [   0    0    0    0    0    0    0    0   42    0    0    0    0    0    0    0    0    0    0    0    0    0    1    0    0    0    0]
 [   0    0    0    0    0    0    0    0    0 1730    0    0    0    0    0    0    0    0    0    0    0    0    0    0    0    0    0]
 [   0    0    0    0    0    0    0    0    0    1   57    0    0    0    0    0    0    0    0    0    0    0    0    0    0    0    0]
 [   0    0    0    0    0    0    0    0    0    2    0  294    0    0    0    0    0    0    0    0    0    0    0    0    0    0    0]
 [   0    0    0    0    0    1    0    0    0    0    0    0   27    0    0    0    0    0    0    2    0    0    0    0    0    0    0]
 [   0    0    0    0    0    3    0    0    0    0    0    0    4   14    0    0    0    0    0    1    0    0    0    0    0    0    0]
 [   0    0    0    0    0    0    0    0    0    0    0    0    2    1   73    0    0    0    1    1    0    0    0    0    0    0    0]
 [   0    0    0    0    0    0    0    0    0    0    0    0    0    0    0   17    0    0    0    0    0    0    0    0    0    0    0]
 [   3    0    0    0    0    0    0    0    0    0    0    0    0    0    0    0  105    0    0    0    0    0    0    0    1    0    0]
 [   0    0    0    0    0    3    0    0    0    0    0    0    2    2    2    0    0   37    0   20    0    0    0    0    0    0    0]
 [   0    0    0    0    0    1    0    0    0    0    0    0    0    0   10    0    0    1   23    5    0    0    0    0    0    0    0]
 [   0    0    0    0    0    1    0    0    0    0    0    0   11    3    3    0    0    3    2   63    0    0    0    0    0    0    0]
 [   1    0    0    0    0    0    0    0    0    0    0    0    0    0    0    0    0    0    0    0  242    0    0    0    0    0    0]
 [   1    0    1    0    0    0    0    1    0    0    0    0    0    0    0    0    0    0    0    0    0   53    0    0    0    0    0]
 [   0    0    0    0    0    0    0    0    0    0    0    0    0    0    0    0    0    0    0    0    0    0  539    0    0    0    0]
 [   1    0    0    0    0    0    0    0    0    1    0    0    0    0    0    0    0    0    0    0    0    0    0    7    0    0    0]
 [   0    0    0    0    0    0    0    0    0    0    0    0    0    0    0    0    0    0    0    0    0    0    0    0    6    0    0]
 [   0    0    0    0    0    0    0    0    0    0    0    0    0    0    0    0    0    0    0    0    0    0    0    0    0   16    0]
 [   0    0    0    0    0    0    0    0    0    0    0    0    0    0    0    0    0    0    0    0    1    0    0    0    0    0   49]]

