Classifier: MultinomialNB
Params: {'alpha': 1.0, 'class_prior': None, 'fit_prior': True}

Labels: None

Training accuracy: 0.8984232473286422
Training confusion matrix:
[[12907   163    15   390     9     6     5    77     0    31   303     1     2     0   153     3    29    83    11    44    30    20    16    18   164     0   239]
 [    4   230     0     0     0     0     0     0     0     0     0     0     0     0     0     0     0     0     0     0     0     0     0     0     0     0     0]
 [    2     0   275     0     5     0    10     0     0     0     0     0     0     0     0     0     0     0     0     0     0     2     0     0     0     0     0]
 [    6     0     0   188     0     0     0     0     0     0     0     0     0     0     0     0     0     0     0     0     0     0     0     0     0     0     0]
 [    0     0     0     1   189     0     2     0     0     0     0     0     0     0     0     0     1     0     0     0     0     0     0     0     0     0     0]
 [    0     2     0     0     0   100     0     0     0     0     0     0     2     0    10     0     0     9     0    43     0     0     0     0     0     0     0]
 [    0     0     0     0     1     0   116     0     0     0     0     0     0     0     0     0     0     0     0     0     0     0     0     0     0     0     0]
 [    5     1    14     0    29     0    10   913     1     0     0     0     0     0     0     0     0     0     0     0    13     4     0     0     0     0     9]
 [    0     0     0     0     1     0     0     0   180     0     0     0     0     0     0     0     0     0     0     0     0     0     0     0     0     0     0]
 [  233     0     0    22    24     0     0     1     4  6504    15     2     0     0     3     0    11     0     0     0     0     0     3     0     0     0     0]
 [   12     0     0     0     0     0     0     0     0     0   199     0     0     0     0     0     0     0     0     0     0     0     0     0     0     0     0]
 [   26     0     0     0     0     0     0     0     0     1     1  1153     0     0     0     0     0     0     0     0     0     0     0     0     0     0     0]
 [    0     0     0     0     0    14     0     0     0     0     0     0    34     0     3     0     0    17     0    37     0     0     0     0     0     0     0]
 [    0     0     0     0     0    11     0     0     0     0     0     0    10     4     5     0     0    26     0    30     0     0     0     0     0     0     0]
 [    3     0     0     2     0    18     0     0     0     0     0     0     0     4   239     0     0    38     3    13     0     0     0     0     0     0     0]
 [    0     0     0     0     1     0     3     0     0     0     0     0     0     0     0    34     8     0     0     0     0     0     4     0     0     0     1]
 [   37     0     0    17     3     0     0     0     0     0     0     0     0     0     0     0   347     0     0     0     0     0     0     0     0     0     0]
 [    2     0     0     0     0    14     0     0     0     0     0     0     4     0    21     0     0   148     6    91     0     0     0     0     0     0     0]
 [    1     0     0     0     0     8     0     0     0     0     0     0     5     0    35     0     0    18    34    17     0     0     0     0     0     0     0]
 [    0     5     0     1     0    39     2     0     0     0     6     0    13     0    14     0     0    55     0   243     1     0     1     0     0     0     0]
 [    4     0     1     0     2     0     0     0     1     0     0     0     0     0     0     0     0     0     0     0   991     0     0     0     0     0     6]
 [    0     0     7     0     0     0     0     2     0     0     0     0     0     0     0     0     0     0     0     0     2   202     0     0     0     0     1]
 [    4     0     0     0    18     0     1     0     1     0     0     0     0     0     0     2     3     0     0     0     0     0  2078     0     0     0     0]
 [    4    17     0     0     0     0     0     0     0     0     0     0     0     0     0     0     0     0     0     0     0     0     0    15     0     0     0]
 [    3     0     0     0     0     0     0     0     0     0     0     0     0     0     0     0     0     0     0     0     0     0     0     0    29     0     0]
 [    0     0     0     0     2     0     0     4     0     0     0     0     0     0     0     0     2     0     0     0     0     0     0     0     0    51     0]
 [    0     0     1     0     2     0     2     0     0     0     0     0     0     0     0     0     0     0     0     0     2     0     0     0     0     0   175]]

Accuracy: 0.892624446181913

Precision: [0.9699 0.5299 0.8101 0.2994 0.6042 0.3182 0.7805 0.9087 0.9111 0.9928 0.4109 0.9930 0.6667 0.0000 0.5045 1.0000 0.9184 0.3143 0.5238 0.4174 0.9600 0.8750 0.9925 0.5000 0.1190 1.0000 0.3934]
Mean: 0.6560588787446434
Std: 0.29807951596430704

Recall: [0.8768 0.9688 0.9697 0.9400 0.9831 0.5385 0.9412 0.8496 0.9535 0.9509 0.9138 0.9595 0.4000 0.0000 0.7179 0.8824 0.8257 0.5000 0.2750 0.5581 0.9877 0.8750 0.9870 0.3333 0.8333 0.7500 0.9600]
Mean: 0.7677983086630527
Std: 0.2599758425928876

F1 score: [0.9210 0.6851 0.8828 0.4541 0.7484 0.4000 0.8533 0.8782 0.9318 0.9714 0.5668 0.9759 0.5000 0.0000 0.5926 0.9375 0.8696 0.3860 0.3607 0.4776 0.9736 0.8750 0.9898 0.4000 0.2083 0.8571 0.5581]
Mean: 0.6760984536033432
Std: 0.26889850699591555

Cohen Kappa score: 0.8546432747053925
Confusion matrix:
[[3187   49    6   99    4    4    1   19    0   11   70    2    0    0   29    0    3   18    4   13    5    6    0    3   36    0   66]
 [   2   62    0    0    0    0    0    0    0    0    0    0    0    0    0    0    0    0    0    0    0    0    0    0    0    0    0]
 [   0    1   64    0    1    0    0    0    0    0    0    0    0    0    0    0    0    0    0    0    0    0    0    0    0    0    0]
 [   3    0    0   47    0    0    0    0    0    0    0    0    0    0    0    0    0    0    0    0    0    0    0    0    0    0    0]
 [   0    0    0    0   58    0    1    0    0    0    0    0    0    0    0    0    0    0    0    0    0    0    0    0    0    0    0]
 [   0    0    0    0    0   14    0    0    0    0    0    0    1    0    2    0    0    1    0    8    0    0    0    0    0    0    0]
 [   0    0    0    0    2    0   32    0    0    0    0    0    0    0    0    0    0    0    0    0    0    0    0    0    0    0    0]
 [   0    0    5    0   15    0    4  209    0    0    0    0    0    0    0    0    0    0    0    0    4    1    0    0    0    0    8]
 [   1    0    0    0    0    0    0    0   41    0    0    0    0    0    0    0    0    0    0    0    0    0    1    0    0    0    0]
 [  61    0    0    6    2    0    0    0    4 1645    5    0    0    0    0    0    4    0    1    0    0    0    2    0    0    0    0]
 [   5    0    0    0    0    0    0    0    0    0   53    0    0    0    0    0    0    0    0    0    0    0    0    0    0    0    0]
 [  10    0    0    1    0    0    0    0    0    1    0  284    0    0    0    0    0    0    0    0    0    0    0    0    0    0    0]
 [   0    0    0    0    0    2    0    0    0    0    0    0   12    0    1    0    0    8    0    7    0    0    0    0    0    0    0]
 [   0    0    0    0    0    6    0    0    0    0    0    0    1    0    1    0    0    8    0    6    0    0    0    0    0    0    0]
 [   0    0    0    0    0    5    0    0    0    0    0    0    2    0   56    0    0   10    2    3    0    0    0    0    0    0    0]
 [   0    0    0    0    1    0    0    0    0    0    0    0    0    0    0   15    1    0    0    0    0    0    0    0    0    0    0]
 [  11    0    0    4    1    0    2    0    0    0    0    0    0    0    0    0   90    0    0    0    0    0    0    0    1    0    0]
 [   0    0    0    0    0    4    0    0    0    0    0    0    0    0    4    0    0   33    1   24    0    0    0    0    0    0    0]
 [   1    0    0    0    0    4    0    0    0    0    0    0    0    0   10    0    0    8   11    6    0    0    0    0    0    0    0]
 [   0    1    0    0    0    5    0    0    0    0    1    0    2    0    8    0    0   19    2   48    0    0    0    0    0    0    0]
 [   1    0    1    0    1    0    0    0    0    0    0    0    0    0    0    0    0    0    0    0  240    0    0    0    0    0    0]
 [   1    0    2    0    1    0    0    2    0    0    0    0    0    0    0    0    0    0    0    0    1   49    0    0    0    0    0]
 [   0    0    0    0    7    0    0    0    0    0    0    0    0    0    0    0    0    0    0    0    0    0  532    0    0    0    0]
 [   2    4    0    0    0    0    0    0    0    0    0    0    0    0    0    0    0    0    0    0    0    0    0    3    0    0    0]
 [   1    0    0    0    0    0    0    0    0    0    0    0    0    0    0    0    0    0    0    0    0    0    0    0    5    0    0]
 [   0    0    0    0    3    0    0    0    0    0    0    0    0    0    0    0    0    0    0    0    0    0    1    0    0   12    0]
 [   0    0    1    0    0    0    1    0    0    0    0    0    0    0    0    0    0    0    0    0    0    0    0    0    0    0   48]]

