Classifier: GradientBoostingClassifier
Params: {'criterion': 'friedman_mse', 'init': None, 'learning_rate': 0.1, 'loss': 'deviance', 'max_depth': 3, 'max_features': None, 'max_leaf_nodes': None, 'min_impurity_decrease': 0.0, 'min_impurity_split': None, 'min_samples_leaf': 1, 'min_samples_split': 2, 'min_weight_fraction_leaf': 0.0, 'n_estimators': 100, 'presort': 'auto', 'random_state': None, 'subsample': 1.0, 'verbose': 0, 'warm_start': False}

Labels: None

Training accuracy: 0.9700286682303884
Training confusion matrix:
[[14460    28     7     1     0     3     2    21     0    59     0     5     0     0    11     0     0     0     6     3    25    11     5     0     1     2     0]
 [   28   216     0     0     0     0     0     0     0     0     0     0     0     0     0     0     0     0     0     0     0     0     0     0     0     0     0]
 [    4     0   276     0     0     0     0     0     0     0     0     0     0     0     0     0     0     0     0     0     1     0     0     0     0     2     1]
 [   97     0     0   103     0     0     0     0     0     0     0     0     0     0     0     0     0     0     0     0     0     0     0     0     0     0     0]
 [    2     0     0     0   191     0     0     0     0     0     0     0     0     0     0     0     0     0     0     0     0     0     0     0     0     0     0]
 [    0     0     0     0     0   132     0     0     0     0     0     0     4     4     0     0     0     4     1    11     0     0     0     0     0     0     0]
 [    0     0     0     0     0     0   119     0     0     0     0     0     0     0     0     0     0     0     0     0     0     0     0     0     0     0     0]
 [    5     0     0     0     0     0     0  1013     0     0     0     0     0     0     0     0     0     0     0     0     8     0     0     0     0     0     0]
 [    0     0     0     0     0     0     0     0   177     0     0     0     0     0     0     0     0     0     0     0     0     0     0     0     0     0     0]
 [  102     0     0     0     0     0     0     0     0  6756     0     0     0     0     0     0     0     0     0     0     0     0     0     0     0     0     0]
 [    9     0     0     0     0     0     0     0     0     0   200     0     0     0     0     0     0     0     0     0     0     0     0     0     0     0     0]
 [   33     0     0     0     0     0     0     0     0     0     0  1135     0     0     0     0     0     0     0     0     0     0     0     0     0     0     0]
 [    0     0     0     0     0     1     0     0     0     0     0     0    89     1     1     0     0     5     0    11     0     0     0     0     0     0     0]
 [    0     0     0     0     0     3     0     0     0     0     0     0     2    79     0     0     0     2     0     3     0     0     0     0     0     0     0]
 [    6     0     0     0     0     6     0     0     0     1     0     0     1     2   288     0     0     2     9     6     0     0     0     0     0     0     0]
 [    1     0     0     0     0     0     0     0     0     0     0     0     0     0     0    56     0     0     0     0     0     0     0     0     0     0     0]
 [   59     0     0     0     0     0     0     0     0     0     0     0     0     0     0     0   338     0     0     0     0     0     0     0     0     0     0]
 [   26     0     0     0     0     5     0     0     0     0     0     0     8     3     2     0     0   209     5    30     0     0     0     0     0     0     0]
 [    5     0     0     0     0     6     0     0     0     0     0     0     2     1    10     0     0     4    87     8     0     0     0     0     0     0     0]
 [   14     0     0     0     0    13     0     0     0     4     0     0    17     5     0     0     0    47     1   265     0     0     0     0     0     0     0]
 [    2     0     0     0     0     0     0     0     0     0     0     0     0     0     0     0     0     0     0     0   998     0     0     0     0     0     0]
 [    2     0     0     0     0     0     0     1     0     0     0     0     0     0     0     0     0     0     0     0     0   211     0     0     0     0     0]
 [    1     0     0     0     0     0     0     0     1     0     0     0     0     0     0     0     0     0     0     0     0     0  2142     0     0     0     0]
 [   31     0     0     0     0     0     0     0     0     0     0     0     0     0     0     0     0     0     0     0     0     0     0     1     0     0     0]
 [    2     0     0     0     0     0     0     0     0     0     0     0     0     0     0     0     0     0     0     0     0     0     0     0    28     0     0]
 [    2     0     5     0     0     0     0     0     0     0     0     0     0     0     0     0     0     0     0     0     0     0     0     0     0    50     0]
 [   11     0     7     0     0     0     0     0     0     0     0     0     0     0     0     0     0     0     0     0     0     0     0     0     0    11   157]]

Accuracy: 0.9579098253844149

Precision: [0.9645 0.8571 0.9351 1.0000 1.0000 0.5366 0.9697 0.9730 1.0000 0.9910 0.9821 1.0000 0.5484 0.5417 0.8148 1.0000 0.9709 0.6308 0.6875 0.6235 0.9533 0.9000 0.9960 0.0000 0.8889 0.8000 1.0000]
Mean: 0.8357377497112289
Std: 0.22800208782525336

Recall: [0.9833 0.8889 0.9474 0.3864 0.9831 0.6111 1.0000 0.9863 1.0000 0.9793 0.9167 0.9612 0.6296 0.6842 0.8571 1.0000 0.8621 0.6406 0.6286 0.5300 0.9879 0.9643 0.9980 0.0000 1.0000 0.8889 0.8478]
Mean: 0.8208398690095318
Std: 0.23469028357828942

F1 score: [0.9738 0.8727 0.9412 0.5574 0.9915 0.5714 0.9846 0.9796 1.0000 0.9852 0.9483 0.9802 0.5862 0.6047 0.8354 1.0000 0.9132 0.6357 0.6567 0.5730 0.9703 0.9310 0.9970 0.0000 0.9412 0.8421 0.9176]
Mean: 0.8218504180299102
Std: 0.22631781463272915

Cohen Kappa score: 0.9403462274536563
Confusion matrix:
[[3642    8    0    0    0    3    1    5    0   15    1    0    0    0    5    0    3    1    2    1    8    6    2    0    1    0    0]
 [   6   48    0    0    0    0    0    0    0    0    0    0    0    0    0    0    0    0    0    0    0    0    0    0    0    0    0]
 [   0    0   72    0    0    0    0    0    0    0    0    0    0    0    0    0    0    0    0    0    1    0    0    0    0    3    0]
 [  27    0    0   17    0    0    0    0    0    0    0    0    0    0    0    0    0    0    0    0    0    0    0    0    0    0    0]
 [   1    0    0    0   58    0    0    0    0    0    0    0    0    0    0    0    0    0    0    0    0    0    0    0    0    0    0]
 [   0    0    0    0    0   22    0    0    0    0    0    0    2    0    1    0    0    5    0    6    0    0    0    0    0    0    0]
 [   0    0    0    0    0    0   32    0    0    0    0    0    0    0    0    0    0    0    0    0    0    0    0    0    0    0    0]
 [   1    0    0    0    0    0    0  216    0    0    0    0    0    0    0    0    0    0    0    0    2    0    0    0    0    0    0]
 [   0    0    0    0    0    0    0    0   47    0    0    0    0    0    0    0    0    0    0    0    0    0    0    0    0    0    0]
 [  35    0    0    0    0    0    0    0    0 1659    0    0    0    0    0    0    0    0    0    0    0    0    0    0    0    0    0]
 [   5    0    0    0    0    0    0    0    0    0   55    0    0    0    0    0    0    0    0    0    0    0    0    0    0    0    0]
 [  12    0    0    0    0    0    0    0    0    0    0  297    0    0    0    0    0    0    0    0    0    0    0    0    0    0    0]
 [   0    0    0    0    0    0    0    0    0    0    0    0   17    2    0    0    0    1    0    7    0    0    0    0    0    0    0]
 [   0    0    0    0    0    1    0    0    0    0    0    0    2   13    1    0    0    0    0    2    0    0    0    0    0    0    0]
 [   2    0    0    0    0    3    0    0    0    0    0    0    0    0   66    0    0    0    4    2    0    0    0    0    0    0    0]
 [   0    0    0    0    0    0    0    0    0    0    0    0    0    0    0   11    0    0    0    0    0    0    0    0    0    0    0]
 [  16    0    0    0    0    0    0    0    0    0    0    0    0    0    0    0  100    0    0    0    0    0    0    0    0    0    0]
 [   4    0    0    0    0    0    0    0    0    0    0    0    4    2    0    0    0   41    0   13    0    0    0    0    0    0    0]
 [   1    0    0    0    0    2    0    0    0    0    0    0    0    2    7    0    0    0   22    1    0    0    0    0    0    0    0]
 [   4    0    0    0    0   10    0    0    0    0    0    0    6    5    1    0    0   17    4   53    0    0    0    0    0    0    0]
 [   2    0    0    0    0    0    0    1    0    0    0    0    0    0    0    0    0    0    0    0  245    0    0    0    0    0    0]
 [   1    0    0    0    0    0    0    0    0    0    0    0    0    0    0    0    0    0    0    0    1   54    0    0    0    0    0]
 [   1    0    0    0    0    0    0    0    0    0    0    0    0    0    0    0    0    0    0    0    0    0  501    0    0    0    0]
 [  13    0    0    0    0    0    0    0    0    0    0    0    0    0    0    0    0    0    0    0    0    0    0    0    0    0    0]
 [   0    0    0    0    0    0    0    0    0    0    0    0    0    0    0    0    0    0    0    0    0    0    0    0    8    0    0]
 [   0    0    2    0    0    0    0    0    0    0    0    0    0    0    0    0    0    0    0    0    0    0    0    0    0   16    0]
 [   3    0    3    0    0    0    0    0    0    0    0    0    0    0    0    0    0    0    0    0    0    0    0    0    0    1   39]]

