Classifier: LinearSVC
Params: {'C': 1.0, 'class_weight': None, 'dual': True, 'fit_intercept': True, 'intercept_scaling': 1, 'loss': 'squared_hinge', 'max_iter': 1000, 'multi_class': 'ovr', 'penalty': 'l2', 'random_state': None, 'tol': 0.0001, 'verbose': 0}

Labels: None

Training accuracy: 0.95217617930675
Training confusion matrix:
[[14334    23     9     0     1     9     2    16     0   131    21     5     0     0    21     0     4     6     9     7    30    10     7     0     1     3     1]
 [   60   184     0     0     0     0     0     0     0     0     0     0     0     0     0     0     0     0     0     0     0     0     0     0     0     0     0]
 [    8     0   256     0     0     0     0     1     0     0     0     0     0     0     0     0     0     0     0     0     2     0     0     0     0    15     2]
 [  102     0     0    98     0     0     0     0     0     0     0     0     0     0     0     0     0     0     0     0     0     0     0     0     0     0     0]
 [    4     0     0     0   189     0     0     0     0     0     0     0     0     0     0     0     0     0     0     0     0     0     0     0     0     0     0]
 [    4     0     0     0     0    95     0     0     0     0     0     0     9     3     0     0     0     4     6    35     0     0     0     0     0     0     0]
 [    0     0     0     0     0     0   119     0     0     0     0     0     0     0     0     0     0     0     0     0     0     0     0     0     0     0     0]
 [   37     0     7     0     0     0     0   971     0     0     0     0     0     0     0     0     0     0     0     0    11     0     0     0     0     0     0]
 [    0     0     0     0     0     0     0     0   177     0     0     0     0     0     0     0     0     0     0     0     0     0     0     0     0     0     0]
 [  215     0     0     0     0     0     0     0     0  6642     0     1     0     0     0     0     0     0     0     0     0     0     0     0     0     0     0]
 [   13     0     0     0     0     0     0     0     0     0   196     0     0     0     0     0     0     0     0     0     0     0     0     0     0     0     0]
 [   35     0     0     0     0     0     0     0     0     0     0  1133     0     0     0     0     0     0     0     0     0     0     0     0     0     0     0]
 [    0     0     0     0     0     1     0     0     0     0     0     0    77     7     0     0     0     6     0    17     0     0     0     0     0     0     0]
 [    0     0     0     0     0     8     0     0     0     0     0     0     0    78     0     0     0     1     0     2     0     0     0     0     0     0     0]
 [   30     0     0     0     0     5     0     0     0     0     0     0     1     2   266     0     0     2     3    12     0     0     0     0     0     0     0]
 [    1     0     0     0     0     0     0     0     0     0     0     0     0     0     0    56     0     0     0     0     0     0     0     0     0     0     0]
 [   63     0     0     0     0     0     0     0     0     0     0     0     0     0     0     0   333     0     0     0     0     0     0     0     1     0     0]
 [   34     0     0     0     0    11     0     0     0     0     0     0    14     7     4     0     0   174     7    37     0     0     0     0     0     0     0]
 [   12     0     0     0     0     0     0     0     0     0     0     0     3     1    21     0     0     6    67    13     0     0     0     0     0     0     0]
 [   14     0     0     2     0     9     0     0     0     4     4     0    31    14     6     0     0    61     2   219     0     0     0     0     0     0     0]
 [    4     0     1     0     0     0     0     1     0     0     0     0     0     0     0     0     0     0     0     0   993     1     0     0     0     0     0]
 [   10     0     0     0     0     0     0     1     0     0     0     0     0     0     0     0     0     0     0     0     0   203     0     0     0     0     0]
 [   11     0     0     1     0     0     0     0     1     0     0     0     0     0     0     0     0     0     0     0     0     0  2131     0     0     0     0]
 [   32     0     0     0     0     0     0     0     0     0     0     0     0     0     0     0     0     0     0     0     0     0     0     0     0     0     0]
 [    2     0     0     0     0     0     0     0     0     0     0     0     0     0     0     0     0     0     0     0     0     0     0     0    28     0     0]
 [    0     0     3     0     0     0     0     1     0     0     0     0     0     0     0     0     0     0     0     0     0     0     0     0     0    53     0]
 [   10     0     2     0     0     0     0     1     0     0     0     0     0     0     0     0     0     0     0     0     0     0     0     0     0    17   156]]

Accuracy: 0.9463122230909565

Precision: [0.9506 0.8491 0.9706 1.0000 0.9831 0.6471 0.9697 0.9680 1.0000 0.9795 0.8387 0.9867 0.5455 0.4643 0.7294 1.0000 0.9901 0.5932 0.6800 0.6463 0.9570 0.8983 1.0000 0.0000 0.8889 0.6000 1.0000]
Mean: 0.8198548428704454
Std: 0.23155499495776283

Recall: [0.9765 0.8333 0.8684 0.3864 0.9831 0.6111 1.0000 0.9680 1.0000 0.9610 0.8667 0.9612 0.6667 0.6842 0.8052 1.0000 0.8621 0.5469 0.4857 0.5300 0.9879 0.9464 0.9900 0.0000 1.0000 1.0000 0.8478]
Mean: 0.8062454459301641
Std: 0.2408879924658443

F1 score: [0.9634 0.8411 0.9167 0.5574 0.9831 0.6286 0.9846 0.9680 1.0000 0.9702 0.8525 0.9738 0.6000 0.5532 0.7654 1.0000 0.9217 0.5691 0.5667 0.5824 0.9722 0.9217 0.9950 0.0000 0.9412 0.7500 0.9176]
Mean: 0.803537081628469
Std: 0.22758299110858565

Cohen Kappa score: 0.9237565852042022
Confusion matrix:
[[3617    8    0    0    1    0    1    5    0   34    6    2    0    0    6    0    1    1    5    2    8    6    0    0    1    0    0]
 [   9   45    0    0    0    0    0    0    0    0    0    0    0    0    0    0    0    0    0    0    0    0    0    0    0    0    0]
 [   1    0   66    0    0    0    0    0    0    0    0    0    0    0    0    0    0    0    0    0    0    0    0    0    0    9    0]
 [  25    0    0   17    0    0    0    0    0    0    1    1    0    0    0    0    0    0    0    0    0    0    0    0    0    0    0]
 [   1    0    0    0   58    0    0    0    0    0    0    0    0    0    0    0    0    0    0    0    0    0    0    0    0    0    0]
 [   0    0    0    0    0   22    0    0    0    0    0    0    2    0    2    0    0    0    1    9    0    0    0    0    0    0    0]
 [   0    0    0    0    0    0   32    0    0    0    0    0    0    0    0    0    0    0    0    0    0    0    0    0    0    0    0]
 [   4    0    1    0    0    0    0  212    0    0    0    0    0    0    0    0    0    0    0    0    2    0    0    0    0    0    0]
 [   0    0    0    0    0    0    0    0   47    0    0    0    0    0    0    0    0    0    0    0    0    0    0    0    0    0    0]
 [  64    0    0    0    0    0    0    0    0 1628    1    1    0    0    0    0    0    0    0    0    0    0    0    0    0    0    0]
 [   8    0    0    0    0    0    0    0    0    0   52    0    0    0    0    0    0    0    0    0    0    0    0    0    0    0    0]
 [  12    0    0    0    0    0    0    0    0    0    0  297    0    0    0    0    0    0    0    0    0    0    0    0    0    0    0]
 [   0    0    0    0    0    0    0    0    0    0    0    0   18    3    0    0    0    4    0    2    0    0    0    0    0    0    0]
 [   0    0    0    0    0    3    0    0    0    0    0    0    0   13    1    0    0    1    0    1    0    0    0    0    0    0    0]
 [   9    0    0    0    0    3    0    0    0    0    0    0    1    0   62    0    0    0    1    1    0    0    0    0    0    0    0]
 [   0    0    0    0    0    0    0    0    0    0    0    0    0    0    0   11    0    0    0    0    0    0    0    0    0    0    0]
 [  16    0    0    0    0    0    0    0    0    0    0    0    0    0    0    0  100    0    0    0    0    0    0    0    0    0    0]
 [   7    0    0    0    0    1    0    0    0    0    0    0    5    2    2    0    0   35    0   12    0    0    0    0    0    0    0]
 [   6    0    0    0    0    0    0    0    0    0    0    0    1    2    7    0    0    0   17    2    0    0    0    0    0    0    0]
 [   3    0    0    0    0    5    0    0    0    0    1    0    6    8    5    0    0   18    1   53    0    0    0    0    0    0    0]
 [   2    0    0    0    0    0    0    1    0    0    0    0    0    0    0    0    0    0    0    0  245    0    0    0    0    0    0]
 [   1    0    0    0    0    0    0    1    0    0    0    0    0    0    0    0    0    0    0    0    1   53    0    0    0    0    0]
 [   4    0    0    0    0    0    0    0    0    0    1    0    0    0    0    0    0    0    0    0    0    0  497    0    0    0    0]
 [  13    0    0    0    0    0    0    0    0    0    0    0    0    0    0    0    0    0    0    0    0    0    0    0    0    0    0]
 [   0    0    0    0    0    0    0    0    0    0    0    0    0    0    0    0    0    0    0    0    0    0    0    0    8    0    0]
 [   0    0    0    0    0    0    0    0    0    0    0    0    0    0    0    0    0    0    0    0    0    0    0    0    0   18    0]
 [   3    0    1    0    0    0    0    0    0    0    0    0    0    0    0    0    0    0    0    0    0    0    0    0    0    3   39]]

