Classifier: LogisticRegression
Params: {'C': 1.0, 'class_weight': None, 'dual': False, 'fit_intercept': True, 'intercept_scaling': 1, 'max_iter': 100, 'multi_class': 'ovr', 'n_jobs': 1, 'penalty': 'l2', 'random_state': None, 'solver': 'liblinear', 'tol': 0.0001, 'verbose': 0, 'warm_start': False}

Labels: None

Training accuracy: 0.9483971853010165
Training confusion matrix:
[[14377    27     9     5     1     7     1    22     0   102     8     5     0     0    22     1     6     5     8     3    17     8    12     0     1     2     1]
 [   57   187     0     0     0     0     0     0     0     0     0     0     0     0     0     0     0     0     0     0     0     0     0     0     0     0     0]
 [   13     0   254     0     0     0     0     1     0     0     0     0     0     0     0     0     0     0     0     0     2     0     0     0     0    12     2]
 [  103     0     0    97     0     0     0     0     0     0     0     0     0     0     0     0     0     0     0     0     0     0     0     0     0     0     0]
 [    5     0     0     0   188     0     0     0     0     0     0     0     0     0     0     0     0     0     0     0     0     0     0     0     0     0     0]
 [    5     0     0     0     0    92     0     0     0     0     0     0     8     3     0     0     0     7     6    35     0     0     0     0     0     0     0]
 [    4     0     0     0     0     0   115     0     0     0     0     0     0     0     0     0     0     0     0     0     0     0     0     0     0     0     0]
 [   45     0     7     0     0     0     0   963     0     0     0     0     0     0     0     0     0     0     0     0    11     0     0     0     0     0     0]
 [    0     0     0     0     0     0     0     0   176     0     0     0     0     0     0     0     0     0     0     0     0     0     1     0     0     0     0]
 [  273     0     0     0     0     0     0     0     0  6585     0     0     0     0     0     0     0     0     0     0     0     0     0     0     0     0     0]
 [   24     0     0     0     0     0     0     0     0     0   184     0     0     0     0     0     0     0     0     1     0     0     0     0     0     0     0]
 [   37     0     0     0     0     0     0     0     0     0     0  1131     0     0     0     0     0     0     0     0     0     0     0     0     0     0     0]
 [    2     0     0     0     0     2     0     0     0     0     0     0    67     7     0     0     0    10     0    20     0     0     0     0     0     0     0]
 [    0     0     0     0     0     8     0     0     0     0     0     0     0    77     1     0     0     1     0     2     0     0     0     0     0     0     0]
 [   33     0     0     0     0     5     0     0     0     2     0     0     1     2   259     0     0     2     7    10     0     0     0     0     0     0     0]
 [    1     0     0     0     0     0     0     0     0     0     0     0     0     0     0    56     0     0     0     0     0     0     0     0     0     0     0]
 [   63     0     0     0     0     0     0     0     0     0     0     0     0     0     0     0   333     0     0     0     0     0     0     0     1     0     0]
 [   55     0     0     0     0    10     0     0     0     1     0     0    12     7     3     0     0   152     5    43     0     0     0     0     0     0     0]
 [   25     0     0     0     0     0     0     0     0     2     0     0     3     1    19     0     0     6    55    12     0     0     0     0     0     0     0]
 [   18     0     0     0     0    14     0     0     0     6     0     0    30    14     7     0     0    56     2   219     0     0     0     0     0     0     0]
 [   18     0     0     0     0     0     0     1     0     0     0     0     0     0     0     0     0     0     0     0   980     1     0     0     0     0     0]
 [   12     0     0     0     0     0     0     1     0     0     0     0     0     0     0     0     0     0     0     0     0   201     0     0     0     0     0]
 [   11     0     0     1     0     0     0     0     1     0     0     0     0     0     0     0     0     0     0     0     0     0  2131     0     0     0     0]
 [   32     0     0     0     0     0     0     0     0     0     0     0     0     0     0     0     0     0     0     0     0     0     0     0     0     0     0]
 [    3     0     0     0     0     0     0     0     0     0     0     0     0     0     0     0     0     0     0     0     0     0     0     0    27     0     0]
 [    2     0     4     0     0     0     0     1     0     0     0     0     0     0     0     0     0     0     0     0     0     0     0     0     0    50     0]
 [    9     0     2     0     1     0     0     2     0     0     0     0     0     0     0     0     0     0     0     0     0     0     0     0     0    16   156]]

Accuracy: 0.9437060203283816

Precision: [0.9409 0.8519 0.9559 1.0000 0.9828 0.6667 1.0000 0.9631 1.0000 0.9788 0.9787 1.0000 0.5484 0.4643 0.7470 0.9167 0.9902 0.5306 0.6818 0.6628 0.9683 0.9123 1.0000 0.0000 0.8889 0.6071 0.9750]
Mean: 0.8226679719630093
Std: 0.2329583181844501

Recall: [0.9806 0.8519 0.8553 0.3636 0.9661 0.6111 1.0000 0.9543 1.0000 0.9528 0.7667 0.9579 0.6296 0.6842 0.8052 1.0000 0.8707 0.4062 0.4286 0.5700 0.9839 0.9286 0.9920 0.0000 1.0000 0.9444 0.8478]
Mean: 0.7907972017267169
Std: 0.2484526737010154

F1 score: [0.9603 0.8519 0.9028 0.5333 0.9744 0.6377 1.0000 0.9587 1.0000 0.9656 0.8598 0.9785 0.5862 0.5532 0.7750 0.9565 0.9266 0.4602 0.5263 0.6129 0.9760 0.9204 0.9960 0.0000 0.9412 0.7391 0.9070]
Mean: 0.7962793202873807
Std: 0.23306525660501426

Cohen Kappa score: 0.9197114349970945
Confusion matrix:
[[3632    8    0    0    1    0    0    7    0   32    1    0    0    0    7    1    1    0    3    0    5    5    0    0    1    0    0]
 [   8   46    0    0    0    0    0    0    0    0    0    0    0    0    0    0    0    0    0    0    0    0    0    0    0    0    0]
 [   2    0   65    0    0    0    0    0    0    0    0    0    0    0    0    0    0    0    0    0    0    0    0    0    0    8    1]
 [  28    0    0   16    0    0    0    0    0    0    0    0    0    0    0    0    0    0    0    0    0    0    0    0    0    0    0]
 [   2    0    0    0   57    0    0    0    0    0    0    0    0    0    0    0    0    0    0    0    0    0    0    0    0    0    0]
 [   0    0    0    0    0   22    0    0    0    0    0    0    2    0    2    0    0    0    1    9    0    0    0    0    0    0    0]
 [   0    0    0    0    0    0   32    0    0    0    0    0    0    0    0    0    0    0    0    0    0    0    0    0    0    0    0]
 [   7    0    1    0    0    0    0  209    0    0    0    0    0    0    0    0    0    0    0    0    2    0    0    0    0    0    0]
 [   0    0    0    0    0    0    0    0   47    0    0    0    0    0    0    0    0    0    0    0    0    0    0    0    0    0    0]
 [  80    0    0    0    0    0    0    0    0 1614    0    0    0    0    0    0    0    0    0    0    0    0    0    0    0    0    0]
 [  14    0    0    0    0    0    0    0    0    0   46    0    0    0    0    0    0    0    0    0    0    0    0    0    0    0    0]
 [  13    0    0    0    0    0    0    0    0    0    0  296    0    0    0    0    0    0    0    0    0    0    0    0    0    0    0]
 [   0    0    0    0    0    0    0    0    0    0    0    0   17    4    0    0    0    4    0    2    0    0    0    0    0    0    0]
 [   0    0    0    0    0    2    0    0    0    0    0    0    0   13    1    0    0    2    0    1    0    0    0    0    0    0    0]
 [   8    0    0    0    0    3    0    0    0    0    0    0    1    0   62    0    0    0    2    1    0    0    0    0    0    0    0]
 [   0    0    0    0    0    0    0    0    0    0    0    0    0    0    0   11    0    0    0    0    0    0    0    0    0    0    0]
 [  15    0    0    0    0    0    0    0    0    0    0    0    0    0    0    0  101    0    0    0    0    0    0    0    0    0    0]
 [  12    0    0    0    0    1    0    0    0    0    0    0    6    2    2    0    0   26    0   15    0    0    0    0    0    0    0]
 [   9    0    0    0    0    0    0    0    0    0    0    0    1    1    7    0    0    1   15    1    0    0    0    0    0    0    0]
 [   4    0    0    0    0    5    0    0    0    3    0    0    4    8    2    0    0   16    1   57    0    0    0    0    0    0    0]
 [   3    0    0    0    0    0    0    1    0    0    0    0    0    0    0    0    0    0    0    0  244    0    0    0    0    0    0]
 [   3    0    0    0    0    0    0    0    0    0    0    0    0    0    0    0    0    0    0    0    1   52    0    0    0    0    0]
 [   4    0    0    0    0    0    0    0    0    0    0    0    0    0    0    0    0    0    0    0    0    0  498    0    0    0    0]
 [  13    0    0    0    0    0    0    0    0    0    0    0    0    0    0    0    0    0    0    0    0    0    0    0    0    0    0]
 [   0    0    0    0    0    0    0    0    0    0    0    0    0    0    0    0    0    0    0    0    0    0    0    0    8    0    0]
 [   0    0    1    0    0    0    0    0    0    0    0    0    0    0    0    0    0    0    0    0    0    0    0    0    0   17    0]
 [   3    0    1    0    0    0    0    0    0    0    0    0    0    0    0    0    0    0    0    0    0    0    0    0    0    3   39]]

