Classifier: MLPClassifier
Params: {'activation': 'relu', 'alpha': 0.0001, 'batch_size': 'auto', 'beta_1': 0.9, 'beta_2': 0.999, 'early_stopping': False, 'epsilon': 1e-08, 'hidden_layer_sizes': (100,), 'learning_rate': 'constant', 'learning_rate_init': 0.001, 'max_iter': 200, 'momentum': 0.9, 'nesterovs_momentum': True, 'power_t': 0.5, 'random_state': None, 'shuffle': True, 'solver': 'adam', 'tol': 0.0001, 'validation_fraction': 0.1, 'verbose': False, 'warm_start': False}

Labels: None

Training accuracy: 0.9710385718008862
Training confusion matrix:
[[14523    54     7     6     0     1     2    11     0     7     0     5     0     0     2     0     0     1     7     1    10     8     2     0     1     2     0]
 [   14   230     0     0     0     0     0     0     0     0     0     0     0     0     0     0     0     0     0     0     0     0     0     0     0     0     0]
 [    3     0   276     0     0     0     0     0     0     0     0     0     0     0     0     0     0     0     0     0     1     0     0     0     0     4     0]
 [   81     0     0   119     0     0     0     0     0     0     0     0     0     0     0     0     0     0     0     0     0     0     0     0     0     0     0]
 [    2     0     0     0   191     0     0     0     0     0     0     0     0     0     0     0     0     0     0     0     0     0     0     0     0     0     0]
 [    3     0     0     0     0   125     0     0     0     0     0     0     3     1     0     0     0     2     6    16     0     0     0     0     0     0     0]
 [    0     0     0     0     0     0   119     0     0     0     0     0     0     0     0     0     0     0     0     0     0     0     0     0     0     0     0]
 [    7     0     0     0     0     0     0  1011     0     0     0     0     0     0     0     0     0     0     0     0     8     0     0     0     0     0     0]
 [    0     0     0     0     0     0     0     0   177     0     0     0     0     0     0     0     0     0     0     0     0     0     0     0     0     0     0]
 [  124     0     0     0     0     0     0     0     0  6734     0     0     0     0     0     0     0     0     0     0     0     0     0     0     0     0     0]
 [   11     0     0     0     0     0     0     0     0     0   198     0     0     0     0     0     0     0     0     0     0     0     0     0     0     0     0]
 [   33     0     0     0     0     0     0     0     0     0     0  1135     0     0     0     0     0     0     0     0     0     0     0     0     0     0     0]
 [    0     0     0     0     0     6     0     0     0     0     0     0    73     1     0     0     0     9     0    19     0     0     0     0     0     0     0]
 [    0     0     0     0     0     8     0     0     0     0     0     0     3    60     1     0     0     3     2    12     0     0     0     0     0     0     0]
 [   14     0     0     0     0     5     0     0     0     0     0     0     1     1   283     0     0     1     8     8     0     0     0     0     0     0     0]
 [    1     0     0     0     0     0     0     0     0     0     0     0     0     0     0    56     0     0     0     0     0     0     0     0     0     0     0]
 [   60     0     0     1     0     0     0     0     0     0     0     0     0     0     0     0   336     0     0     0     0     0     0     0     0     0     0]
 [   15     0     0     0     0    10     0     0     0     0     0     0     2     3     0     0     0   228     3    27     0     0     0     0     0     0     0]
 [    3     0     0     0     0     0     0     0     0     0     0     0     3     0    11     0     0     2    98     6     0     0     0     0     0     0     0]
 [    7     0     0     0     0    17     0     0     0     0     0     0    13     4     2     0     0    59     7   257     0     0     0     0     0     0     0]
 [   16     0     1     0     0     0     0     0     0     0     0     0     0     0     0     0     0     0     0     0   983     0     0     0     0     0     0]
 [    1     0     0     0     0     0     0     0     0     0     0     0     0     0     0     0     0     0     0     0     0   213     0     0     0     0     0]
 [    1     0     0     0     0     0     0     0     1     0     0     0     0     0     0     0     0     0     0     0     0     0  2142     0     0     0     0]
 [   32     0     0     0     0     0     0     0     0     0     0     0     0     0     0     0     0     0     0     0     0     0     0     0     0     0     0]
 [    2     0     0     0     0     0     0     0     0     0     0     0     0     0     0     0     0     0     0     0     0     0     0     0    28     0     0]
 [    0     0     5     0     0     0     0     0     0     0     0     0     0     0     0     0     0     0     0     0     0     0     0     0     0    52     0]
 [    8     0     7     0     0     0     0     0     0     0     0     0     0     0     0     0     0     0     0     0     0     0     0     0     0    11   160]]

Accuracy: 0.9594735470419599

Precision: [0.9634 0.7612 0.9200 0.9231 1.0000 0.5750 0.9697 0.9817 1.0000 1.0000 0.9811 0.9967 0.5600 0.5556 0.8514 1.0000 0.9901 0.6216 0.6944 0.6353 0.9684 0.8730 0.9980 0.0000 0.8889 0.7619 1.0000]
Mean: 0.8322357793976581
Std: 0.2246030322723219

Recall: [0.9876 0.9444 0.9079 0.5455 0.9831 0.6389 1.0000 0.9772 1.0000 0.9734 0.8667 0.9644 0.5185 0.5263 0.8182 1.0000 0.8621 0.7188 0.7143 0.5400 0.9879 0.9821 1.0000 0.0000 1.0000 0.8889 0.8478]
Mean: 0.8219951439840889
Std: 0.23016639500234637

F1 score: [0.9753 0.8430 0.9139 0.6857 0.9915 0.6053 0.9846 0.9794 1.0000 0.9865 0.9204 0.9803 0.5385 0.5405 0.8344 1.0000 0.9217 0.6667 0.7042 0.5838 0.9780 0.9244 0.9990 0.0000 0.9412 0.8205 0.9176]
Mean: 0.8235687067819116
Std: 0.22216289340235665

Cohen Kappa score: 0.9425145140004736
Confusion matrix:
[[3658   16    1    2    0    0    1    4    0    0    1    1    0    0    1    0    1    0    3    2    5    6    1    0    1    0    0]
 [   3   51    0    0    0    0    0    0    0    0    0    0    0    0    0    0    0    0    0    0    0    0    0    0    0    0    0]
 [   3    0   69    0    0    0    0    0    0    0    0    0    0    0    0    0    0    0    0    0    0    0    0    0    0    4    0]
 [  20    0    0   24    0    0    0    0    0    0    0    0    0    0    0    0    0    0    0    0    0    0    0    0    0    0    0]
 [   1    0    0    0   58    0    0    0    0    0    0    0    0    0    0    0    0    0    0    0    0    0    0    0    0    0    0]
 [   0    0    0    0    0   23    0    0    0    0    0    0    0    0    2    0    0    3    1    7    0    0    0    0    0    0    0]
 [   0    0    0    0    0    0   32    0    0    0    0    0    0    0    0    0    0    0    0    0    0    0    0    0    0    0    0]
 [   1    0    0    0    0    0    0  214    0    0    0    0    0    0    0    0    0    0    0    0    2    2    0    0    0    0    0]
 [   0    0    0    0    0    0    0    0   47    0    0    0    0    0    0    0    0    0    0    0    0    0    0    0    0    0    0]
 [  45    0    0    0    0    0    0    0    0 1649    0    0    0    0    0    0    0    0    0    0    0    0    0    0    0    0    0]
 [   8    0    0    0    0    0    0    0    0    0   52    0    0    0    0    0    0    0    0    0    0    0    0    0    0    0    0]
 [  11    0    0    0    0    0    0    0    0    0    0  298    0    0    0    0    0    0    0    0    0    0    0    0    0    0    0]
 [   0    0    0    0    0    1    0    0    0    0    0    0   14    1    0    0    0    3    0    8    0    0    0    0    0    0    0]
 [   0    0    0    0    0    3    0    0    0    0    0    0    1   10    1    0    0    2    0    2    0    0    0    0    0    0    0]
 [   7    0    0    0    0    3    0    0    0    0    0    0    0    0   63    0    0    0    2    2    0    0    0    0    0    0    0]
 [   0    0    0    0    0    0    0    0    0    0    0    0    0    0    0   11    0    0    0    0    0    0    0    0    0    0    0]
 [  16    0    0    0    0    0    0    0    0    0    0    0    0    0    0    0  100    0    0    0    0    0    0    0    0    0    0]
 [   2    0    0    0    0    1    0    0    0    0    0    0    4    2    0    0    0   46    0    9    0    0    0    0    0    0    0]
 [   1    0    0    0    0    0    0    0    0    0    0    0    1    1    5    0    0    1   25    1    0    0    0    0    0    0    0]
 [   2    0    0    0    0    9    0    0    0    0    0    0    5    4    2    0    0   19    5   54    0    0    0    0    0    0    0]
 [   3    0    0    0    0    0    0    0    0    0    0    0    0    0    0    0    0    0    0    0  245    0    0    0    0    0    0]
 [   0    0    0    0    0    0    0    0    0    0    0    0    0    0    0    0    0    0    0    0    1   55    0    0    0    0    0]
 [   0    0    0    0    0    0    0    0    0    0    0    0    0    0    0    0    0    0    0    0    0    0  502    0    0    0    0]
 [  13    0    0    0    0    0    0    0    0    0    0    0    0    0    0    0    0    0    0    0    0    0    0    0    0    0    0]
 [   0    0    0    0    0    0    0    0    0    0    0    0    0    0    0    0    0    0    0    0    0    0    0    0    8    0    0]
 [   0    0    2    0    0    0    0    0    0    0    0    0    0    0    0    0    0    0    0    0    0    0    0    0    0   16    0]
 [   3    0    3    0    0    0    0    0    0    0    0    0    0    0    0    0    0    0    0    0    0    0    0    0    0    1   39]]

