Classifier: MultinomialNB
Params: {'alpha': 1.0, 'class_prior': None, 'fit_prior': True}

Labels: None

Training accuracy: 0.8736968986187126
Training confusion matrix:
[[13246   128   122     2     5     7     3    83     0   404   164    91     0     0   170    26    18    62     9     9    48     8    43     1     1     0     0]
 [   10   234     0     0     0     0     0     0     0     0     0     0     0     0     0     0     0     0     0     0     0     0     0     0     0     0     0]
 [    8     0   231     0    11     0     0     5     0     0     0     0     0     0     0     0     0     0     0     0    12     1    14     0     0     0     2]
 [   93     0     0    94     0     0     0     0     0     0     0     2     0     0     0     0     0     0     0     0     0     0    11     0     0     0     0]
 [    3     0     0     0   190     0     0     0     0     0     0     0     0     0     0     0     0     0     0     0     0     0     0     0     0     0     0]
 [    2     0     0     0     0   111     0     0     0     0     0     0     5     5     1     0     0     6     0    26     0     0     0     0     0     0     0]
 [    0     0     0     0     0     0   119     0     0     0     0     0     0     0     0     0     0     0     0     0     0     0     0     0     0     0     0]
 [    8     0    22     0     0     0     0   978     1     0     0     0     0     0     0     0     0     0     0     0    14     2     1     0     0     0     0]
 [    0     0     0     0     0     0     0     0   177     0     0     0     0     0     0     0     0     0     0     0     0     0     0     0     0     0     0]
 [ 1285     0     0     0     0     0     0     0     0  5570     0     1     0     0     2     0     0     0     0     0     0     0     0     0     0     0     0]
 [    8     0     0     0     0     0     0     0     0    21   180     0     0     0     0     0     0     0     0     0     0     0     0     0     0     0     0]
 [   38     0     0     0     0     0     0     0     0     0     0  1130     0     0     0     0     0     0     0     0     0     0     0     0     0     0     0]
 [    0     0     0     0     0     7     0     0     0     0     0     0    48     5     3     0     0     9     0    36     0     0     0     0     0     0     0]
 [    0     0     0     0     0     6     0     0     0     0     0     0     4    78     1     0     0     0     0     0     0     0     0     0     0     0     0]
 [   50     0     0     2     0     6     0     0     0     0     0     0     1     2   195     0     0    47     2    13     0     0     3     0     0     0     0]
 [    1     0     0     0     0     0     0     0     0     0     0     0     0     0     0    56     0     0     0     0     0     0     0     0     0     0     0]
 [   56     0     0     0     0     0     0     0     0     0     0     5     0     0     0     0   334     0     0     0     0     0     1     0     1     0     0]
 [   18     0     0     0     0    14     0     0     0     0     0     0     5     7    24     0     0   154     7    59     0     0     0     0     0     0     0]
 [    8     0     0     0     0     7     0     0     0     0     0     0     3     2    48     0     0    24    26     5     0     0     0     0     0     0     0]
 [   21     0     4     0     0    22     0     0     0     0     6     0    19    13    22     0     0    48     0   206     0     0     2     0     0     3     0]
 [   53     0    26     0     0     0     0     3     0     0     0     0     0     0     0     0     0     0     0     0   918     0     0     0     0     0     0]
 [    6     0    11     0     0     0     0     2     0     0     0     0     0     0     0     0     0     0     0     0     1   193     0     0     0     1     0]
 [    1     0     0     0     2     0     0     0     1     0     0     0     0     0     0     0     0     0     0     0     0     0  2140     0     0     0     0]
 [   30     1     0     0     0     0     0     0     0     0     0     0     0     0     0     0     0     0     0     0     0     0     0     1     0     0     0]
 [    3     0     0     0     0     0     0     0     0     0     0     0     0     0     0     0     0     0     0     0     0     0     0     0    27     0     0]
 [    0     0     0     0     4     0     0     1     0     0     0     0     0     0     0     0     0     0     0     0     4     0    19     0     0    29     0]
 [    9     0     2     0     4     0     0     1     0     0     0     0     0     0     0     0     0     0     0     0     0     0    16     0     0     0   154]]

Accuracy: 0.8732082356007297

Precision: [0.8834 0.5977 0.6211 1.0000 0.8788 0.5897 0.9697 0.8917 1.0000 0.9331 0.6173 0.9288 0.6364 0.4667 0.4472 0.7333 0.9528 0.3977 0.7500 0.6049 0.9150 0.8571 0.9383 0.0000 0.8889 0.9000 1.0000]
Mean: 0.7555385956898294
Std: 0.23474997162427763

Recall: [0.9104 0.9630 0.7763 0.3636 0.9831 0.6389 1.0000 0.9772 1.0000 0.7981 0.8333 0.9709 0.5185 0.7368 0.7143 1.0000 0.8707 0.5469 0.2571 0.4900 0.9113 0.9643 1.0000 0.0000 1.0000 0.5000 0.8478]
Mean: 0.7619431498775323
Std: 0.26061654467906936

F1 score: [0.8967 0.7376 0.6901 0.5333 0.9280 0.6133 0.9846 0.9325 1.0000 0.8603 0.7092 0.9494 0.5714 0.5714 0.5500 0.8462 0.9099 0.4605 0.3830 0.5414 0.9131 0.9076 0.9682 0.0000 0.9412 0.6429 0.9176]
Mean: 0.7392372834136
Std: 0.2327075272711944

Cohen Kappa score: 0.8211391446200105
Confusion matrix:
[[3372   34   23    0    2    3    1   24    0   92   28   23    0    0   39    4    5   16    2    2   11    8   13    1    1    0    0]
 [   2   52    0    0    0    0    0    0    0    0    0    0    0    0    0    0    0    0    0    0    0    0    0    0    0    0    0]
 [   1    0   59    0    4    0    0    1    0    0    0    0    0    0    0    0    0    0    0    0    6    0    5    0    0    0    0]
 [  24    0    0   16    0    0    0    0    0    0    0    0    0    0    0    0    0    0    0    0    0    0    4    0    0    0    0]
 [   0    0    0    0   58    0    0    0    0    0    0    0    0    0    0    0    0    0    0    0    1    0    0    0    0    0    0]
 [   0    0    0    0    0   23    0    0    0    0    0    0    0    0    0    0    0    3    1    9    0    0    0    0    0    0    0]
 [   0    0    0    0    0    0   32    0    0    0    0    0    0    0    0    0    0    0    0    0    0    0    0    0    0    0    0]
 [   0    0    3    0    0    0    0  214    0    0    0    0    0    0    0    0    0    0    0    0    2    0    0    0    0    0    0]
 [   0    0    0    0    0    0    0    0   47    0    0    0    0    0    0    0    0    0    0    0    0    0    0    0    0    0    0]
 [ 342    0    0    0    0    0    0    0    0 1352    0    0    0    0    0    0    0    0    0    0    0    0    0    0    0    0    0]
 [   5    0    0    0    0    0    0    0    0    5   50    0    0    0    0    0    0    0    0    0    0    0    0    0    0    0    0]
 [   9    0    0    0    0    0    0    0    0    0    0  300    0    0    0    0    0    0    0    0    0    0    0    0    0    0    0]
 [   0    0    0    0    0    1    0    0    0    0    0    0   14    4    1    0    0    4    0    3    0    0    0    0    0    0    0]
 [   0    0    0    0    0    2    0    0    0    0    0    0    1   14    0    0    0    1    0    1    0    0    0    0    0    0    0]
 [   8    0    0    0    0    3    0    0    0    0    0    0    1    0   55    0    0    9    0    1    0    0    0    0    0    0    0]
 [   0    0    0    0    0    0    0    0    0    0    0    0    0    0    0   11    0    0    0    0    0    0    0    0    0    0    0]
 [  15    0    0    0    0    0    0    0    0    0    0    0    0    0    0    0  101    0    0    0    0    0    0    0    0    0    0]
 [   4    0    0    0    0    1    0    0    0    0    0    0    2    2    5    0    0   35    0   15    0    0    0    0    0    0    0]
 [   1    0    0    0    0    1    0    0    0    0    0    0    1    2   19    0    0    1    9    1    0    0    0    0    0    0    0]
 [   5    0    1    0    0    5    0    0    0    0    3    0    3    8    4    0    0   19    0   49    0    1    1    0    0    1    0]
 [  15    0    7    0    0    0    0    0    0    0    0    0    0    0    0    0    0    0    0    0  226    0    0    0    0    0    0]
 [   0    0    1    0    0    0    0    0    0    0    0    0    0    0    0    0    0    0    0    0    1   54    0    0    0    0    0]
 [   0    0    0    0    0    0    0    0    0    0    0    0    0    0    0    0    0    0    0    0    0    0  502    0    0    0    0]
 [  12    1    0    0    0    0    0    0    0    0    0    0    0    0    0    0    0    0    0    0    0    0    0    0    0    0    0]
 [   0    0    0    0    0    0    0    0    0    0    0    0    0    0    0    0    0    0    0    0    0    0    0    0    8    0    0]
 [   0    0    0    0    1    0    0    1    0    0    0    0    0    0    0    0    0    0    0    0    0    0    7    0    0    9    0]
 [   2    0    1    0    1    0    0    0    0    0    0    0    0    0    0    0    0    0    0    0    0    0    3    0    0    0   39]]

