Classifier: RandomForestClassifier
Params: {'bootstrap': True, 'class_weight': None, 'criterion': 'gini', 'max_depth': None, 'max_features': 'auto', 'max_leaf_nodes': None, 'min_impurity_decrease': 0.0, 'min_impurity_split': None, 'min_samples_leaf': 1, 'min_samples_split': 2, 'min_weight_fraction_leaf': 0.0, 'n_estimators': 100, 'n_jobs': 1, 'oob_score': False, 'random_state': None, 'verbose': 0, 'warm_start': False}

Labels: None

Training accuracy: 0.9765767526713578
Training confusion matrix:
[[14581    11     4     2     0     3     2    11     0     3     0    12     0     0     0     0     0     0     1     0     9     6     2     0     1     2     0]
 [   36   208     0     0     0     0     0     0     0     0     0     0     0     0     0     0     0     0     0     0     0     0     0     0     0     0     0]
 [    2     0   279     0     0     0     0     0     0     0     0     0     0     0     0     0     0     0     0     0     1     0     0     0     0     2     0]
 [   78     0     0   122     0     0     0     0     0     0     0     0     0     0     0     0     0     0     0     0     0     0     0     0     0     0     0]
 [    2     0     0     0   191     0     0     0     0     0     0     0     0     0     0     0     0     0     0     0     0     0     0     0     0     0     0]
 [    0     0     0     0     0   128     0     0     0     0     0     0     3     4     0     0     0     3     5    13     0     0     0     0     0     0     0]
 [    0     0     0     0     0     0   119     0     0     0     0     0     0     0     0     0     0     0     0     0     0     0     0     0     0     0     0]
 [    2     0     0     0     0     0     0  1018     0     0     0     0     0     0     0     0     0     0     0     0     6     0     0     0     0     0     0]
 [    0     0     0     0     0     0     0     0   177     0     0     0     0     0     0     0     0     0     0     0     0     0     0     0     0     0     0]
 [  120     0     0     0     0     0     0     0     0  6738     0     0     0     0     0     0     0     0     0     0     0     0     0     0     0     0     0]
 [    9     0     0     0     0     0     0     0     0     0   200     0     0     0     0     0     0     0     0     0     0     0     0     0     0     0     0]
 [   22     0     0     0     0     0     0     0     0     0     0  1146     0     0     0     0     0     0     0     0     0     0     0     0     0     0     0]
 [    0     0     0     0     0     0     0     0     0     0     0     0    94     1     0     0     0     5     0     8     0     0     0     0     0     0     0]
 [    0     0     0     0     0     3     0     0     0     0     0     0     1    77     1     0     0     3     0     4     0     0     0     0     0     0     0]
 [   12     0     0     0     0     5     0     0     0     0     0     0     1     1   290     0     0     0     6     6     0     0     0     0     0     0     0]
 [    1     0     0     0     0     0     0     0     0     0     0     0     0     0     0    56     0     0     0     0     0     0     0     0     0     0     0]
 [   51     0     0     1     0     0     0     0     0     0     0     0     0     0     0     0   345     0     0     0     0     0     0     0     0     0     0]
 [   15     0     0     0     0     4     0     0     0     0     0     0     4     2     1     0     0   234     2    26     0     0     0     0     0     0     0]
 [    5     0     0     0     0     0     0     0     0     0     0     0     2     1     9     0     0     2    97     7     0     0     0     0     0     0     0]
 [    7     0     0     0     0     9     0     0     0     0     0     0    16     5     0     0     0    32     0   297     0     0     0     0     0     0     0]
 [   15     0     0     0     0     0     0     1     0     0     0     0     0     0     0     0     0     0     0     0   984     0     0     0     0     0     0]
 [    1     0     0     0     0     0     0     0     0     0     0     0     0     0     0     0     0     0     0     0     0   213     0     0     0     0     0]
 [    1     0     0     0     0     0     0     0     1     0     0     0     0     0     0     0     0     0     0     0     0     0  2142     0     0     0     0]
 [   31     0     0     0     0     0     0     0     0     0     0     0     0     0     0     0     0     0     0     0     0     0     0     1     0     0     0]
 [    2     0     0     0     0     0     0     0     0     0     0     0     0     0     0     0     0     0     0     0     0     0     0     0    28     0     0]
 [    0     0     5     0     0     0     0     0     0     0     0     0     0     0     0     0     0     0     0     0     0     0     0     0     0    52     0]
 [    8     0     7     0     0     0     0     0     0     0     0     0     0     0     0     0     0     0     0     0     0     0     0     0     0    11   160]]

Accuracy: 0.9628616106333072

Precision: [0.9640 0.9216 0.9342 0.8000 0.9828 0.6000 0.9697 0.9864 1.0000 0.9988 1.0000 0.9967 0.5312 0.5417 0.8889 1.0000 0.9902 0.7333 0.7273 0.6774 0.9684 0.8966 0.9941 0.0000 0.8889 0.7895 1.0000]
Mean: 0.8437585068616374
Std: 0.22062793588376678

Recall: [0.9914 0.8704 0.9342 0.4545 0.9661 0.5833 1.0000 0.9909 1.0000 0.9752 0.9167 0.9709 0.6296 0.6842 0.8312 1.0000 0.8707 0.6875 0.6857 0.6300 0.9879 0.9286 1.0000 0.0000 1.0000 0.8333 0.8478]
Mean: 0.824817915475813
Std: 0.22319390698548053

F1 score: [0.9775 0.8952 0.9342 0.5797 0.9744 0.5915 0.9846 0.9886 1.0000 0.9869 0.9565 0.9836 0.5763 0.6047 0.8591 1.0000 0.9266 0.7097 0.7059 0.6528 0.9780 0.9123 0.9970 0.0000 0.9412 0.8108 0.9176]
Mean: 0.831287490978999
Std: 0.21948918467790818

Cohen Kappa score: 0.9472519772820938
Confusion matrix:
[[3672    4    0    3    0    1    1    2    0    2    0    1    0    0    1    0    1    0    2    0    4    6    3    0    1    0    0]
 [   7   47    0    0    0    0    0    0    0    0    0    0    0    0    0    0    0    0    0    0    0    0    0    0    0    0    0]
 [   1    0   71    0    0    0    0    0    0    0    0    0    0    0    0    0    0    0    0    0    1    0    0    0    0    3    0]
 [  24    0    0   20    0    0    0    0    0    0    0    0    0    0    0    0    0    0    0    0    0    0    0    0    0    0    0]
 [   2    0    0    0   57    0    0    0    0    0    0    0    0    0    0    0    0    0    0    0    0    0    0    0    0    0    0]
 [   1    0    0    0    0   21    0    0    0    0    0    0    2    0    1    0    0    3    1    7    0    0    0    0    0    0    0]
 [   0    0    0    0    0    0   32    0    0    0    0    0    0    0    0    0    0    0    0    0    0    0    0    0    0    0    0]
 [   0    0    0    0    0    0    0  217    0    0    0    0    0    0    0    0    0    0    0    0    2    0    0    0    0    0    0]
 [   0    0    0    0    0    0    0    0   47    0    0    0    0    0    0    0    0    0    0    0    0    0    0    0    0    0    0]
 [  42    0    0    0    0    0    0    0    0 1652    0    0    0    0    0    0    0    0    0    0    0    0    0    0    0    0    0]
 [   5    0    0    0    0    0    0    0    0    0   55    0    0    0    0    0    0    0    0    0    0    0    0    0    0    0    0]
 [   9    0    0    0    0    0    0    0    0    0    0  300    0    0    0    0    0    0    0    0    0    0    0    0    0    0    0]
 [   0    0    0    0    0    1    0    0    0    0    0    0   17    2    0    0    0    2    0    5    0    0    0    0    0    0    0]
 [   0    0    0    0    0    1    0    0    0    0    0    0    2   13    0    0    0    0    0    3    0    0    0    0    0    0    0]
 [   5    0    0    0    0    2    0    0    0    0    0    0    0    0   64    0    0    0    3    3    0    0    0    0    0    0    0]
 [   0    0    0    0    0    0    0    0    0    0    0    0    0    0    0   11    0    0    0    0    0    0    0    0    0    0    0]
 [  15    0    0    0    0    0    0    0    0    0    0    0    0    0    0    0  101    0    0    0    0    0    0    0    0    0    0]
 [   3    0    0    0    0    1    0    0    0    0    0    0    4    2    0    0    0   44    0   10    0    0    0    0    0    0    0]
 [   1    0    0    0    0    1    0    0    0    0    0    0    0    2    5    0    0    0   24    2    0    0    0    0    0    0    0]
 [   2    0    0    1    0    7    0    0    0    0    0    0    7    5    1    0    0   11    3   63    0    0    0    0    0    0    0]
 [   2    0    0    1    0    0    0    0    0    0    0    0    0    0    0    0    0    0    0    0  245    0    0    0    0    0    0]
 [   2    0    0    0    0    0    0    1    0    0    0    0    0    0    0    0    0    0    0    0    1   52    0    0    0    0    0]
 [   0    0    0    0    0    0    0    0    0    0    0    0    0    0    0    0    0    0    0    0    0    0  502    0    0    0    0]
 [  13    0    0    0    0    0    0    0    0    0    0    0    0    0    0    0    0    0    0    0    0    0    0    0    0    0    0]
 [   0    0    0    0    0    0    0    0    0    0    0    0    0    0    0    0    0    0    0    0    0    0    0    0    8    0    0]
 [   0    0    2    0    1    0    0    0    0    0    0    0    0    0    0    0    0    0    0    0    0    0    0    0    0   15    0]
 [   3    0    3    0    0    0    0    0    0    0    0    0    0    0    0    0    0    0    0    0    0    0    0    0    0    1   39]]

