Classifier: GradientBoostingClassifier
Params: {'criterion': 'friedman_mse', 'init': None, 'learning_rate': 0.1, 'loss': 'deviance', 'max_depth': 3, 'max_features': None, 'max_leaf_nodes': None, 'min_impurity_decrease': 0.0, 'min_impurity_split': None, 'min_samples_leaf': 1, 'min_samples_split': 2, 'min_weight_fraction_leaf': 0.0, 'n_estimators': 100, 'presort': 'auto', 'random_state': None, 'subsample': 1.0, 'verbose': 0, 'warm_start': False}

Labels: None

Training accuracy: 0.9902918947094084
Training confusion matrix:
[[14612     2     1     6     0     0     0     5     0     4     0     1     0     0     1     1     5     0     0     0     2     0     1     0     0     0     0]
 [    1   241     0     0     0     0     0     0     0     0     0     0     0     0     0     0     0     0     0     0     0     0     0     0     0     0     0]
 [    0     0   290     0     0     0     0     0     1     0     0     0     0     0     0     0     0     0     0     0     0     0     0     0     0     0     0]
 [    5     0     0   194     0     0     0     0     0     0     0     0     0     0     0     0     0     0     0     0     0     0     0     0     0     0     0]
 [    0     0     0     0   200     0     0     0     0     0     0     0     0     0     0     0     0     0     0     0     0     0     0     0     0     0     0]
 [    0     0     0     0     0   129     0     0     0     0     0     0     3     2     1     0     0     1     0    12     0     0     0     0     0     0     0]
 [    0     0     0     0     0     0   124     0     0     0     0     0     0     0     0     0     0     0     0     0     0     0     0     0     0     0     0]
 [    0     0     0     0     0     0     0   977     0     0     0     0     0     0     0     0     0     0     0     0     8     0     0     0     0     0     0]
 [    1     0     1     0     0     0     0     0   179     0     0     0     0     0     0     0     0     0     0     0     0     0     0     0     0     0     0]
 [   11     0     0     0     0     0     0     0     0  6875     0     1     0     0     0     0     0     0     0     0     0     0     0     0     0     0     0]
 [    0     0     0     0     0     0     0     0     0     0   219     0     0     0     0     0     0     0     0     0     0     0     0     0     0     0     0]
 [    0     0     0     0     0     0     0     0     0     7     0  1192     0     0     0     0     0     0     0     0     0     0     0     0     0     0     0]
 [    0     0     0     0     0     2     0     0     0     0     0     0    86     1     0     0     0     3     0    10     0     0     0     0     0     0     0]
 [    0     0     0     0     0     1     0     0     0     0     0     0     1    74     1     0     0     3     0     5     0     0     0     0     0     0     0]
 [    5     0     0     0     0     4     0     0     0     0     0     0     1     0   295     0     0     2     8     7     0     0     0     0     0     0     0]
 [    0     0     4     0     0     0     0     0     6     0     0     0     0     0     0    42     0     0     0     0     0     0     0     0     0     0     0]
 [    2     0     0     0     0     0     0     0     0     0     0     0     0     0     0     0   409     0     0     0     0     0     0     0     0     0     0]
 [    1     0     0     0     0     3     0     0     0     0     0     0     3     3     0     0     0   262     1    19     0     0     0     0     0     0     0]
 [    0     0     0     0     0     3     0     0     0     0     0     0     1     2    10     0     0     1   101    10     0     0     0     0     0     0     0]
 [    9     0     0     0     0     7     0     0     0     0     0     0    19     7     1     0     0    41     0   284     0     0     0     0     0     0     0]
 [    2     0     0     0     0     0     0     0     0     0     0     0     0     0     0     0     0     0     0     0  1002     0     0     0     0     0     0]
 [    1     0     0     0     0     0     0     0     0     0     0     0     0     0     0     0     0     0     0     0     0   214     0     0     0     0     0]
 [    0     0     0     0     0     0     0     0     1     0     0     0     0     0     0     0     0     0     0     0     0     0  2084     0     0     0     0]
 [    2     0     0     0     0     0     0     0     0     1     0     0     0     0     0     0     0     0     0     0     0     0     0    32     0     0     0]
 [    0     0     0     0     0     0     0     0     0     0     0     0     0     0     0     0     0     0     0     0     0     0     0     0    34     0     0]
 [    0     0     0     0     0     0     0     0     0     0     0     0     0     0     0     0     0     0     0     0     0     0     0     0     0    58     0]
 [    0     0     0     0     0     0     0     0     0     0     0     0     0     0     0     0     0     0     0     0     0     0     0     0     0     0   189]]

Accuracy: 0.9790200677612718

Precision: [0.9922 0.9649 0.9178 0.9318 1.0000 0.7105 1.0000 0.9961 0.9767 0.9988 0.9800 0.9964 0.5366 0.7619 0.9412 1.0000 0.9604 0.6184 0.8261 0.6882 0.9918 0.9818 0.9982 0.8333 0.8000 1.0000 0.9333]
Mean: 0.9013541217937353
Std: 0.13008599367661539

Recall: [0.9941 0.9821 0.9710 0.9111 1.0000 0.6136 1.0000 0.9885 0.9767 0.9970 0.9800 1.0000 0.6667 0.6957 0.8421 0.6875 0.9510 0.7833 0.6333 0.6531 0.9877 0.9818 0.9964 1.0000 1.0000 1.0000 0.9767]
Mean: 0.8988710010659231
Std: 0.1380879401886961

F1 score: [0.9931 0.9735 0.9437 0.9213 1.0000 0.6585 1.0000 0.9923 0.9767 0.9979 0.9800 0.9982 0.5946 0.7273 0.8889 0.8148 0.9557 0.6912 0.7170 0.6702 0.9897 0.9818 0.9973 0.9091 0.8889 1.0000 0.9545]
Mean: 0.8968966957941041
Std: 0.1269916051071139

Cohen Kappa score: 0.9703967064738399
Confusion matrix:
[[3691    2    2    3    0    0    0    1    0    2    1    1    0    0    0    0    4    0    0    1    0    1    0    2    1    0    1]
 [   1   55    0    0    0    0    0    0    0    0    0    0    0    0    0    0    0    0    0    0    0    0    0    0    0    0    0]
 [   2    0   67    0    0    0    0    0    0    0    0    0    0    0    0    0    0    0    0    0    0    0    0    0    0    0    0]
 [   4    0    0   41    0    0    0    0    0    0    0    0    0    0    0    0    0    0    0    0    0    0    0    0    0    0    0]
 [   0    0    0    0   52    0    0    0    0    0    0    0    0    0    0    0    0    0    0    0    0    0    0    0    0    0    0]
 [   0    0    0    0    0   27    0    0    0    0    0    0    2    1    1    0    0    3    0   10    0    0    0    0    0    0    0]
 [   0    0    0    0    0    0   27    0    0    0    0    0    0    0    0    0    0    0    0    0    0    0    0    0    0    0    0]
 [   0    0    0    0    0    0    0  257    0    0    0    0    0    0    0    0    0    0    0    0    2    0    0    0    0    0    1]
 [   0    0    1    0    0    0    0    0   42    0    0    0    0    0    0    0    0    0    0    0    0    0    0    0    0    0    0]
 [   5    0    0    0    0    0    0    0    0 1660    0    0    0    0    0    0    0    0    0    0    0    0    0    0    0    0    0]
 [   1    0    0    0    0    0    0    0    0    0   49    0    0    0    0    0    0    0    0    0    0    0    0    0    0    0    0]
 [   0    0    0    0    0    0    0    0    0    0    0  278    0    0    0    0    0    0    0    0    0    0    0    0    0    0    0]
 [   0    0    0    0    0    1    0    0    0    0    0    0   22    0    0    0    0    4    0    6    0    0    0    0    0    0    0]
 [   0    0    0    0    0    1    0    0    0    0    0    0    3   16    0    0    0    3    0    0    0    0    0    0    0    0    0]
 [   3    0    0    0    0    1    0    0    0    0    0    0    1    2   64    0    0    0    4    1    0    0    0    0    0    0    0]
 [   2    0    2    0    0    0    0    0    0    0    0    0    0    0    0   11    0    0    0    0    0    0    1    0    0    0    0]
 [   5    0    0    0    0    0    0    0    0    0    0    0    0    0    0    0   97    0    0    0    0    0    0    0    0    0    0]
 [   0    0    0    0    0    0    0    0    0    0    0    0    3    1    0    0    0   47    0    9    0    0    0    0    0    0    0]
 [   0    0    0    0    0    3    0    0    0    0    0    0    2    0    3    0    0    1   19    2    0    0    0    0    0    0    0]
 [   2    0    0    0    0    5    0    0    0    0    0    0    8    1    0    0    0   18    0   64    0    0    0    0    0    0    0]
 [   1    0    1    0    0    0    0    0    0    0    0    0    0    0    0    0    0    0    0    0  241    0    0    0    0    0    1]
 [   1    0    0    0    0    0    0    0    0    0    0    0    0    0    0    0    0    0    0    0    0   54    0    0    0    0    0]
 [   1    0    0    0    0    0    0    0    1    0    0    0    0    0    0    0    0    0    0    0    0    0  559    0    0    0    0]
 [   0    0    0    0    0    0    0    0    0    0    0    0    0    0    0    0    0    0    0    0    0    0    0   10    0    0    0]
 [   0    0    0    0    0    0    0    0    0    0    0    0    0    0    0    0    0    0    0    0    0    0    0    0    4    0    0]
 [   0    0    0    0    0    0    0    0    0    0    0    0    0    0    0    0    0    0    0    0    0    0    0    0    0   17    0]
 [   1    0    0    0    0    0    0    0    0    0    0    0    0    0    0    0    0    0    0    0    0    0    0    0    0    0   42]]

