Classifier: LinearSVC
Params: {'C': 1.0, 'class_weight': None, 'dual': True, 'fit_intercept': True, 'intercept_scaling': 1, 'loss': 'squared_hinge', 'max_iter': 1000, 'multi_class': 'ovr', 'penalty': 'l2', 'random_state': None, 'tol': 0.0001, 'verbose': 0}

Labels: None

Training accuracy: 0.9864151681000782
Training confusion matrix:
[[14602     5     2     4     0     0     0     8     0     2     1     0     0     0     1     1     6     0     0     0     2     2     2     1     1     0     1]
 [    2   240     0     0     0     0     0     0     0     0     0     0     0     0     0     0     0     0     0     0     0     0     0     0     0     0     0]
 [    3     0   286     0     0     0     0     0     1     0     0     0     0     0     0     1     0     0     0     0     0     0     0     0     0     0     0]
 [    7     0     0   192     0     0     0     0     0     0     0     0     0     0     0     0     0     0     0     0     0     0     0     0     0     0     0]
 [    0     0     0     0   200     0     0     0     0     0     0     0     0     0     0     0     0     0     0     0     0     0     0     0     0     0     0]
 [    0     0     0     0     0   102     0     0     0     0     0     0     7     2     3     0     0     3     4    27     0     0     0     0     0     0     0]
 [    0     0     0     0     0     0   124     0     0     0     0     0     0     0     0     0     0     0     0     0     0     0     0     0     0     0     0]
 [    6     0     0     0     0     0     0   970     0     0     0     0     0     0     0     0     0     0     0     0     9     0     0     0     0     0     0]
 [    3     0     0     0     0     0     0     0   178     0     0     0     0     0     0     0     0     0     0     0     0     0     0     0     0     0     0]
 [    3     0     0     0     0     0     0     0     0  6884     0     0     0     0     0     0     0     0     0     0     0     0     0     0     0     0     0]
 [    0     0     0     0     0     0     0     0     0     0   219     0     0     0     0     0     0     0     0     0     0     0     0     0     0     0     0]
 [    0     0     0     0     0     0     0     0     0     7     0  1192     0     0     0     0     0     0     0     0     0     0     0     0     0     0     0]
 [    0     0     0     0     0     0     0     0     0     0     0     0    80     5     0     0     0     5     0    12     0     0     0     0     0     0     0]
 [    0     0     0     0     0     6     0     0     0     0     0     0     2    71     1     0     0     1     1     3     0     0     0     0     0     0     0]
 [    4     0     0     0     0     1     0     0     0     0     0     0     1     0   304     0     0     1     1    10     0     0     0     0     0     0     0]
 [    0     0     2     0     0     0     0     0     7     0     0     0     0     0     0    43     0     0     0     0     0     0     0     0     0     0     0]
 [    2     0     0     0     0     0     0     0     0     0     0     0     0     0     0     0   409     0     0     0     0     0     0     0     0     0     0]
 [    1     0     0     0     0    14     0     0     0     0     0     0     9     9     1     0     0   227     0    31     0     0     0     0     0     0     0]
 [    0     0     0     0     0     3     0     0     0     0     0     0     2     1    22     0     0     2    86    12     0     0     0     0     0     0     0]
 [    0     0     0     0     0    11     0     0     0     0     0     0    21    15     3     0     0    48     2   268     0     0     0     0     0     0     0]
 [    5     0     0     0     0     0     0     1     0     0     0     0     0     0     0     0     0     0     0     0   998     0     0     0     0     0     0]
 [    1     0     0     0     0     0     0     1     0     0     0     0     0     0     0     0     0     0     0     0     0   213     0     0     0     0     0]
 [    1     0     0     0     0     0     0     0     1     0     0     0     0     0     0     0     0     0     0     0     0     0  2083     0     0     0     0]
 [    4     0     0     0     0     0     0     0     0     1     0     0     0     0     0     0     0     0     0     0     0     0     0    30     0     0     0]
 [    2     0     0     0     0     0     0     0     0     0     0     0     0     0     0     0     0     0     0     0     0     0     0     0    32     0     0]
 [    0     0     0     0     0     0     0     1     0     0     0     0     0     0     0     0     0     0     0     0     0     0     0     0     0    57     0]
 [    0     0     0     0     0     0     0     0     0     0     0     0     0     0     0     0     0     0     0     0     0     0     0     0     0     0   189]]

Accuracy: 0.9786291373468856

Precision: [0.9927 0.9655 0.9710 0.9091 0.9811 0.6279 0.9643 0.9884 1.0000 0.9982 1.0000 1.0000 0.5758 0.6667 0.8831 1.0000 0.9800 0.6000 0.8667 0.6667 0.9918 0.9818 0.9982 0.8750 0.6000 0.9444 0.9556]
Mean: 0.8882972086364982
Std: 0.1476741274400561

Recall: [0.9957 1.0000 0.9710 0.8889 1.0000 0.6136 1.0000 0.9846 0.9767 0.9976 0.9800 1.0000 0.5758 0.7826 0.8947 0.7500 0.9608 0.7000 0.4333 0.6327 0.9918 0.9818 0.9982 0.7000 0.7500 1.0000 1.0000]
Mean: 0.8725889066926228
Std: 0.16405423223519547

F1 score: [0.9942 0.9825 0.9710 0.8989 0.9905 0.6207 0.9818 0.9865 0.9882 0.9979 0.9899 1.0000 0.5758 0.7200 0.8889 0.8571 0.9703 0.6462 0.5778 0.6492 0.9918 0.9818 0.9982 0.7778 0.6667 0.9714 0.9773]
Mean: 0.8760115016991521
Std: 0.15175896950750248

Cohen Kappa score: 0.9698314999032766
Confusion matrix:
[[3697    2    0    3    0    0    1    1    0    3    0    0    0    0    0    0    2    0    0    1    0    1    0    0    2    0    0]
 [   0   56    0    0    0    0    0    0    0    0    0    0    0    0    0    0    0    0    0    0    0    0    0    0    0    0    0]
 [   0    0   67    0    0    0    0    0    0    0    0    0    0    0    0    0    0    0    0    0    0    0    0    1    0    0    1]
 [   5    0    0   40    0    0    0    0    0    0    0    0    0    0    0    0    0    0    0    0    0    0    0    0    0    0    0]
 [   0    0    0    0   52    0    0    0    0    0    0    0    0    0    0    0    0    0    0    0    0    0    0    0    0    0    0]
 [   0    0    0    0    0   27    0    0    0    0    0    0    2    1    2    0    0    2    0   10    0    0    0    0    0    0    0]
 [   0    0    0    0    0    0   27    0    0    0    0    0    0    0    0    0    0    0    0    0    0    0    0    0    0    0    0]
 [   2    0    0    0    0    0    0  256    0    0    0    0    0    0    0    0    0    0    0    0    2    0    0    0    0    0    0]
 [   0    0    0    0    0    0    0    1   42    0    0    0    0    0    0    0    0    0    0    0    0    0    0    0    0    0    0]
 [   2    0    0    0    0    0    0    0    0 1661    0    0    0    0    1    0    0    0    0    1    0    0    0    0    0    0    0]
 [   1    0    0    0    0    0    0    0    0    0   49    0    0    0    0    0    0    0    0    0    0    0    0    0    0    0    0]
 [   0    0    0    0    0    0    0    0    0    0    0  278    0    0    0    0    0    0    0    0    0    0    0    0    0    0    0]
 [   0    0    0    0    0    3    0    0    0    0    0    0   19    2    0    0    0    3    0    6    0    0    0    0    0    0    0]
 [   0    0    0    0    0    1    0    0    0    0    0    0    0   18    0    0    0    2    1    1    0    0    0    0    0    0    0]
 [   1    0    0    0    0    1    0    0    0    0    0    0    1    2   68    0    0    1    1    1    0    0    0    0    0    0    0]
 [   1    0    2    0    0    0    0    0    0    0    0    0    0    0    0   12    0    0    0    0    0    0    1    0    0    0    0]
 [   2    0    0    0    1    0    0    1    0    0    0    0    0    0    0    0   98    0    0    0    0    0    0    0    0    0    0]
 [   4    0    0    0    0    1    0    0    0    0    0    0    4    1    0    0    0   42    0    8    0    0    0    0    0    0    0]
 [   3    0    0    0    0    2    0    0    0    0    0    0    1    0    5    0    0    3   13    3    0    0    0    0    0    0    0]
 [   0    0    0    1    0    8    0    0    0    0    0    0    6    3    1    0    0   17    0   62    0    0    0    0    0    0    0]
 [   1    0    0    0    0    0    0    0    0    0    0    0    0    0    0    0    0    0    0    0  242    0    0    0    0    0    1]
 [   0    0    0    0    0    0    0    0    0    0    0    0    0    0    0    0    0    0    0    0    0   54    0    0    0    1    0]
 [   1    0    0    0    0    0    0    0    0    0    0    0    0    0    0    0    0    0    0    0    0    0  560    0    0    0    0]
 [   3    0    0    0    0    0    0    0    0    0    0    0    0    0    0    0    0    0    0    0    0    0    0    7    0    0    0]
 [   1    0    0    0    0    0    0    0    0    0    0    0    0    0    0    0    0    0    0    0    0    0    0    0    3    0    0]
 [   0    0    0    0    0    0    0    0    0    0    0    0    0    0    0    0    0    0    0    0    0    0    0    0    0   17    0]
 [   0    0    0    0    0    0    0    0    0    0    0    0    0    0    0    0    0    0    0    0    0    0    0    0    0    0   43]]

