Classifier: LogisticRegression
Params: {'C': 1.0, 'class_weight': None, 'dual': False, 'fit_intercept': True, 'intercept_scaling': 1, 'max_iter': 100, 'multi_class': 'ovr', 'n_jobs': 1, 'penalty': 'l2', 'random_state': None, 'solver': 'liblinear', 'tol': 0.0001, 'verbose': 0, 'warm_start': False}

Labels: None

Training accuracy: 0.9824407088871514
Training confusion matrix:
[[14580     5     3     6     1     0     0     9     0    12     1     0     0     0     2     0     6     0     0     0     7     1     5     1     1     0     1]
 [    3   239     0     0     0     0     0     0     0     0     0     0     0     0     0     0     0     0     0     0     0     0     0     0     0     0     0]
 [    3     0   285     0     0     0     0     0     2     0     0     0     0     0     0     0     0     0     0     0     1     0     0     0     0     0     0]
 [   13     0     0   186     0     0     0     0     0     0     0     0     0     0     0     0     0     0     0     0     0     0     0     0     0     0     0]
 [    2     0     0     0   198     0     0     0     0     0     0     0     0     0     0     0     0     0     0     0     0     0     0     0     0     0     0]
 [    0     0     0     0     0   104     0     0     0     0     0     0     8     2     2     0     0     3     3    26     0     0     0     0     0     0     0]
 [    0     0     0     0     0     0   124     0     0     0     0     0     0     0     0     0     0     0     0     0     0     0     0     0     0     0     0]
 [    8     0     0     0     0     0     0   966     0     0     0     0     0     0     0     0     0     0     0     0    10     1     0     0     0     0     0]
 [    4     0     0     0     0     0     0     0   176     0     0     0     0     0     0     0     0     0     0     0     0     0     1     0     0     0     0]
 [   14     0     0     0     0     0     0     0     0  6873     0     0     0     0     0     0     0     0     0     0     0     0     0     0     0     0     0]
 [    9     0     0     0     0     0     0     0     0     0   210     0     0     0     0     0     0     0     0     0     0     0     0     0     0     0     0]
 [    1     0     0     0     0     0     0     0     0     7     0  1191     0     0     0     0     0     0     0     0     0     0     0     0     0     0     0]
 [    0     0     0     0     0     0     0     0     0     0     0     0    68     5     0     0     0     5     0    24     0     0     0     0     0     0     0]
 [    0     0     0     0     0     8     0     0     0     0     0     0     4    50     1     0     0     2     2    18     0     0     0     0     0     0     0]
 [    5     0     0     0     0     3     0     0     0     0     0     0     1     0   301     0     0     2     1     9     0     0     0     0     0     0     0]
 [    1     0     3     0     0     0     0     1     8     0     0     0     0     0     0    39     0     0     0     0     0     0     0     0     0     0     0]
 [    5     0     0     0     0     0     0     0     0     0     0     0     0     0     0     0   405     0     0     0     0     0     0     0     1     0     0]
 [    4     0     0     0     0    14     0     0     0     0     0     0    10     9     1     0     0   218     1    35     0     0     0     0     0     0     0]
 [    2     0     0     0     0     4     0     0     0     0     0     0     1     0    23     0     0     2    83    13     0     0     0     0     0     0     0]
 [    2     0     0     0     0    12     0     0     0     0     0     0    17     8     8     0     0    48     2   271     0     0     0     0     0     0     0]
 [    6     0     0     0     0     0     0     2     0     0     0     0     0     0     0     0     0     0     0     0   996     0     0     0     0     0     0]
 [    3     0     0     0     0     0     0     1     0     0     0     0     0     0     0     0     0     0     0     0     1   210     0     0     0     0     0]
 [    0     0     0     0     0     0     0     0     1     0     0     0     0     0     0     0     0     0     0     0     0     0  2084     0     0     0     0]
 [    9     0     0     0     0     0     0     0     0     1     0     0     0     0     0     0     0     0     0     0     0     0     0    25     0     0     0]
 [    4     0     0     0     0     0     0     0     0     0     0     0     0     0     0     0     0     0     0     0     0     0     0     0    30     0     0]
 [    0     0     0     0     0     0     0     1     0     0     0     0     0     0     0     0     0     0     0     0     0     0     0     0     0    57     0]
 [    1     0     0     0     0     0     0     0     0     0     0     0     0     0     0     0     0     0     0     0     0     0     0     0     0     0   188]]

Accuracy: 0.9779775866562419

Precision: [0.9895 0.9821 0.9444 0.9302 1.0000 0.6383 1.0000 0.9961 0.9333 0.9970 1.0000 1.0000 0.6429 0.6818 0.9200 1.0000 0.9709 0.6056 0.8571 0.6701 0.9879 0.9818 0.9982 0.8333 0.7500 1.0000 0.9773]
Mean: 0.8995573541194406
Std: 0.13379956861640668

Recall: [0.9946 0.9821 0.9855 0.8889 0.9615 0.6818 1.0000 0.9885 0.9767 0.9976 0.9600 0.9964 0.5455 0.6522 0.9079 0.5625 0.9804 0.7167 0.4000 0.6633 1.0000 0.9818 0.9982 0.5000 0.7500 1.0000 1.0000]
Mean: 0.8545221604166372
Std: 0.18667292080146214

F1 score: [0.9921 0.9821 0.9645 0.9091 0.9804 0.6593 1.0000 0.9923 0.9545 0.9973 0.9796 0.9982 0.5902 0.6667 0.9139 0.7200 0.9756 0.6565 0.5455 0.6667 0.9939 0.9818 0.9982 0.6250 0.7500 1.0000 0.9885]
Mean: 0.8696993044460813
Std: 0.15815029117993976

Cohen Kappa score: 0.9688867331667186
Confusion matrix:
[[3693    1    2    3    0    0    0    1    0    5    0    0    0    0    0    0    3    0    0    1    1    1    0    0    1    0    1]
 [   1   55    0    0    0    0    0    0    0    0    0    0    0    0    0    0    0    0    0    0    0    0    0    0    0    0    0]
 [   0    0   68    0    0    0    0    0    0    0    0    0    0    0    0    0    0    0    0    0    0    0    0    1    0    0    0]
 [   5    0    0   40    0    0    0    0    0    0    0    0    0    0    0    0    0    0    0    0    0    0    0    0    0    0    0]
 [   2    0    0    0   50    0    0    0    0    0    0    0    0    0    0    0    0    0    0    0    0    0    0    0    0    0    0]
 [   0    0    0    0    0   30    0    0    0    0    0    0    1    0    1    0    0    1    0   11    0    0    0    0    0    0    0]
 [   0    0    0    0    0    0   27    0    0    0    0    0    0    0    0    0    0    0    0    0    0    0    0    0    0    0    0]
 [   1    0    0    0    0    0    0  257    0    0    0    0    0    0    0    0    0    0    0    0    2    0    0    0    0    0    0]
 [   1    0    0    0    0    0    0    0   42    0    0    0    0    0    0    0    0    0    0    0    0    0    0    0    0    0    0]
 [   3    0    0    0    0    0    0    0    0 1661    0    0    0    0    0    0    0    0    0    1    0    0    0    0    0    0    0]
 [   2    0    0    0    0    0    0    0    0    0   48    0    0    0    0    0    0    0    0    0    0    0    0    0    0    0    0]
 [   1    0    0    0    0    0    0    0    0    0    0  277    0    0    0    0    0    0    0    0    0    0    0    0    0    0    0]
 [   0    0    0    0    0    1    0    0    0    0    0    0   18    3    0    0    0    5    0    6    0    0    0    0    0    0    0]
 [   0    0    0    0    0    2    0    0    0    0    0    0    1   15    0    0    0    3    1    1    0    0    0    0    0    0    0]
 [   1    0    0    0    0    1    0    0    0    0    0    0    1    2   69    0    0    0    1    1    0    0    0    0    0    0    0]
 [   1    0    2    0    0    0    0    0    3    0    0    0    0    0    0    9    0    0    0    0    0    0    1    0    0    0    0]
 [   2    0    0    0    0    0    0    0    0    0    0    0    0    0    0    0  100    0    0    0    0    0    0    0    0    0    0]
 [   4    0    0    0    0    1    0    0    0    0    0    0    3    1    0    0    0   43    0    8    0    0    0    0    0    0    0]
 [   3    0    0    0    0    3    0    0    0    0    0    0    1    0    5    0    0    3   12    3    0    0    0    0    0    0    0]
 [   4    0    0    0    0    9    0    0    0    0    0    0    3    1    0    0    0   16    0   65    0    0    0    0    0    0    0]
 [   0    0    0    0    0    0    0    0    0    0    0    0    0    0    0    0    0    0    0    0  244    0    0    0    0    0    0]
 [   1    0    0    0    0    0    0    0    0    0    0    0    0    0    0    0    0    0    0    0    0   54    0    0    0    0    0]
 [   1    0    0    0    0    0    0    0    0    0    0    0    0    0    0    0    0    0    0    0    0    0  560    0    0    0    0]
 [   5    0    0    0    0    0    0    0    0    0    0    0    0    0    0    0    0    0    0    0    0    0    0    5    0    0    0]
 [   1    0    0    0    0    0    0    0    0    0    0    0    0    0    0    0    0    0    0    0    0    0    0    0    3    0    0]
 [   0    0    0    0    0    0    0    0    0    0    0    0    0    0    0    0    0    0    0    0    0    0    0    0    0   17    0]
 [   0    0    0    0    0    0    0    0    0    0    0    0    0    0    0    0    0    0    0    0    0    0    0    0    0    0   43]]

