Classifier: MLPClassifier
Params: {'activation': 'relu', 'alpha': 0.0001, 'batch_size': 'auto', 'beta_1': 0.9, 'beta_2': 0.999, 'early_stopping': False, 'epsilon': 1e-08, 'hidden_layer_sizes': (100,), 'learning_rate': 'constant', 'learning_rate_init': 0.001, 'max_iter': 200, 'momentum': 0.9, 'nesterovs_momentum': True, 'power_t': 0.5, 'random_state': None, 'shuffle': True, 'solver': 'adam', 'tol': 0.0001, 'validation_fraction': 0.1, 'verbose': False, 'warm_start': False}

Labels: None

Training accuracy: 0.9875553818087047
Training confusion matrix:
[[14624     0     1     5     0     0     0     2     0     2     0     0     0     0     0     0     7     0     0     0     0     0     0     0     0     0     0]
 [    7   235     0     0     0     0     0     0     0     0     0     0     0     0     0     0     0     0     0     0     0     0     0     0     0     0     0]
 [    2     0   287     0     0     0     0     0     1     0     0     0     0     0     0     1     0     0     0     0     0     0     0     0     0     0     0]
 [    6     0     0   193     0     0     0     0     0     0     0     0     0     0     0     0     0     0     0     0     0     0     0     0     0     0     0]
 [    0     0     0     0   200     0     0     0     0     0     0     0     0     0     0     0     0     0     0     0     0     0     0     0     0     0     0]
 [    0     0     0     0     0   133     0     0     0     0     0     0     8     0     0     0     0     5     0     2     0     0     0     0     0     0     0]
 [    0     0     0     0     0     0   124     0     0     0     0     0     0     0     0     0     0     0     0     0     0     0     0     0     0     0     0]
 [    0     0     0     0     0     0     0   979     0     0     0     0     0     0     0     0     0     0     0     0     6     0     0     0     0     0     0]
 [    1     0     0     0     0     0     0     0   180     0     0     0     0     0     0     0     0     0     0     0     0     0     0     0     0     0     0]
 [    1     0     0     0     0     0     0     0     0  6886     0     0     0     0     0     0     0     0     0     0     0     0     0     0     0     0     0]
 [    0     0     0     0     0     0     0     0     0     0   219     0     0     0     0     0     0     0     0     0     0     0     0     0     0     0     0]
 [    0     0     0     0     0     0     0     0     0     7     0  1192     0     0     0     0     0     0     0     0     0     0     0     0     0     0     0]
 [    0     0     0     0     0     0     0     0     0     0     0     0    95     0     0     0     0     5     0     2     0     0     0     0     0     0     0]
 [    1     0     0     0     0    11     0     0     0     0     0     0    12    22     1     0     0    12     2    24     0     0     0     0     0     0     0]
 [    1     0     0     0     0     8     0     0     0     0     0     0     1     0   299     0     0     3     1     9     0     0     0     0     0     0     0]
 [    1     0     2     0     0     0     0     0     7     0     0     0     0     0     0    42     0     0     0     0     0     0     0     0     0     0     0]
 [    0     0     0     0     0     0     0     0     0     0     0     0     0     0     0     0   411     0     0     0     0     0     0     0     0     0     0]
 [    1     0     0     0     0     8     0     0     0     0     0     0     6     1     0     0     0   267     0     9     0     0     0     0     0     0     0]
 [    0     0     0     0     0     6     0     0     0     0     0     0     2     0    17     0     0     2    88    13     0     0     0     0     0     0     0]
 [    0     0     0     0     0    33     0     0     0     0     0     0    35     0     1     0     0    74     1   224     0     0     0     0     0     0     0]
 [    1     0     0     0     0     0     0     1     0     0     0     0     0     0     0     0     0     0     0     0  1002     0     0     0     0     0     0]
 [    1     0     0     0     0     0     0     0     0     0     0     0     0     0     0     0     0     0     0     0     0   214     0     0     0     0     0]
 [    0     0     0     0     0     0     0     0     1     0     0     0     0     0     0     0     0     0     0     0     0     0  2084     0     0     0     0]
 [    1     0     0     0     0     0     0     0     0     1     0     0     0     0     0     0     0     0     0     0     0     0     0    33     0     0     0]
 [    0     0     0     0     0     0     0     0     0     0     0     0     0     0     0     0     0     0     0     0     0     0     0     0    34     0     0]
 [    0     0     0     0     0     0     0     0     0     0     0     0     0     0     0     0     0     0     0     0     0     0     0     0     0    58     0]
 [    0     0     0     0     0     0     0     0     0     0     0     0     0     0     0     0     0     0     0     0     0     0     0     0     0     0   189]]

Accuracy: 0.9791503778994006

Precision: [0.9930 0.9818 0.9571 0.9130 1.0000 0.6545 1.0000 0.9961 0.9556 0.9988 1.0000 1.0000 0.5510 0.7778 0.9324 1.0000 0.9615 0.5417 0.8750 0.7903 0.9917 0.9815 0.9982 0.7692 0.7500 1.0000 0.9545]
Mean: 0.9009263343641207
Std: 0.13757035272117216

Recall: [0.9960 0.9643 0.9710 0.9333 0.9423 0.8182 1.0000 0.9885 1.0000 0.9976 0.9800 1.0000 0.8182 0.3043 0.9079 0.6875 0.9804 0.8667 0.4667 0.5000 0.9836 0.9636 0.9964 1.0000 0.7500 1.0000 0.9767]
Mean: 0.8812301571462255
Std: 0.18287952669406526

F1 score: [0.9945 0.9730 0.9640 0.9231 0.9703 0.7273 1.0000 0.9923 0.9773 0.9982 0.9899 1.0000 0.6585 0.4375 0.9200 0.8148 0.9709 0.6667 0.6087 0.6125 0.9877 0.9725 0.9973 0.8696 0.7500 1.0000 0.9655]
Mean: 0.8793299054297482
Std: 0.1565025991212663

Cohen Kappa score: 0.9705699977636995
Confusion matrix:
[[3698    1    0    4    0    0    0    0    0    2    0    0    0    0    0    0    4    0    0    0    0    1    0    1    1    0    1]
 [   2   54    0    0    0    0    0    0    0    0    0    0    0    0    0    0    0    0    0    0    0    0    0    0    0    0    0]
 [   1    0   67    0    0    0    0    0    0    0    0    0    0    0    0    0    0    0    0    0    0    0    0    1    0    0    0]
 [   3    0    0   42    0    0    0    0    0    0    0    0    0    0    0    0    0    0    0    0    0    0    0    0    0    0    0]
 [   3    0    0    0   49    0    0    0    0    0    0    0    0    0    0    0    0    0    0    0    0    0    0    0    0    0    0]
 [   0    0    0    0    0   36    0    0    0    0    0    0    2    0    0    0    0    4    0    2    0    0    0    0    0    0    0]
 [   0    0    0    0    0    0   27    0    0    0    0    0    0    0    0    0    0    0    0    0    0    0    0    0    0    0    0]
 [   1    0    0    0    0    0    0  257    0    0    0    0    0    0    0    0    0    0    0    0    2    0    0    0    0    0    0]
 [   0    0    0    0    0    0    0    0   43    0    0    0    0    0    0    0    0    0    0    0    0    0    0    0    0    0    0]
 [   3    0    0    0    0    0    0    0    0 1661    0    0    0    0    0    0    0    0    0    1    0    0    0    0    0    0    0]
 [   0    0    0    0    0    0    0    0    0    0   49    0    0    0    0    0    0    0    0    0    0    0    0    1    0    0    0]
 [   0    0    0    0    0    0    0    0    0    0    0  278    0    0    0    0    0    0    0    0    0    0    0    0    0    0    0]
 [   0    0    0    0    0    1    0    0    0    0    0    0   27    0    0    0    0    4    0    1    0    0    0    0    0    0    0]
 [   1    0    0    0    0    2    0    0    0    0    0    0    6    7    0    0    0    4    1    2    0    0    0    0    0    0    0]
 [   0    0    0    0    0    1    0    0    0    0    0    0    1    2   69    0    0    0    1    2    0    0    0    0    0    0    0]
 [   2    0    2    0    0    0    0    0    0    0    0    0    0    0    0   11    0    0    0    0    0    0    1    0    0    0    0]
 [   2    0    0    0    0    0    0    0    0    0    0    0    0    0    0    0  100    0    0    0    0    0    0    0    0    0    0]
 [   2    0    0    0    0    1    0    0    0    0    0    0    3    0    0    0    0   52    0    2    0    0    0    0    0    0    0]
 [   1    0    0    0    0    3    0    0    0    0    0    0    1    0    5    0    0    3   14    3    0    0    0    0    0    0    0]
 [   0    0    0    0    0   11    0    0    0    0    0    0    9    0    0    0    0   29    0   49    0    0    0    0    0    0    0]
 [   1    0    0    0    0    0    0    1    1    0    0    0    0    0    0    0    0    0    0    0  240    0    0    0    0    0    1]
 [   1    0    0    0    0    0    0    0    1    0    0    0    0    0    0    0    0    0    0    0    0   53    0    0    0    0    0]
 [   2    0    0    0    0    0    0    0    0    0    0    0    0    0    0    0    0    0    0    0    0    0  559    0    0    0    0]
 [   0    0    0    0    0    0    0    0    0    0    0    0    0    0    0    0    0    0    0    0    0    0    0   10    0    0    0]
 [   1    0    0    0    0    0    0    0    0    0    0    0    0    0    0    0    0    0    0    0    0    0    0    0    3    0    0]
 [   0    0    0    0    0    0    0    0    0    0    0    0    0    0    0    0    0    0    0    0    0    0    0    0    0   17    0]
 [   0    0    1    0    0    0    0    0    0    0    0    0    0    0    0    0    0    0    0    0    0    0    0    0    0    0   42]]

