Classifier: MultinomialNB
Params: {'alpha': 1.0, 'class_prior': None, 'fit_prior': True}

Labels: None

Training accuracy: 0.87395751889497
Training confusion matrix:
[[12645   117     9   481     6     7     0    45     1    71   314     5     0    16   118     1     4    67    19    53    18    20    10    52   250     1   311]
 [    3   239     0     0     0     0     0     0     0     0     0     0     0     0     0     0     0     0     0     0     0     0     0     0     0     0     0]
 [    3     1   192     1    24     0    15     0    13     0     0     0     0     0     0     0     0     0     0     0     8     2     1     0     0     0    31]
 [   12     0     0   185     0     0     0     0     0     0     0     0     0     0     0     0     2     0     0     0     0     0     0     0     0     0     0]
 [    0     0     0     1   190     0     0     0     4     0     0     0     0     0     0     0     0     0     0     0     1     3     0     0     0     0     1]
 [    0     0     0     0     0   122     0     0     0     0     0     0     4     0     6     0     0     0     0    14     0     0     0     2     0     0     0]
 [    0     0     0     0     0     0   119     0     4     0     0     0     0     0     0     0     0     0     0     0     0     1     0     0     0     0     0]
 [    2     0    24     2    16     0    13   844     9     0     0     0     0     0     0     1     0     0     0     0    17     6     1     0     0     0    50]
 [    3     0     0     0     1     0     5     0   163     0     0     0     0     0     0     0     1     0     0     0     1     0     6     0     0     1     0]
 [  530     0     0    10     0     0     0     0     1  6291     9     2     0     0     3     1     0     0     0     0     0    17     0     7     0    16     0]
 [   11     0     0     0     0     0     0     0     0     0   208     0     0     0     0     0     0     0     0     0     0     0     0     0     0     0     0]
 [   25     0     0     0     0     0     0     0     0     3     0  1169     0     0     0     0     0     0     0     0     0     0     0     0     2     0     0]
 [    0     0     0     0     0    12     0     0     0     0     0     0    53    16     2     0     0     3     0    16     0     0     0     0     0     0     0]
 [    0     0     0     0     0    11     0     0     0     0     0     0    20    26     3     0     0     5     0    20     0     0     0     0     0     0     0]
 [    6     0     1     3     0     9     0     0     3     0     0     0     1    19   221     2     2    27     8    10     1     4     5     0     0     0     0]
 [    0     0     0     0     3     0     1     0     8     0     0     0     0     0     0    28     6     0     0     0     0     0     6     0     0     0     0]
 [   10     0     0    46     3     0     1     0     0     0     0     0     0     0     0     1   348     0     0     0     0     0     0     0     2     0     0]
 [    9     0     0     0     0    15     0     0     0     0     0     0    11    23    20     0     0   138     6    69     0     0     0     0     0     0     1]
 [    1     0     0     0     0     9     0     0     0     0     0     0     3     2    40     0     0    17    44    12     0     0     0     0     0     0     0]
 [    4     1     0     0     0    36     5     0     0     0     6     0    32    16    12     0     2    36     0   209     1     0     5     0     0     3     0]
 [    2     0     7     0     0     0     0     1     4     0     0     0     0     0     0     0     0     0     0     0   900     3     0     0     0     0    87]
 [    3     0     2     0     1     0     0     5     0     0     0     0     0     0     0     0     0     0     0     0    12   184     0     0     0     0     8]
 [    2     0     0     2    10     0     7     0    14     0     0     0     0     0     0     3     0     0     0     0     0     0  2046     0     0     0     1]
 [    8     4     0     0     0     0     0     0     0     0     2     0     0     0     0     0     0     0     0     0     0     0     0    21     0     0     0]
 [    0     0     0     2     0     0     0     0     0     0     0     0     0     0     0     0     0     0     0     0     0     0     0     0    32     0     0]
 [    0     0     0     0     3     0     0     1     1     0     0     0     0     0     0     0     0     0     0     0     0     1     0     0     0    52     0]
 [    0     0    22     0     2     0     1     1     2     0     0     0     0     0     0     0     0     0     0     0     2     1     0     0     0     0   158]]

Accuracy: 0.8815480844409695

Precision: [0.9590 0.7179 0.7164 0.2727 0.7500 0.5614 0.5778 0.9770 0.7115 0.9834 0.3429 0.9964 0.5429 0.3750 0.4949 0.7500 0.9091 0.3714 0.5200 0.4954 0.9447 0.8500 0.9875 0.2778 0.0517 0.7000 0.2432]
Mean: 0.6325950810776739
Std: 0.2659527862279415

Recall: [0.8764 1.0000 0.6957 0.9333 0.9231 0.7273 0.9630 0.8154 0.8605 0.9237 0.9600 0.9856 0.5758 0.3913 0.6447 0.3750 0.8824 0.4333 0.4333 0.5510 0.9098 0.9273 0.9857 0.5000 0.7500 0.8235 0.8372]
Mean: 0.7660847930110721
Std: 0.20061014460099427

F1 score: [0.9158 0.8358 0.7059 0.4221 0.8276 0.6337 0.7222 0.8889 0.7789 0.9526 0.5053 0.9910 0.5588 0.3830 0.5600 0.5000 0.8955 0.4000 0.4727 0.5217 0.9269 0.8870 0.9866 0.3571 0.0968 0.7568 0.3770]
Mean: 0.6614718894277927
Std: 0.23578026385114104

Cohen Kappa score: 0.8381738435765813
Confusion matrix:
[[3254   21    2   99    0    1    0    5    0   25   87    1    0    2   26    1    3   14    7   17    2    5    0   13   54    0   74]
 [   0   56    0    0    0    0    0    0    0    0    0    0    0    0    0    0    0    0    0    0    0    0    0    0    0    0    0]
 [   2    0   48    0    3    0    5    0    1    0    0    0    0    0    0    0    0    0    0    0    5    0    0    0    0    0    5]
 [   3    0    0   42    0    0    0    0    0    0    0    0    0    0    0    0    0    0    0    0    0    0    0    0    0    0    0]
 [   0    0    0    0   48    0    2    0    2    0    0    0    0    0    0    0    0    0    0    0    0    0    0    0    0    0    0]
 [   0    0    0    0    0   32    0    0    0    0    0    0    1    0    5    0    0    0    0    6    0    0    0    0    0    0    0]
 [   0    0    0    0    0    0   26    0    0    0    0    0    0    0    0    0    1    0    0    0    0    0    0    0    0    0    0]
 [   0    0   11    2    7    0    5  212    5    0    0    0    0    0    0    0    0    0    0    0    4    2    0    0    0    0   12]
 [   1    0    0    0    1    0    2    0   37    0    0    0    0    0    0    0    2    0    0    0    0    0    0    0    0    0    0]
 [ 115    0    0    3    0    0    0    0    0 1538    2    0    0    0    1    0    0    0    0    0    0    1    0    0    0    5    0]
 [   2    0    0    0    0    0    0    0    0    0   48    0    0    0    0    0    0    0    0    0    0    0    0    0    0    0    0]
 [   3    0    0    0    0    0    0    0    0    1    0  274    0    0    0    0    0    0    0    0    0    0    0    0    0    0    0]
 [   0    0    0    0    0    3    0    0    0    0    0    0   19    3    1    0    0    0    0    7    0    0    0    0    0    0    0]
 [   0    0    0    0    0    2    0    0    0    0    0    0    5    9    3    0    0    2    0    2    0    0    0    0    0    0    0]
 [   1    0    0    0    0    2    0    0    0    0    1    0    1    3   49    1    1   10    3    3    0    0    1    0    0    0    0]
 [   0    0    0    0    0    0    1    0    1    0    0    0    0    0    0    6    1    0    0    0    0    0    6    0    0    0    1]
 [   3    0    0    7    0    0    1    0    0    0    0    0    0    0    0    0   90    0    0    0    0    0    0    0    1    0    0]
 [   1    0    0    0    0    2    0    0    0    0    0    0    2    5    4    0    0   26    2   18    0    0    0    0    0    0    0]
 [   0    0    0    1    0    4    0    0    0    0    0    0    2    0    6    0    0    2   13    2    0    0    0    0    0    0    0]
 [   2    0    0    0    0   11    0    0    0    0    1    0    5    2    4    0    0   16    0   54    0    1    0    0    0    1    1]
 [   1    0    1    0    0    0    0    0    2    0    0    0    0    0    0    0    0    0    0    0  222    0    0    0    0    0   18]
 [   0    0    1    0    0    0    0    0    1    0    0    0    0    0    0    0    0    0    0    0    1   51    0    0    0    0    1]
 [   1    0    0    0    3    0    2    0    2    0    0    0    0    0    0    0    0    0    0    0    0    0  553    0    0    0    0]
 [   3    1    0    0    0    0    0    0    0    0    1    0    0    0    0    0    0    0    0    0    0    0    0    5    0    0    0]
 [   1    0    0    0    0    0    0    0    0    0    0    0    0    0    0    0    0    0    0    0    0    0    0    0    3    0    0]
 [   0    0    0    0    2    0    0    0    0    0    0    0    0    0    0    0    1    0    0    0    0    0    0    0    0   14    0]
 [   0    0    4    0    0    0    1    0    1    0    0    0    0    0    0    0    0    0    0    0    1    0    0    0    0    0   36]]

