Classifier: RandomForestClassifier
Params: {'bootstrap': True, 'class_weight': None, 'criterion': 'gini', 'max_depth': None, 'max_features': 'auto', 'max_leaf_nodes': None, 'min_impurity_decrease': 0.0, 'min_impurity_split': None, 'min_samples_leaf': 1, 'min_samples_split': 2, 'min_weight_fraction_leaf': 0.0, 'n_estimators': 100, 'n_jobs': 1, 'oob_score': False, 'random_state': None, 'verbose': 0, 'warm_start': False}

Labels: None

Training accuracy: 0.9936148032316914
Training confusion matrix:
[[14628     2     0     4     0     0     0     2     0     2     0     0     0     0     0     1     2     0     0     0     0     0     0     0     0     0     0]
 [    0   242     0     0     0     0     0     0     0     0     0     0     0     0     0     0     0     0     0     0     0     0     0     0     0     0     0]
 [    1     0   289     0     0     0     0     0     1     0     0     0     0     0     0     0     0     0     0     0     0     0     0     0     0     0     0]
 [    4     0     0   195     0     0     0     0     0     0     0     0     0     0     0     0     0     0     0     0     0     0     0     0     0     0     0]
 [    0     0     0     0   200     0     0     0     0     0     0     0     0     0     0     0     0     0     0     0     0     0     0     0     0     0     0]
 [    0     0     0     0     0   134     0     0     0     0     0     0     0     1     3     0     0     2     0     8     0     0     0     0     0     0     0]
 [    0     0     0     0     0     0   124     0     0     0     0     0     0     0     0     0     0     0     0     0     0     0     0     0     0     0     0]
 [    0     0     0     0     0     0     0   979     0     0     0     0     0     0     0     0     0     0     0     0     6     0     0     0     0     0     0]
 [    0     0     0     0     0     0     0     0   181     0     0     0     0     0     0     0     0     0     0     0     0     0     0     0     0     0     0]
 [    1     0     0     0     0     0     0     0     0  6886     0     0     0     0     0     0     0     0     0     0     0     0     0     0     0     0     0]
 [    0     0     0     0     0     0     0     0     0     0   219     0     0     0     0     0     0     0     0     0     0     0     0     0     0     0     0]
 [    0     0     0     0     0     0     0     0     0     7     0  1192     0     0     0     0     0     0     0     0     0     0     0     0     0     0     0]
 [    0     0     0     0     0     1     0     0     0     0     0     0    85     1     1     0     0     5     0     9     0     0     0     0     0     0     0]
 [    0     0     0     0     0     2     0     0     0     0     0     0     0    76     0     0     0     3     1     3     0     0     0     0     0     0     0]
 [    0     0     0     0     0     0     0     0     0     0     0     0     0     0   318     0     0     1     2     1     0     0     0     0     0     0     0]
 [    0     0     1     0     0     0     0     0     6     0     0     0     0     0     0    45     0     0     0     0     0     0     0     0     0     0     0]
 [    2     0     0     0     0     0     0     0     0     0     0     0     0     0     0     0   409     0     0     0     0     0     0     0     0     0     0]
 [    0     0     0     0     0     1     0     0     0     0     0     0     0     2     0     0     0   268     1    20     0     0     0     0     0     0     0]
 [    0     0     0     0     0     2     0     0     0     0     0     0     0     1    11     0     0     1   111     2     0     0     0     0     0     0     0]
 [    0     0     0     0     0     6     0     0     0     0     0     0    14     6     6     0     0    28     5   303     0     0     0     0     0     0     0]
 [    1     0     0     0     0     0     0     0     0     0     0     0     0     0     0     0     0     0     0     0  1003     0     0     0     0     0     0]
 [    0     0     0     0     0     0     0     0     0     0     0     0     0     0     0     0     0     0     0     0     0   215     0     0     0     0     0]
 [    0     0     0     0     0     0     0     0     1     0     0     0     0     0     0     0     0     0     0     0     0     0  2084     0     0     0     0]
 [    1     0     0     0     0     0     0     0     0     1     0     0     0     0     0     0     0     0     0     0     0     0     0    33     0     0     0]
 [    0     0     0     0     0     0     0     0     0     0     0     0     0     0     0     0     0     0     0     0     0     0     0     0    34     0     0]
 [    0     0     0     0     0     0     0     0     0     0     0     0     0     0     0     0     0     0     0     0     0     0     0     0     0    58     0]
 [    0     0     0     0     0     0     0     0     0     0     0     0     0     0     0     0     0     0     0     0     0     0     0     0     0     0   189]]

Accuracy: 0.9766744852749544

Precision: [0.9896 0.9474 0.9275 0.8667 1.0000 0.6389 0.9630 0.9923 0.9535 0.9988 1.0000 0.9964 0.6061 0.7500 0.8904 0.8571 0.9608 0.6515 0.7895 0.6729 0.9798 0.9444 0.9982 0.9000 0.7500 1.0000 0.9756]
Mean: 0.888899972007598
Std: 0.12585242632376914

Recall: [0.9949 0.9643 0.9275 0.8667 0.9615 0.5227 0.9630 0.9923 0.9535 0.9982 0.9800 1.0000 0.6061 0.5217 0.8553 0.7500 0.9608 0.7167 0.5000 0.7347 0.9918 0.9273 0.9982 0.9000 0.7500 0.8824 0.9302]
Mean: 0.8573955978941379
Std: 0.15807469893015938

F1 score: [0.9922 0.9558 0.9275 0.8667 0.9804 0.5750 0.9630 0.9923 0.9535 0.9985 0.9899 0.9982 0.6061 0.6154 0.8725 0.8000 0.9608 0.6825 0.6122 0.7024 0.9857 0.9358 0.9982 0.9000 0.7500 0.9375 0.9524]
Mean: 0.8705361690128223
Std: 0.14152769835557308

Cohen Kappa score: 0.9670446180440556
Confusion matrix:
[[3694    3    1    5    0    0    0    0    0    2    0    0    0    0    1    0    3    0    1    0    0    1    0    1    1    0    0]
 [   2   54    0    0    0    0    0    0    0    0    0    0    0    0    0    0    0    0    0    0    0    0    0    0    0    0    0]
 [   2    0   64    0    0    0    0    1    0    0    0    0    0    0    0    0    0    0    0    0    1    0    0    0    0    0    1]
 [   6    0    0   39    0    0    0    0    0    0    0    0    0    0    0    0    0    0    0    0    0    0    0    0    0    0    0]
 [   0    0    0    0   50    0    0    0    0    0    0    0    0    0    0    0    0    0    0    0    0    2    0    0    0    0    0]
 [   1    0    0    0    0   23    0    0    0    0    0    0    2    0    2    0    0    3    0   13    0    0    0    0    0    0    0]
 [   1    0    0    0    0    0   26    0    0    0    0    0    0    0    0    0    0    0    0    0    0    0    0    0    0    0    0]
 [   0    0    0    0    0    0    0  258    0    0    0    0    0    0    0    0    0    0    0    0    2    0    0    0    0    0    0]
 [   1    0    1    0    0    0    0    0   41    0    0    0    0    0    0    0    0    0    0    0    0    0    0    0    0    0    0]
 [   2    0    0    0    0    0    0    0    0 1662    0    1    0    0    0    0    0    0    0    0    0    0    0    0    0    0    0]
 [   1    0    0    0    0    0    0    0    0    0   49    0    0    0    0    0    0    0    0    0    0    0    0    0    0    0    0]
 [   0    0    0    0    0    0    0    0    0    0    0  278    0    0    0    0    0    0    0    0    0    0    0    0    0    0    0]
 [   0    0    0    0    0    3    0    0    0    0    0    0   20    0    0    0    0    2    0    8    0    0    0    0    0    0    0]
 [   1    0    0    0    0    2    0    0    0    0    0    0    4   12    0    0    0    2    1    1    0    0    0    0    0    0    0]
 [   3    0    0    0    0    1    0    0    0    0    0    0    1    2   65    0    0    0    2    2    0    0    0    0    0    0    0]
 [   1    0    2    0    0    0    0    0    0    0    0    0    0    0    0   12    0    0    0    0    0    0    1    0    0    0    0]
 [   3    0    0    1    0    0    0    0    0    0    0    0    0    0    0    0   98    0    0    0    0    0    0    0    0    0    0]
 [   5    0    0    0    0    0    0    0    0    0    0    0    2    1    0    0    0   43    0    9    0    0    0    0    0    0    0]
 [   3    0    0    0    0    3    0    0    0    0    0    0    1    0    4    0    0    2   15    2    0    0    0    0    0    0    0]
 [   3    0    0    0    0    4    0    0    0    0    0    0    3    1    1    0    0   14    0   72    0    0    0    0    0    0    0]
 [   1    0    0    0    0    0    0    0    0    0    0    0    0    0    0    1    0    0    0    0  242    0    0    0    0    0    0]
 [   1    0    0    0    0    0    0    1    1    0    0    0    0    0    0    0    0    0    0    0    1   51    0    0    0    0    0]
 [   0    0    0    0    0    0    0    0    1    0    0    0    0    0    0    0    0    0    0    0    0    0  560    0    0    0    0]
 [   1    0    0    0    0    0    0    0    0    0    0    0    0    0    0    0    0    0    0    0    0    0    0    9    0    0    0]
 [   1    0    0    0    0    0    0    0    0    0    0    0    0    0    0    0    0    0    0    0    0    0    0    0    3    0    0]
 [   0    0    0    0    0    0    0    0    0    0    0    0    0    0    0    1    1    0    0    0    0    0    0    0    0   15    0]
 [   0    0    1    0    0    0    1    0    0    0    0    0    0    0    0    0    0    0    0    0    1    0    0    0    0    0   40]]

