Classifier: LinearSVC
Params: {'C': 1.0, 'class_weight': None, 'dual': True, 'fit_intercept': True, 'intercept_scaling': 1, 'loss': 'squared_hinge', 'max_iter': 1000, 'multi_class': 'ovr', 'penalty': 'l2', 'random_state': None, 'tol': 0.0001, 'verbose': 0}

Labels: None

Training accuracy: 0.9895751889497003
Training confusion matrix:
[[14691     0     0     5     0     0     0     1     0     0     0     0     0     0     1     0     4     0     0     0     0     0     0     0     2     0     0]
 [    0   236     0     0     0     0     0     0     0     0     0     0     0     0     0     0     0     0     0     0     0     0     0     0     0     0     0]
 [    2     0   279     0     0     0     0     0     0     0     0     0     0     0     0     0     0     0     0     0     0     0     0     0     0     0     0]
 [    6     0     0   192     0     0     0     0     0     0     0     0     0     0     0     0     0     0     0     0     0     0     0     0     0     0     0]
 [    0     0     0     0   194     0     0     0     0     0     0     0     0     0     0     0     0     0     0     0     0     0     0     0     0     0     0]
 [    0     0     0     0     0   111     0     0     0     0     0     0     7     6     2     0     0     2     2    27     0     0     0     0     0     0     0]
 [    0     0     0     0     0     0   120     0     0     0     0     0     0     0     0     0     0     0     0     0     0     0     0     0     0     0     0]
 [    1     0     0     0     0     0     0  1024     0     0     0     0     0     0     0     0     0     0     0     0     0     0     0     0     0     0     0]
 [    0     0     0     0     0     0     0     0   181     0     0     0     0     0     0     0     0     0     0     0     0     0     0     0     0     0     0]
 [    5     0     0     0     0     0     0     0     0  6814     0     0     0     0     0     0     0     0     0     0     0     0     0     0     0     0     0]
 [    0     0     0     0     0     0     0     0     0     0   219     0     0     0     0     0     0     0     0     0     0     0     0     0     0     0     0]
 [    0     0     0     0     0     0     0     0     0     0     0  1175     0     0     0     0     0     0     0     0     0     0     0     0     0     0     0]
 [    0     0     0     0     0     2     0     0     0     0     0     0    79     6     0     0     0     2     0    21     0     0     0     0     0     0     0]
 [    0     0     0     0     0     3     0     0     0     0     0     0     0    82     0     0     0     3     1     1     0     0     0     0     0     0     0]
 [    0     0     0     0     0     0     0     0     0     0     0     0     1     0   304     0     0     1     4     7     0     0     0     0     0     0     0]
 [    0     0     0     0     0     0     0     0     0     0     0     0     0     0     0    50     0     0     0     0     0     0     0     0     0     0     0]
 [    5     0     0     0     0     0     0     0     0     0     0     0     0     0     0     0   390     0     0     0     0     0     0     0     0     0     0]
 [    0     0     0     0     0     9     0     0     0     0     0     0    13     9     1     0     0   208     3    36     0     0     0     0     0     0     0]
 [    0     0     0     0     0     0     0     0     0     0     0     0     2     0    10     0     0     0   106    10     0     0     0     0     0     0     0]
 [    1     0     0     0     0    17     0     0     0     0     0     0    18    13     4     0     0    40     1   283     0     0     0     0     0     0     0]
 [    1     0     0     0     0     0     0     0     0     0     0     0     0     0     0     0     0     0     0     0   989     0     0     0     0     0     0]
 [    1     0     0     0     0     0     0     0     0     0     0     0     0     0     0     0     0     0     0     0     0   210     0     0     0     0     0]
 [    0     0     0     0     0     0     0     0     1     0     0     0     0     0     0     0     0     0     0     0     0     0  2128     0     0     0     0]
 [    0     0     0     0     0     0     0     0     0     0     0     0     0     0     0     0     0     0     0     0     0     0     0    38     0     0     0]
 [    0     0     0     0     0     0     0     0     0     0     0     0     0     0     0     0     0     0     0     0     0     0     0     0    33     0     0]
 [    0     0     0     0     0     0     0     0     0     0     0     0     0     0     0     0     0     0     0     0     0     0     0     0     0    60     0]
 [    0     0     0     0     0     0     0     0     0     0     0     0     0     0     0     0     0     0     0     0     0     0     0     0     0     0   180]]

Accuracy: 0.9808444096950742

Precision: [0.9948 0.9683 1.0000 0.9375 1.0000 0.6562 1.0000 0.9910 1.0000 0.9983 0.9804 1.0000 0.5000 0.4211 0.8554 1.0000 0.9833 0.7258 0.5882 0.7042 0.9961 0.9831 1.0000 0.8750 1.0000 1.0000 1.0000]
Mean: 0.8947641256140254
Std: 0.16986528506376902

Recall: [0.9956 0.9839 0.9494 0.9783 1.0000 0.6000 1.0000 0.9955 1.0000 0.9971 1.0000 1.0000 0.6000 0.8889 0.8765 0.9444 1.0000 0.6164 0.6667 0.5618 0.9884 0.9831 1.0000 1.0000 0.8000 1.0000 1.0000]
Mean: 0.9046624814381931
Std: 0.1489821139027745

F1 score: [0.9952 0.9760 0.9740 0.9574 1.0000 0.6269 1.0000 0.9932 1.0000 0.9977 0.9901 1.0000 0.5455 0.5714 0.8659 0.9714 0.9916 0.6667 0.6250 0.6250 0.9922 0.9831 1.0000 0.9333 0.8889 1.0000 1.0000]
Mean: 0.8952019386609366
Std: 0.1568909085631945

Cohen Kappa score: 0.9731544132056876
Confusion matrix:
[[3634    2    0    2    0    0    0    2    0    3    1    0    0    0    1    0    2    0    0    0    1    1    0    1    0    0    0]
 [   1   61    0    0    0    0    0    0    0    0    0    0    0    0    0    0    0    0    0    0    0    0    0    0    0    0    0]
 [   4    0   75    0    0    0    0    0    0    0    0    0    0    0    0    0    0    0    0    0    0    0    0    0    0    0    0]
 [   1    0    0   45    0    0    0    0    0    0    0    0    0    0    0    0    0    0    0    0    0    0    0    0    0    0    0]
 [   0    0    0    0   58    0    0    0    0    0    0    0    0    0    0    0    0    0    0    0    0    0    0    0    0    0    0]
 [   0    0    0    0    0   21    0    0    0    0    0    0    0    0    4    0    0    0    5    5    0    0    0    0    0    0    0]
 [   0    0    0    0    0    0   31    0    0    0    0    0    0    0    0    0    0    0    0    0    0    0    0    0    0    0    0]
 [   1    0    0    0    0    0    0  219    0    0    0    0    0    0    0    0    0    0    0    0    0    0    0    0    0    0    0]
 [   0    0    0    0    0    0    0    0   43    0    0    0    0    0    0    0    0    0    0    0    0    0    0    0    0    0    0]
 [   5    0    0    0    0    0    0    0    0 1728    0    0    0    0    0    0    0    0    0    0    0    0    0    0    0    0    0]
 [   0    0    0    0    0    0    0    0    0    0   50    0    0    0    0    0    0    0    0    0    0    0    0    0    0    0    0]
 [   0    0    0    0    0    0    0    0    0    0    0  302    0    0    0    0    0    0    0    0    0    0    0    0    0    0    0]
 [   0    0    0    0    0    1    0    0    0    0    0    0   15    5    0    0    0    1    0    3    0    0    0    0    0    0    0]
 [   0    0    0    0    0    0    0    0    0    0    0    0    0   16    0    0    0    0    2    0    0    0    0    0    0    0    0]
 [   1    0    0    0    0    2    0    0    0    0    0    0    1    2   71    0    0    0    3    1    0    0    0    0    0    0    0]
 [   1    0    0    0    0    0    0    0    0    0    0    0    0    0    0   17    0    0    0    0    0    0    0    0    0    0    0]
 [   0    0    0    0    0    0    0    0    0    0    0    0    0    0    0    0  118    0    0    0    0    0    0    0    0    0    0]
 [   0    0    0    0    0    3    0    0    0    0    0    0    8    3    1    0    0   45    3   10    0    0    0    0    0    0    0]
 [   0    0    0    0    0    0    0    0    0    0    0    0    1    0    6    0    0    1   20    2    0    0    0    0    0    0    0]
 [   1    0    0    0    0    5    0    0    0    0    0    0    5   12    0    0    0   15    1   50    0    0    0    0    0    0    0]
 [   3    0    0    0    0    0    0    0    0    0    0    0    0    0    0    0    0    0    0    0  255    0    0    0    0    0    0]
 [   1    0    0    0    0    0    0    0    0    0    0    0    0    0    0    0    0    0    0    0    0   58    0    0    0    0    0]
 [   0    0    0    0    0    0    0    0    0    0    0    0    0    0    0    0    0    0    0    0    0    0  517    0    0    0    0]
 [   0    0    0    0    0    0    0    0    0    0    0    0    0    0    0    0    0    0    0    0    0    0    0    7    0    0    0]
 [   0    0    0    1    0    0    0    0    0    0    0    0    0    0    0    0    0    0    0    0    0    0    0    0    4    0    0]
 [   0    0    0    0    0    0    0    0    0    0    0    0    0    0    0    0    0    0    0    0    0    0    0    0    0   15    0]
 [   0    0    0    0    0    0    0    0    0    0    0    0    0    0    0    0    0    0    0    0    0    0    0    0    0    0   52]]

