Classifier: LogisticRegression
Params: {'C': 1.0, 'class_weight': None, 'dual': False, 'fit_intercept': True, 'intercept_scaling': 1, 'max_iter': 100, 'multi_class': 'ovr', 'n_jobs': 1, 'penalty': 'l2', 'random_state': None, 'solver': 'liblinear', 'tol': 0.0001, 'verbose': 0, 'warm_start': False}

Labels: None

Training accuracy: 0.9872947615324472
Training confusion matrix:
[[14666     5     2     4     0     0     0     8     0     1     1     0     0     0     1     0     5     0     0     0     3     2     2     1     2     0     1]
 [    1   235     0     0     0     0     0     0     0     0     0     0     0     0     0     0     0     0     0     0     0     0     0     0     0     0     0]
 [    3     0   278     0     0     0     0     0     0     0     0     0     0     0     0     0     0     0     0     0     0     0     0     0     0     0     0]
 [   12     0     0   186     0     0     0     0     0     0     0     0     0     0     0     0     0     0     0     0     0     0     0     0     0     0     0]
 [    0     0     0     0   194     0     0     0     0     0     0     0     0     0     0     0     0     0     0     0     0     0     0     0     0     0     0]
 [    0     0     0     0     0   107     0     0     0     0     0     0     7     6     2     0     0     2     2    31     0     0     0     0     0     0     0]
 [    0     0     0     0     0     0   120     0     0     0     0     0     0     0     0     0     0     0     0     0     0     0     0     0     0     0     0]
 [    3     0     1     0     0     0     0  1018     0     0     0     0     0     0     0     0     0     0     0     0     3     0     0     0     0     0     0]
 [    0     0     0     0     0     0     0     0   181     0     0     0     0     0     0     0     0     0     0     0     0     0     0     0     0     0     0]
 [   10     0     0     0     0     0     0     0     0  6809     0     0     0     0     0     0     0     0     0     0     0     0     0     0     0     0     0]
 [    5     0     0     0     0     0     0     0     0     0   214     0     0     0     0     0     0     0     0     0     0     0     0     0     0     0     0]
 [    0     0     0     0     0     0     0     0     0     0     0  1175     0     0     0     0     0     0     0     0     0     0     0     0     0     0     0]
 [    0     0     0     0     0     2     0     0     0     0     0     0    72     7     0     0     0     2     0    27     0     0     0     0     0     0     0]
 [    0     0     0     0     0     3     0     0     0     0     0     0     0    79     1     0     0     3     1     3     0     0     0     0     0     0     0]
 [    3     0     0     0     0     0     0     0     0     0     0     0     1     0   302     0     0     1     3     7     0     0     0     0     0     0     0]
 [    0     0     0     0     0     0     0     0     0     0     0     0     0     0     0    50     0     0     0     0     0     0     0     0     0     0     0]
 [    6     0     0     0     0     0     0     0     0     0     0     0     0     0     0     0   388     0     0     0     0     0     0     0     1     0     0]
 [    0     0     0     0     0     9     0     0     0     0     0     0    12     9     0     0     0   207     3    39     0     0     0     0     0     0     0]
 [    1     0     0     0     0     0     0     0     0     0     0     0     2     0    13     0     0     1    98    13     0     0     0     0     0     0     0]
 [    1     0     0     0     0    17     0     0     0     0     0     0    11     8     4     0     0    33     2   301     0     0     0     0     0     0     0]
 [    4     0     0     0     0     0     0     1     0     0     0     0     0     0     0     0     0     0     0     0   985     0     0     0     0     0     0]
 [    1     0     0     0     0     0     0     1     0     0     0     0     0     0     0     0     0     0     0     0     0   209     0     0     0     0     0]
 [    1     0     0     0     0     0     0     0     1     0     0     0     0     0     0     0     0     0     0     0     0     0  2127     0     0     0     0]
 [    1     0     0     0     0     0     0     0     0     1     0     0     0     0     0     0     0     0     0     0     0     0     0    36     0     0     0]
 [    2     0     0     0     0     0     0     0     0     0     0     0     0     0     0     0     0     0     0     0     0     0     0     0    31     0     0]
 [    0     0     0     0     0     0     0     1     0     0     0     0     0     0     0     0     0     0     0     0     0     0     0     0     0    59     0]
 [    1     0     0     0     0     0     0     0     0     0     0     0     0     0     0     0     0     0     0     0     0     0     0     0     0     0   179]]

Accuracy: 0.979410998175658

Precision: [0.9929 0.9683 1.0000 0.9348 1.0000 0.6774 1.0000 0.9955 1.0000 0.9971 1.0000 0.9967 0.4348 0.4324 0.8488 1.0000 1.0000 0.7358 0.6129 0.6437 0.9808 1.0000 0.9981 1.0000 1.0000 1.0000 1.0000]
Mean: 0.8981458359726578
Std: 0.17645865328903895

Recall: [0.9956 0.9839 0.9747 0.9348 1.0000 0.6000 1.0000 0.9955 1.0000 0.9954 0.9800 1.0000 0.4000 0.8889 0.9012 0.9444 0.9831 0.5342 0.6333 0.6292 0.9884 1.0000 1.0000 0.7143 0.8000 1.0000 1.0000]
Mean: 0.8843282140746318
Std: 0.17218118905989455

F1 score: [0.9943 0.9760 0.9872 0.9348 1.0000 0.6364 1.0000 0.9955 1.0000 0.9962 0.9899 0.9983 0.4167 0.5818 0.8743 0.9714 0.9915 0.6190 0.6230 0.6364 0.9846 1.0000 0.9990 0.8333 0.8889 1.0000 1.0000]
Mean: 0.8862340317447447
Std: 0.1699330821544675

Cohen Kappa score: 0.9711279614334646
Confusion matrix:
[[3634    2    0    2    0    0    0    1    0    4    0    1    0    0    1    0    0    0    0    0    4    0    1    0    0    0    0]
 [   1   61    0    0    0    0    0    0    0    0    0    0    0    0    0    0    0    0    0    0    0    0    0    0    0    0    0]
 [   2    0   77    0    0    0    0    0    0    0    0    0    0    0    0    0    0    0    0    0    0    0    0    0    0    0    0]
 [   3    0    0   43    0    0    0    0    0    0    0    0    0    0    0    0    0    0    0    0    0    0    0    0    0    0    0]
 [   0    0    0    0   58    0    0    0    0    0    0    0    0    0    0    0    0    0    0    0    0    0    0    0    0    0    0]
 [   0    0    0    0    0   21    0    0    0    0    0    0    0    0    4    0    0    0    5    5    0    0    0    0    0    0    0]
 [   0    0    0    0    0    0   31    0    0    0    0    0    0    0    0    0    0    0    0    0    0    0    0    0    0    0    0]
 [   0    0    0    0    0    0    0  219    0    0    0    0    0    0    0    0    0    0    0    0    1    0    0    0    0    0    0]
 [   0    0    0    0    0    0    0    0   43    0    0    0    0    0    0    0    0    0    0    0    0    0    0    0    0    0    0]
 [   8    0    0    0    0    0    0    0    0 1725    0    0    0    0    0    0    0    0    0    0    0    0    0    0    0    0    0]
 [   1    0    0    0    0    0    0    0    0    0   49    0    0    0    0    0    0    0    0    0    0    0    0    0    0    0    0]
 [   0    0    0    0    0    0    0    0    0    0    0  302    0    0    0    0    0    0    0    0    0    0    0    0    0    0    0]
 [   0    0    0    0    0    1    0    0    0    0    0    0   10    5    0    0    0    1    0    8    0    0    0    0    0    0    0]
 [   0    0    0    0    0    0    0    0    0    0    0    0    0   16    0    0    0    0    2    0    0    0    0    0    0    0    0]
 [   1    0    0    0    0    1    0    0    0    0    0    0    1    2   73    0    0    0    2    1    0    0    0    0    0    0    0]
 [   1    0    0    0    0    0    0    0    0    0    0    0    0    0    0   17    0    0    0    0    0    0    0    0    0    0    0]
 [   2    0    0    0    0    0    0    0    0    0    0    0    0    0    0    0  116    0    0    0    0    0    0    0    0    0    0]
 [   1    0    0    0    0    3    0    0    0    0    0    0    8    3    1    0    0   39    3   15    0    0    0    0    0    0    0]
 [   1    0    0    0    0    0    0    0    0    0    0    0    1    0    7    0    0    0   19    2    0    0    0    0    0    0    0]
 [   1    0    0    0    0    5    0    0    0    0    0    0    3   11    0    0    0   13    0   56    0    0    0    0    0    0    0]
 [   3    0    0    0    0    0    0    0    0    0    0    0    0    0    0    0    0    0    0    0  255    0    0    0    0    0    0]
 [   0    0    0    0    0    0    0    0    0    0    0    0    0    0    0    0    0    0    0    0    0   59    0    0    0    0    0]
 [   0    0    0    0    0    0    0    0    0    0    0    0    0    0    0    0    0    0    0    0    0    0  517    0    0    0    0]
 [   1    0    0    0    0    0    0    0    0    1    0    0    0    0    0    0    0    0    0    0    0    0    0    5    0    0    0]
 [   0    0    0    1    0    0    0    0    0    0    0    0    0    0    0    0    0    0    0    0    0    0    0    0    4    0    0]
 [   0    0    0    0    0    0    0    0    0    0    0    0    0    0    0    0    0    0    0    0    0    0    0    0    0   15    0]
 [   0    0    0    0    0    0    0    0    0    0    0    0    0    0    0    0    0    0    0    0    0    0    0    0    0    0   52]]

