Classifier: MLPClassifier
Params: {'activation': 'relu', 'alpha': 0.0001, 'batch_size': 'auto', 'beta_1': 0.9, 'beta_2': 0.999, 'early_stopping': False, 'epsilon': 1e-08, 'hidden_layer_sizes': (100,), 'learning_rate': 'constant', 'learning_rate_init': 0.001, 'max_iter': 200, 'momentum': 0.9, 'nesterovs_momentum': True, 'power_t': 0.5, 'random_state': None, 'shuffle': True, 'solver': 'adam', 'tol': 0.0001, 'validation_fraction': 0.1, 'verbose': False, 'warm_start': False}

Labels: None

Training accuracy: 0.9897706541568934
Training confusion matrix:
[[14684     0     0     5     0     0     0     0     0     1     0     0     0     0     1     0    12     0     0     0     0     0     1     0     0     0     0]
 [    0   236     0     0     0     0     0     0     0     0     0     0     0     0     0     0     0     0     0     0     0     0     0     0     0     0     0]
 [    2     0   279     0     0     0     0     0     0     0     0     0     0     0     0     0     0     0     0     0     0     0     0     0     0     0     0]
 [    6     0     0   192     0     0     0     0     0     0     0     0     0     0     0     0     0     0     0     0     0     0     0     0     0     0     0]
 [    0     0     0     0   194     0     0     0     0     0     0     0     0     0     0     0     0     0     0     0     0     0     0     0     0     0     0]
 [    0     0     0     0     0   142     0     0     0     0     0     0     1     2     1     0     0     3     2     6     0     0     0     0     0     0     0]
 [    0     0     0     0     0     0   120     0     0     0     0     0     0     0     0     0     0     0     0     0     0     0     0     0     0     0     0]
 [    0     0     0     0     0     0     0  1025     0     0     0     0     0     0     0     0     0     0     0     0     0     0     0     0     0     0     0]
 [    0     0     0     0     0     0     0     0   181     0     0     0     0     0     0     0     0     0     0     0     0     0     0     0     0     0     0]
 [    5     0     0     0     0     0     0     0     0  6814     0     0     0     0     0     0     0     0     0     0     0     0     0     0     0     0     0]
 [    0     0     0     0     0     0     0     0     0     0   219     0     0     0     0     0     0     0     0     0     0     0     0     0     0     0     0]
 [    0     0     0     0     0     0     0     0     0     0     0  1175     0     0     0     0     0     0     0     0     0     0     0     0     0     0     0]
 [    0     0     0     0     0    10     0     0     0     0     0     0    52     6     0     0     0    15     0    27     0     0     0     0     0     0     0]
 [    0     0     0     0     0    10     0     0     0     0     0     0     0    69     0     0     0     5     0     6     0     0     0     0     0     0     0]
 [    0     0     0     0     0     2     0     0     0     0     0     0     1     0   304     0     0     0     3     7     0     0     0     0     0     0     0]
 [    0     0     0     0     0     0     0     0     0     0     0     0     0     0     0    50     0     0     0     0     0     0     0     0     0     0     0]
 [    0     0     0     0     0     0     0     0     0     0     0     0     0     0     0     0   395     0     0     0     0     0     0     0     0     0     0]
 [    0     0     0     0     0    11     0     0     0     0     0     0     2     8     1     0     0   255     0     2     0     0     0     0     0     0     0]
 [    0     0     0     0     0     3     0     0     0     0     0     0     1     0    12     0     0     3   103     6     0     0     0     0     0     0     0]
 [    0     0     0     0     0    26     0     0     0     0     0     0     5     8     2     0     0    77     4   255     0     0     0     0     0     0     0]
 [    1     0     0     0     0     0     0     0     0     0     0     0     0     0     0     0     0     0     0     0   989     0     0     0     0     0     0]
 [    0     0     0     0     0     0     0     0     0     0     0     0     0     0     0     0     0     0     0     0     0   211     0     0     0     0     0]
 [    0     0     0     0     0     0     0     0     0     0     0     0     0     0     0     0     0     0     0     0     0     0  2129     0     0     0     0]
 [    0     0     0     0     0     0     0     0     0     0     0     0     0     0     0     0     0     0     0     0     0     0     0    38     0     0     0]
 [    2     0     0     0     0     0     0     0     0     0     0     0     0     0     0     0     0     0     0     0     0     0     0     0    31     0     0]
 [    0     0     0     0     0     0     0     0     0     0     0     0     0     0     0     0     0     0     0     0     0     0     0     0     0    60     0]
 [    0     0     0     0     0     0     0     0     0     0     0     0     0     0     0     0     0     0     0     0     0     0     0     0     0     0   180]]

Accuracy: 0.9821475110763618

Precision: [0.9959 0.9683 1.0000 0.9565 1.0000 0.6585 1.0000 0.9909 1.0000 0.9983 0.9804 0.9967 0.6667 0.4516 0.8765 1.0000 0.9833 0.6495 0.6207 0.7869 0.9885 0.9831 0.9981 0.8750 1.0000 1.0000 1.0000]
Mean: 0.9046394239066204
Std: 0.15275597058619053

Recall: [0.9948 0.9839 0.9747 0.9565 1.0000 0.7714 1.0000 0.9909 1.0000 0.9977 1.0000 1.0000 0.3200 0.7778 0.8765 0.9444 1.0000 0.8630 0.6000 0.5393 0.9961 0.9831 1.0000 1.0000 0.6000 1.0000 1.0000]
Mean: 0.8951918573989871
Std: 0.17637944893567625

F1 score: [0.9953 0.9760 0.9872 0.9565 1.0000 0.7105 1.0000 0.9909 1.0000 0.9980 0.9901 0.9983 0.4324 0.5714 0.8765 0.9714 0.9916 0.7412 0.6102 0.6400 0.9923 0.9831 0.9990 0.9333 0.7500 1.0000 1.0000]
Mean: 0.8924212531865668
Std: 0.16238312729753734

Cohen Kappa score: 0.9749931604139459
Confusion matrix:
[[3631    2    0    2    0    0    0    2    0    3    1    1    0    0    1    0    2    0    0    0    2    1    1    1    0    0    0]
 [   1   61    0    0    0    0    0    0    0    0    0    0    0    0    0    0    0    0    0    0    0    0    0    0    0    0    0]
 [   2    0   77    0    0    0    0    0    0    0    0    0    0    0    0    0    0    0    0    0    0    0    0    0    0    0    0]
 [   2    0    0   44    0    0    0    0    0    0    0    0    0    0    0    0    0    0    0    0    0    0    0    0    0    0    0]
 [   0    0    0    0   58    0    0    0    0    0    0    0    0    0    0    0    0    0    0    0    0    0    0    0    0    0    0]
 [   0    0    0    0    0   27    0    0    0    0    0    0    0    0    1    0    0    0    5    2    0    0    0    0    0    0    0]
 [   0    0    0    0    0    0   31    0    0    0    0    0    0    0    0    0    0    0    0    0    0    0    0    0    0    0    0]
 [   1    0    0    0    0    0    0  218    0    0    0    0    0    0    0    0    0    0    0    0    1    0    0    0    0    0    0]
 [   0    0    0    0    0    0    0    0   43    0    0    0    0    0    0    0    0    0    0    0    0    0    0    0    0    0    0]
 [   4    0    0    0    0    0    0    0    0 1729    0    0    0    0    0    0    0    0    0    0    0    0    0    0    0    0    0]
 [   0    0    0    0    0    0    0    0    0    0   50    0    0    0    0    0    0    0    0    0    0    0    0    0    0    0    0]
 [   0    0    0    0    0    0    0    0    0    0    0  302    0    0    0    0    0    0    0    0    0    0    0    0    0    0    0]
 [   0    0    0    0    0    1    0    0    0    0    0    0    8    5    0    0    0    6    0    5    0    0    0    0    0    0    0]
 [   0    0    0    0    0    0    0    0    0    0    0    0    1   14    0    0    0    1    1    1    0    0    0    0    0    0    0]
 [   0    0    0    0    0    3    0    0    0    0    0    0    1    2   71    0    0    0    3    1    0    0    0    0    0    0    0]
 [   1    0    0    0    0    0    0    0    0    0    0    0    0    0    0   17    0    0    0    0    0    0    0    0    0    0    0]
 [   0    0    0    0    0    0    0    0    0    0    0    0    0    0    0    0  118    0    0    0    0    0    0    0    0    0    0]
 [   0    0    0    0    0    3    0    0    0    0    0    0    0    3    1    0    0   63    1    2    0    0    0    0    0    0    0]
 [   0    0    0    0    0    0    0    0    0    0    0    0    1    1    7    0    0    1   18    2    0    0    0    0    0    0    0]
 [   0    0    0    0    0    7    0    0    0    0    0    0    1    6    0    0    0   26    1   48    0    0    0    0    0    0    0]
 [   1    0    0    0    0    0    0    0    0    0    0    0    0    0    0    0    0    0    0    0  257    0    0    0    0    0    0]
 [   1    0    0    0    0    0    0    0    0    0    0    0    0    0    0    0    0    0    0    0    0   58    0    0    0    0    0]
 [   0    0    0    0    0    0    0    0    0    0    0    0    0    0    0    0    0    0    0    0    0    0  517    0    0    0    0]
 [   0    0    0    0    0    0    0    0    0    0    0    0    0    0    0    0    0    0    0    0    0    0    0    7    0    0    0]
 [   2    0    0    0    0    0    0    0    0    0    0    0    0    0    0    0    0    0    0    0    0    0    0    0    3    0    0]
 [   0    0    0    0    0    0    0    0    0    0    0    0    0    0    0    0    0    0    0    0    0    0    0    0    0   15    0]
 [   0    0    0    0    0    0    0    0    0    0    0    0    0    0    0    0    0    0    0    0    0    0    0    0    0    0   52]]

