Classifier: MultinomialNB
Params: {'alpha': 1.0, 'class_prior': None, 'fit_prior': True}

Labels: None

Training accuracy: 0.9162105811832161
Training confusion matrix:
[[13461   107    13   104     7     0     0   191     2    24   259    10     0     0   119     0    35    68     0    92    21    15    11    12    73     0    80]
 [    6   230     0     0     0     0     0     0     0     0     0     0     0     0     0     0     0     0     0     0     0     0     0     0     0     0     0]
 [    3     0   249     0     6     0     2    18     0     0     0     0     0     0     0     0     1     0     0     0     2     0     0     0     0     0     0]
 [   35     0     0   149     0     0     0     0     0     0     0     0     0     0     0     0    14     0     0     0     0     0     0     0     0     0     0]
 [    0     0     0     0   191     0     1     0     0     0     0     0     0     0     0     0     0     0     0     0     0     0     2     0     0     0     0]
 [    1     0     0     0     0     6     0     0     0     0     0     0     0     0     2     0     0     0     0   148     0     0     0     0     0     0     0]
 [    0     0     0     0     0     0   116     0     0     0     0     0     0     0     0     0     3     0     0     0     0     0     1     0     0     0     0]
 [    2     0     2     0    13     0     3   988     0     0     0     0     0     0     0     0     1     0     0     0    10     1     0     0     0     0     5]
 [    1     0     0     0     0     0     4     0   174     0     0     0     0     0     0     0     0     0     0     0     0     0     2     0     0     0     0]
 [  130     0     0     6     0     0     0     1     0  6648     3     2     0     0     6     0     5     0     0     0     0     0    18     0     0     0     0]
 [   15     0     0     0     0     0     0     0     0     0   204     0     0     0     0     0     0     0     0     0     0     0     0     0     0     0     0]
 [   21     0     0     0     0     0     0     0     0     1     0  1153     0     0     0     0     0     0     0     0     0     0     0     0     0     0     0]
 [    0     0     0     0     0     0     0     0     0     0     0     0     0     0     1     0     0     0     0   109     0     0     0     0     0     0     0]
 [    0     0     0     0     0     0     0     0     0     0     0     0     1     2     1     0     0     0     0    86     0     0     0     0     0     0     0]
 [    3     0     0     0     0     0     0     1     0     0     0     0     0     0   233     0     0     9     0    68     0     1     2     0     0     0     0]
 [    0     0     1     0     3     0     2     0     1     0     0     0     0     0     0    33     1     0     0     0     0     0     9     0     0     0     0]
 [   34     0     0     9     2     0     1     0     0     0     0     0     0     0     0     0   348     0     0     0     0     0     0     0     1     0     0]
 [    7     0     0     0     0     0     0     0     0     0     0     0     0     0     1     0     0    69     0   202     0     0     0     0     0     0     0]
 [    0     0     0     0     0     0     0     0     0     0     0     0     0     0    42     0     0    14     9    63     0     0     0     0     0     0     0]
 [    1     0     0     0     0     0     0     0     0     0     3     0     0     0     3     0     0    15     0   350     0     0     5     0     0     0     0]
 [    3     0     0     0     0     0     0     3     0     0     0     0     0     0     0     0     0     0     0     0   982     0     0     0     0     0     2]
 [    1     0     0     0     0     0     0     9     0     0     0     0     0     0     0     0     0     0     0     0    29   170     2     0     0     0     0]
 [    3     0     1     0     8     0     6     1     1     0     0     0     0     0     0     0     1     0     0     0     0     0  2108     0     0     0     0]
 [    5    18     0     0     0     0     0     0     0     0     0     1     0     0     0     0     0     0     0     0     0     0     0    14     0     0     0]
 [    3     0     0     0     0     0     0     0     0     0     0     0     0     0     0     0     0     0     0     0     0     0     0     0    30     0     0]
 [    0     0     1     0     5     0     0     8     0     0     0     0     0     0     0     0     2     0     0     0     3     0     4     0     0    37     0]
 [    0     0     3     0     2     0     1     3     0     0     0     0     0     0     0     0     0     0     0     0     1     0     0     0     0     0   170]]

Accuracy: 0.9168621318738598

Precision: [0.9804 0.6941 0.9733 0.5397 0.7703 1.0000 0.8611 0.7969 0.9773 0.9924 0.4848 0.9933 0.0000 1.0000 0.4649 1.0000 0.8718 0.1622 1.0000 0.2971 0.9170 1.0000 0.9828 0.6000 0.1739 1.0000 0.7353]
Mean: 0.7506892397433653
Std: 0.29976033693452464

Recall: [0.9170 0.9516 0.9241 0.7391 0.9828 0.0571 1.0000 0.9455 1.0000 0.9786 0.9600 0.9868 0.0000 0.0556 0.6543 0.6667 0.8644 0.0822 0.0667 0.9213 0.9845 0.8475 0.9942 0.4286 0.8000 0.4667 0.9615]
Mean: 0.7124676057195389
Std: 0.3486454242873516

F1 score: [0.9476 0.8027 0.9481 0.6239 0.8636 0.1081 0.9254 0.8649 0.9885 0.9855 0.6443 0.9900 0.0000 0.1053 0.5436 0.8000 0.8681 0.1091 0.1250 0.4493 0.9495 0.9174 0.9885 0.5000 0.2857 0.6364 0.8333]
Mean: 0.6593969991988012
Std: 0.32642885035050817

Cohen Kappa score: 0.8858574804047079
Confusion matrix:
[[3347   23    2   28    2    0    0   48    1   12   48    1    0    0   42    0   11   24    0   18    7    0    2    2   19    0   13]
 [   3   59    0    0    0    0    0    0    0    0    0    0    0    0    0    0    0    0    0    0    0    0    0    0    0    0    0]
 [   0    0   73    0    3    0    0    2    0    0    0    0    0    0    0    0    0    0    0    0    1    0    0    0    0    0    0]
 [  10    0    0   34    0    0    0    0    0    0    0    0    0    0    0    0    2    0    0    0    0    0    0    0    0    0    0]
 [   0    0    0    0   57    0    0    0    0    0    0    0    0    0    0    0    0    0    0    0    1    0    0    0    0    0    0]
 [   0    0    0    0    0    2    0    0    0    0    0    0    0    0    0    0    0    0    0   33    0    0    0    0    0    0    0]
 [   0    0    0    0    0    0   31    0    0    0    0    0    0    0    0    0    0    0    0    0    0    0    0    0    0    0    0]
 [   0    0    0    0    6    0    2  208    0    0    0    0    0    0    0    0    1    0    0    0    2    0    0    0    0    0    1]
 [   0    0    0    0    0    0    0    0   43    0    0    0    0    0    0    0    0    0    0    0    0    0    0    0    0    0    0]
 [  30    0    0    0    0    0    0    0    0 1696    1    1    0    0    3    0    1    0    0    0    0    0    1    0    0    0    0]
 [   2    0    0    0    0    0    0    0    0    0   48    0    0    0    0    0    0    0    0    0    0    0    0    0    0    0    0]
 [   3    0    0    0    0    0    0    0    0    1    0  298    0    0    0    0    0    0    0    0    0    0    0    0    0    0    0]
 [   0    0    0    0    0    0    0    0    0    0    0    0    0    0    0    0    0    0    0   25    0    0    0    0    0    0    0]
 [   0    0    0    0    0    0    0    0    0    0    0    0    0    1    0    0    0    0    0   17    0    0    0    0    0    0    0]
 [   0    0    0    0    0    0    0    0    0    0    0    0    0    0   53    0    0    5    0   22    0    0    1    0    0    0    0]
 [   0    0    0    0    1    0    1    0    0    0    0    0    0    0    0   12    0    0    0    0    0    0    3    0    0    0    1]
 [  12    0    0    1    2    0    1    0    0    0    0    0    0    0    0    0  102    0    0    0    0    0    0    0    0    0    0]
 [   0    0    0    0    0    0    0    0    0    0    0    0    0    0    1    0    0    6    0   66    0    0    0    0    0    0    0]
 [   1    0    0    0    0    0    0    0    0    0    0    0    0    0   13    0    0    1    2   13    0    0    0    0    0    0    0]
 [   1    0    0    0    0    0    0    0    0    0    2    0    0    0    2    0    0    1    0   82    1    0    0    0    0    0    0]
 [   2    0    0    0    0    0    0    0    0    0    0    0    0    0    0    0    0    0    0    0  254    0    0    0    0    0    2]
 [   0    0    0    0    0    0    0    1    0    0    0    0    0    0    0    0    0    0    0    0    8   50    0    0    0    0    0]
 [   1    0    0    0    1    0    0    0    0    0    0    0    0    0    0    0    0    0    0    0    0    0  514    0    0    0    1]
 [   1    3    0    0    0    0    0    0    0    0    0    0    0    0    0    0    0    0    0    0    0    0    0    3    0    0    0]
 [   1    0    0    0    0    0    0    0    0    0    0    0    0    0    0    0    0    0    0    0    0    0    0    0    4    0    0]
 [   0    0    0    0    2    0    0    2    0    0    0    0    0    0    0    0    0    0    0    0    2    0    2    0    0    7    0]
 [   0    0    0    0    0    0    1    0    0    0    0    0    0    0    0    0    0    0    0    0    1    0    0    0    0    0   50]]

