Classifier: RandomForestClassifier
Params: {'bootstrap': True, 'class_weight': None, 'criterion': 'gini', 'max_depth': None, 'max_features': 'auto', 'max_leaf_nodes': None, 'min_impurity_decrease': 0.0, 'min_impurity_split': None, 'min_samples_leaf': 1, 'min_samples_split': 2, 'min_weight_fraction_leaf': 0.0, 'n_estimators': 100, 'n_jobs': 1, 'oob_score': False, 'random_state': None, 'verbose': 0, 'warm_start': False}

Labels: None

Training accuracy: 0.994950482147511
Training confusion matrix:
[[14697     0     0     4     0     0     0     0     0     0     0     0     0     0     0     0     3     0     0     0     0     0     0     0     0     0     0]
 [    0   236     0     0     0     0     0     0     0     0     0     0     0     0     0     0     0     0     0     0     0     0     0     0     0     0     0]
 [    1     0   280     0     0     0     0     0     0     0     0     0     0     0     0     0     0     0     0     0     0     0     0     0     0     0     0]
 [    6     0     0   192     0     0     0     0     0     0     0     0     0     0     0     0     0     0     0     0     0     0     0     0     0     0     0]
 [    0     0     0     0   194     0     0     0     0     0     0     0     0     0     0     0     0     0     0     0     0     0     0     0     0     0     0]
 [    0     0     0     0     0   143     0     0     0     0     0     0     0     2     2     0     0     1     1     8     0     0     0     0     0     0     0]
 [    0     0     0     0     0     0   120     0     0     0     0     0     0     0     0     0     0     0     0     0     0     0     0     0     0     0     0]
 [    0     0     0     0     0     0     0  1025     0     0     0     0     0     0     0     0     0     0     0     0     0     0     0     0     0     0     0]
 [    0     0     0     0     0     0     0     0   181     0     0     0     0     0     0     0     0     0     0     0     0     0     0     0     0     0     0]
 [    5     0     0     0     0     0     0     0     0  6814     0     0     0     0     0     0     0     0     0     0     0     0     0     0     0     0     0]
 [    0     0     0     0     0     0     0     0     0     0   219     0     0     0     0     0     0     0     0     0     0     0     0     0     0     0     0]
 [    0     0     0     0     0     0     0     0     0     0     0  1175     0     0     0     0     0     0     0     0     0     0     0     0     0     0     0]
 [    0     0     0     0     0     1     0     0     0     0     0     0    96     0     0     0     0     2     0    11     0     0     0     0     0     0     0]
 [    0     0     0     0     0     1     0     0     0     0     0     0     0    88     0     0     0     0     0     1     0     0     0     0     0     0     0]
 [    0     0     0     0     0     0     0     0     0     0     0     0     0     0   308     0     0     1     6     2     0     0     0     0     0     0     0]
 [    0     0     0     0     0     0     0     0     0     0     0     0     0     0     0    50     0     0     0     0     0     0     0     0     0     0     0]
 [    3     0     0     0     0     0     0     0     0     0     0     0     0     0     0     0   392     0     0     0     0     0     0     0     0     0     0]
 [    0     0     0     0     0     1     0     0     0     0     0     0     4     5     0     0     0   250     0    19     0     0     0     0     0     0     0]
 [    0     0     0     0     0     0     0     0     0     0     0     0     0     0     4     0     0     2   116     6     0     0     0     0     0     0     0]
 [    0     0     0     0     0     6     0     0     0     0     0     0    12     4     3     0     0    27     0   325     0     0     0     0     0     0     0]
 [    1     0     0     0     0     0     0     0     0     0     0     0     0     0     0     0     0     0     0     0   989     0     0     0     0     0     0]
 [    0     0     0     0     0     0     0     0     0     0     0     0     0     0     0     0     0     0     0     0     0   211     0     0     0     0     0]
 [    0     0     0     0     0     0     0     0     0     0     0     0     0     0     0     0     0     0     0     0     0     0  2129     0     0     0     0]
 [    0     0     0     0     0     0     0     0     0     0     0     0     0     0     0     0     0     0     0     0     0     0     0    38     0     0     0]
 [    0     0     0     0     0     0     0     0     0     0     0     0     0     0     0     0     0     0     0     0     0     0     0     0    33     0     0]
 [    0     0     0     0     0     0     0     0     0     0     0     0     0     0     0     0     0     0     0     0     0     0     0     0     0    60     0]
 [    0     0     0     0     0     0     0     0     0     0     0     0     0     0     0     0     0     0     0     0     0     0     0     0     0     0   180]]

Accuracy: 0.9736773520979932

Precision: [0.9862 0.9649 0.9605 0.9024 0.9492 0.6400 0.9688 0.9775 1.0000 0.9983 1.0000 1.0000 0.4737 0.4242 0.8333 1.0000 1.0000 0.6885 0.5862 0.6000 0.9769 1.0000 0.9981 0.8000 1.0000 1.0000 1.0000]
Mean: 0.8788394043810158
Std: 0.1779383152046604

Recall: [0.9953 0.8871 0.9241 0.8043 0.9655 0.4571 1.0000 0.9864 1.0000 0.9965 0.9600 1.0000 0.3600 0.7778 0.8025 0.8889 0.9492 0.5753 0.5667 0.6742 0.9845 0.9661 1.0000 0.5714 0.8000 0.9333 0.9423]
Mean: 0.8432785713411048
Std: 0.18372561702417348

F1 score: [0.9907 0.9244 0.9419 0.8506 0.9573 0.5333 0.9841 0.9819 1.0000 0.9974 0.9796 1.0000 0.4091 0.5490 0.8176 0.9412 0.9739 0.6269 0.5763 0.6349 0.9807 0.9828 0.9990 0.6667 0.8889 0.9655 0.9703]
Mean: 0.8564426500980408
Std: 0.17887486732590763

Cohen Kappa score: 0.9630110466626216
Confusion matrix:
[[3633    2    1    3    0    0    0    2    0    3    0    0    0    0    2    0    0    0    1    1    0    0    1    1    0    0    0]
 [   7   55    0    0    0    0    0    0    0    0    0    0    0    0    0    0    0    0    0    0    0    0    0    0    0    0    0]
 [   2    0   73    0    0    0    0    2    0    0    0    0    0    0    0    0    0    0    0    0    2    0    0    0    0    0    0]
 [   9    0    0   37    0    0    0    0    0    0    0    0    0    0    0    0    0    0    0    0    0    0    0    0    0    0    0]
 [   1    0    0    0   56    0    0    0    0    0    0    0    0    0    0    0    0    0    0    0    1    0    0    0    0    0    0]
 [   0    0    0    0    0   16    0    0    0    0    0    0    0    3    3    0    0    0    5    8    0    0    0    0    0    0    0]
 [   0    0    0    0    0    0   31    0    0    0    0    0    0    0    0    0    0    0    0    0    0    0    0    0    0    0    0]
 [   0    0    2    0    0    0    0  217    0    0    0    0    0    0    0    0    0    0    0    0    1    0    0    0    0    0    0]
 [   0    0    0    0    0    0    0    0   43    0    0    0    0    0    0    0    0    0    0    0    0    0    0    0    0    0    0]
 [   6    0    0    0    0    0    0    0    0 1727    0    0    0    0    0    0    0    0    0    0    0    0    0    0    0    0    0]
 [   2    0    0    0    0    0    0    0    0    0   48    0    0    0    0    0    0    0    0    0    0    0    0    0    0    0    0]
 [   0    0    0    0    0    0    0    0    0    0    0  302    0    0    0    0    0    0    0    0    0    0    0    0    0    0    0]
 [   0    0    0    0    0    0    0    0    0    0    0    0    9    2    0    0    0    6    0    8    0    0    0    0    0    0    0]
 [   0    0    0    0    0    0    0    0    0    0    0    0    2   14    0    0    0    0    1    1    0    0    0    0    0    0    0]
 [   5    0    0    0    0    2    0    0    0    0    0    0    1    3   65    0    0    0    3    2    0    0    0    0    0    0    0]
 [   1    0    0    0    1    0    0    0    0    0    0    0    0    0    0   16    0    0    0    0    0    0    0    0    0    0    0]
 [   4    0    0    0    1    0    0    1    0    0    0    0    0    0    0    0  112    0    0    0    0    0    0    0    0    0    0]
 [   1    0    0    0    0    3    0    0    0    0    0    0    4    3    1    0    0   42    2   17    0    0    0    0    0    0    0]
 [   3    0    0    0    0    0    0    0    0    0    0    0    1    1    5    0    0    0   17    3    0    0    0    0    0    0    0]
 [   0    0    0    0    0    4    0    0    0    0    0    0    2    7    2    0    0   13    0   60    1    0    0    0    0    0    0]
 [   4    0    0    0    0    0    0    0    0    0    0    0    0    0    0    0    0    0    0    0  254    0    0    0    0    0    0]
 [   2    0    0    0    0    0    0    0    0    0    0    0    0    0    0    0    0    0    0    0    0   57    0    0    0    0    0]
 [   0    0    0    0    0    0    0    0    0    0    0    0    0    0    0    0    0    0    0    0    0    0  517    0    0    0    0]
 [   3    0    0    0    0    0    0    0    0    0    0    0    0    0    0    0    0    0    0    0    0    0    0    4    0    0    0]
 [   0    0    0    1    0    0    0    0    0    0    0    0    0    0    0    0    0    0    0    0    0    0    0    0    4    0    0]
 [   0    0    0    0    1    0    0    0    0    0    0    0    0    0    0    0    0    0    0    0    0    0    0    0    0   14    0]
 [   1    0    0    0    0    0    1    0    0    0    0    0    0    0    0    0    0    0    0    0    1    0    0    0    0    0   49]]

