Classifier: LogisticRegression
Params: {'C': 1.0, 'class_weight': None, 'dual': False, 'fit_intercept': True, 'intercept_scaling': 1, 'max_iter': 100, 'multi_class': 'ovr', 'n_jobs': 1, 'penalty': 'l2', 'random_state': None, 'solver': 'liblinear', 'tol': 0.0001, 'verbose': 0, 'warm_start': False}

Labels: None

Training accuracy: 0.9895426114151681
Training confusion matrix:
[[14701     0     3     5     0     0     0     0     0     0     0     0     0     0     1     0     5     0     0     0     0     0     0     0     2     0     0]
 [    0   237     0     0     0     0     0     0     0     0     0     0     0     0     0     0     0     0     0     0     0     0     0     0     0     0     0]
 [    1     0   264     0     0     0     0     0     0     0     0     0     0     0     0     0     0     0     0     0     0     0     0     0     0     0     0]
 [    1     0     0   202     0     0     0     0     0     0     0     0     0     0     0     0     0     0     0     0     0     0     0     0     0     0     0]
 [    0     0     0     0   208     0     0     0     0     0     0     0     0     0     0     0     0     0     0     0     0     0     0     0     0     0     0]
 [    0     0     0     0     0   106     0     0     0     0     0     0     6     1     3     0     0     2     4    29     0     0     0     0     0     0     0]
 [    0     0     0     0     0     0   119     0     0     0     0     0     0     0     0     0     0     0     0     0     0     0     0     0     0     0     0]
 [    0     0     0     0     0     0     0   988     0     0     0     0     0     0     0     0     0     0     0     0     2     0     0     0     0     0     0]
 [    0     0     0     0     0     0     0     0   183     0     0     0     0     0     0     0     0     0     0     0     0     0     0     0     0     0     0]
 [    4     0     0     0     0     0     0     0     0  6799     0     0     0     0     0     0     0     0     0     0     0     0     0     0     0     0     0]
 [    0     0     0     0     0     0     0     0     0     0   216     0     0     0     0     0     0     0     0     0     0     0     0     0     0     0     0]
 [    0     0     0     0     0     0     0     0     0     0     0  1183     0     0     0     0     0     0     0     0     0     0     0     0     0     0     0]
 [    0     0     0     0     0     2     0     0     0     0     0     0    90     8     0     0     0     5     0     4     0     0     0     0     0     0     0]
 [    0     0     0     0     0     4     0     0     0     0     0     0     2    69     1     0     0     1     0     9     0     0     0     0     0     0     0]
 [    0     0     0     0     0     3     0     0     0     0     0     0     1     2   304     0     0     1     2     5     0     0     0     0     0     0     0]
 [    0     0     0     0     0     0     0     0     0     0     0     0     0     0     0    58     0     0     0     0     0     0     0     0     0     0     0]
 [    3     0     0     0     0     0     0     0     0     0     0     0     0     0     0     0   414     0     0     0     0     0     0     0     0     0     0]
 [    0     0     0     0     0     9     0     0     0     0     0     0    11     7     1     0     0   196     0    50     0     0     0     0     0     0     0]
 [    0     0     0     0     0     3     0     0     0     0     0     0     2     0    14     0     0     2    99     9     0     0     0     0     0     0     0]
 [    1     0     0     0     0    10     0     0     0     0     0     0    32     7     2     0     0    29     5   286     0     0     0     0     0     0     0]
 [    2     0     0     0     0     0     0     0     0     0     0     0     0     0     0     0     0     0     0     0  1002     0     0     0     0     0     0]
 [    0     0     0     0     0     0     0     0     0     0     0     0     0     0     0     0     0     0     0     0     0   210     0     0     0     0     0]
 [    0     0     0     0     0     0     0     0     1     0     0     0     0     0     0     0     0     0     0     0     0     0  2125     0     0     0     0]
 [    1     0     0     0     0     0     0     0     0     0     0     0     0     0     0     0     0     0     0     0     0     0     0    33     0     0     0]
 [    0     0     0     0     0     0     0     0     0     0     0     0     0     0     0     0     0     0     0     0     0     0     0     0    35     0     0]
 [    0     0     0     0     0     0     0     1     0     0     0     0     0     0     0     0     0     0     0     0     0     0     0     0     0    64     0]
 [    0     0     0     0     0     0     0     0     0     0     0     0     0     0     0     0     0     0     0     0     0     0     0     0     0     0   184]]

Accuracy: 0.9813656502475893

Precision: [0.9932 0.9672 0.9896 0.9048 1.0000 0.6053 1.0000 0.9921 1.0000 0.9994 1.0000 1.0000 0.4545 0.7000 0.8837 1.0000 0.9896 0.8333 0.8333 0.6535 0.9918 1.0000 1.0000 0.8889 0.7500 1.0000 1.0000]
Mean: 0.9048212004107314
Std: 0.14571562367409324

Recall: [0.9973 0.9672 1.0000 0.9268 1.0000 0.5610 1.0000 0.9804 1.0000 0.9949 1.0000 1.0000 0.7692 0.6364 0.9500 0.9000 0.9896 0.6410 0.5172 0.7021 0.9959 0.9667 1.0000 0.7273 1.0000 1.0000 1.0000]
Mean: 0.8971454920501719
Std: 0.1537439361134755

F1 score: [0.9952 0.9672 0.9948 0.9157 1.0000 0.5823 1.0000 0.9862 1.0000 0.9971 1.0000 1.0000 0.5714 0.6667 0.9157 0.9474 0.9896 0.7246 0.6383 0.6769 0.9939 0.9831 1.0000 0.8000 0.8571 1.0000 1.0000]
Mean: 0.8964100689392113
Std: 0.14526289249814195

Cohen Kappa score: 0.9738843149464297
Confusion matrix:
[[3627    2    0    4    0    0    0    1    0    0    0    0    0    0    1    0    1    0    0    0    0    0    0    1    0    0    0]
 [   2   59    0    0    0    0    0    0    0    0    0    0    0    0    0    0    0    0    0    0    0    0    0    0    0    0    0]
 [   0    0   95    0    0    0    0    0    0    0    0    0    0    0    0    0    0    0    0    0    0    0    0    0    0    0    0]
 [   3    0    0   38    0    0    0    0    0    0    0    0    0    0    0    0    0    0    0    0    0    0    0    0    0    0    0]
 [   0    0    0    0   44    0    0    0    0    0    0    0    0    0    0    0    0    0    0    0    0    0    0    0    0    0    0]
 [   1    0    0    0    0   23    0    0    0    0    0    0    4    2    2    0    0    1    0    8    0    0    0    0    0    0    0]
 [   0    0    0    0    0    0   32    0    0    0    0    0    0    0    0    0    0    0    0    0    0    0    0    0    0    0    0]
 [   3    0    0    0    0    0    0  250    0    0    0    0    0    0    0    0    0    0    0    0    2    0    0    0    0    0    0]
 [   0    0    0    0    0    0    0    0   41    0    0    0    0    0    0    0    0    0    0    0    0    0    0    0    0    0    0]
 [   9    0    0    0    0    0    0    0    0 1740    0    0    0    0    0    0    0    0    0    0    0    0    0    0    0    0    0]
 [   0    0    0    0    0    0    0    0    0    0   53    0    0    0    0    0    0    0    0    0    0    0    0    0    0    0    0]
 [   0    0    0    0    0    0    0    0    0    0    0  294    0    0    0    0    0    0    0    0    0    0    0    0    0    0    0]
 [   1    0    0    0    0    5    0    0    0    0    0    0   20    0    0    0    0    0    0    0    0    0    0    0    0    0    0]
 [   0    0    0    0    0    1    0    0    0    0    0    0    0   14    0    0    0    1    1    5    0    0    0    0    0    0    0]
 [   0    0    0    0    0    0    0    0    0    0    0    0    1    0   76    0    0    0    0    3    0    0    0    0    0    0    0]
 [   1    0    0    0    0    0    0    0    0    0    0    0    0    0    0    9    0    0    0    0    0    0    0    0    0    0    0]
 [   0    0    0    0    0    0    0    0    0    0    0    0    0    0    0    0   95    0    0    0    0    0    0    0    1    0    0]
 [   1    0    0    0    0    3    0    0    0    0    0    0    3    2    0    0    0   50    1   18    0    0    0    0    0    0    0]
 [   1    0    0    0    0    1    0    0    0    0    0    0    1    1    7    0    0    2   15    1    0    0    0    0    0    0    0]
 [   0    0    0    0    0    5    0    0    0    0    0    0   15    1    0    0    0    6    1   66    0    0    0    0    0    0    0]
 [   0    0    0    0    0    0    0    1    0    0    0    0    0    0    0    0    0    0    0    0  243    0    0    0    0    0    0]
 [   1    0    1    0    0    0    0    0    0    0    0    0    0    0    0    0    0    0    0    0    0   58    0    0    0    0    0]
 [   0    0    0    0    0    0    0    0    0    0    0    0    0    0    0    0    0    0    0    0    0    0  520    0    0    0    0]
 [   2    0    0    0    0    0    0    0    0    1    0    0    0    0    0    0    0    0    0    0    0    0    0    8    0    0    0]
 [   0    0    0    0    0    0    0    0    0    0    0    0    0    0    0    0    0    0    0    0    0    0    0    0    3    0    0]
 [   0    0    0    0    0    0    0    0    0    0    0    0    0    0    0    0    0    0    0    0    0    0    0    0    0   10    0]
 [   0    0    0    0    0    0    0    0    0    0    0    0    0    0    0    0    0    0    0    0    0    0    0    0    0    0   48]]

