Classifier: MultinomialNB
Params: {'alpha': 1.0, 'class_prior': None, 'fit_prior': True}

Labels: None

Training accuracy: 0.9204782382069325
Training confusion matrix:
[[13628   103    18   100     8     0     1   246     1    32   182     9     0     0   106     0    16    69     3   120    30     4    14     7     3     0    17]
 [    4   233     0     0     0     0     0     0     0     0     0     0     0     0     0     0     0     0     0     0     0     0     0     0     0     0     0]
 [    3     0   227     0     8     0     5    13     0     0     0     0     0     0     0     0     1     0     0     0     8     0     0     0     0     0     0]
 [   38     0     0   148     0     0     0     0     0     0     0     0     0     0     0     0    17     0     0     0     0     0     0     0     0     0     0]
 [    0     0     0     0   202     0     1     0     0     0     0     0     0     0     0     0     0     0     0     0     1     0     4     0     0     0     0]
 [    0     0     0     0     0     8     0     0     0     0     0     0     0     0     2     0     0     0     0   141     0     0     0     0     0     0     0]
 [    0     0     0     0     2     0   111     1     0     0     0     0     0     0     0     0     1     0     0     0     0     0     4     0     0     0     0]
 [    1     0     1     0     7     0     1   970     0     0     0     0     0     0     0     0     0     0     0     0    10     0     0     0     0     0     0]
 [    0     0     0     0     0     0     1     2   175     0     0     0     0     0     0     0     0     0     0     0     0     0     5     0     0     0     0]
 [   81     0     0     4     0     0     0     0     0  6683     2     3     0     0     1     0     4     0     0     0     1     0    24     0     0     0     0]
 [    9     0     0     0     0     0     0     0     0     0   207     0     0     0     0     0     0     0     0     0     0     0     0     0     0     0     0]
 [   14     0     0     0     0     0     0     0     0     4     0  1165     0     0     0     0     0     0     0     0     0     0     0     0     0     0     0]
 [    0     0     0     0     0     0     0     0     0     0     0     0     0     0     0     0     0     0     0   109     0     0     0     0     0     0     0]
 [    0     0     0     0     0     0     0     0     0     0     0     0     0     0     1     0     0     0     0    85     0     0     0     0     0     0     0]
 [    1     0     0     0     0     0     0     1     0     0     0     0     0     0   178     0     0     9     0   124     0     0     5     0     0     0     0]
 [    0     0     1     0     3     0     3     0     0     0     0     0     0     0     0    36     0     0     0     0     0     0    15     0     0     0     0]
 [   43     0     0     1     4     0     2     0     0     0     0     0     0     0     0     0   367     0     0     0     0     0     0     0     0     0     0]
 [    7     0     0     0     0     0     0     0     0     0     0     0     0     0     1     0     0    55     0   211     0     0     0     0     0     0     0]
 [    1     0     0     0     0     0     0     0     0     0     0     0     0     0    11     0     0     8     7   102     0     0     0     0     0     0     0]
 [    1     0     0     0     0     0     0     1     0     0     0     0     0     0     1     0     0     8     0   355     0     0     6     0     0     0     0]
 [    4     0     0     0     0     0     0     2     0     0     0     0     0     0     0     0     0     0     0     0   996     0     1     0     0     0     1]
 [    0     0     0     0     0     0     0    14     0     0     0     0     0     0     0     0     0     0     0     0    32   160     4     0     0     0     0]
 [    4     0     1     0     6     0     6     1     1     0     0     0     0     0     0     0     0     0     0     0     0     0  2107     0     0     0     0]
 [    6    17     0     0     0     0     0     0     0     0     0     0     0     0     0     0     0     0     0     0     0     0     0    11     0     0     0]
 [    3     0     0     0     0     0     0     0     0     0     0     0     0     0     0     0     0     0     0     0     0     0     0     0    32     0     0]
 [    0     0     3     0     5     0     0    15     0     0     0     0     0     0     0     0     1     0     0     0     1     0     9     0     0    31     0]
 [    1     0     0     0     4     0     1     6     0     0     0     0     0     0     0     0     0     0     0     0     8     0     1     0     0     0   163]]

Accuracy: 0.920901746155851

Precision: [0.9786 0.6413 0.9753 0.5745 0.7119 1.0000 0.9118 0.7455 1.0000 0.9982 0.5663 0.9897 0.0000 0.0000 0.6000 1.0000 0.8947 0.4750 0.5000 0.2853 0.9205 1.0000 0.9755 0.5714 0.6000 1.0000 0.9000]
Mean: 0.7339015302976585
Std: 0.2925610094584999

Recall: [0.9315 0.9672 0.8316 0.6585 0.9545 0.0244 0.9688 0.9647 0.9268 0.9771 0.8868 0.9796 0.0000 0.0000 0.6000 0.7000 0.8854 0.2436 0.0690 0.9468 0.9959 0.7500 0.9942 0.3636 1.0000 0.5000 0.9375]
Mean: 0.7058388802212265
Std: 0.3451227372404034

F1 score: [0.9545 0.7712 0.8977 0.6136 0.8155 0.0476 0.9394 0.8410 0.9620 0.9876 0.6912 0.9846 0.0000 0.0000 0.6000 0.8235 0.8901 0.3220 0.1212 0.4384 0.9567 0.8571 0.9848 0.4444 0.7500 0.6667 0.9184]
Mean: 0.6770147885813538
Std: 0.3177850190829588

Cohen Kappa score: 0.8909531367408812
Confusion matrix:
[[3388   29    1   19    0    0    0   69    0    3   36    3    0    0   26    0    2   15    2   28    6    0    1    3    1    0    5]
 [   2   59    0    0    0    0    0    0    0    0    0    0    0    0    0    0    0    0    0    0    0    0    0    0    0    0    0]
 [   0    0   79    0    4    0    2    7    0    0    0    0    0    0    0    0    0    0    0    0    3    0    0    0    0    0    0]
 [   7    0    0   27    0    0    0    0    0    0    0    0    0    0    0    0    7    0    0    0    0    0    0    0    0    0    0]
 [   0    0    0    0   42    0    0    0    0    0    0    0    0    0    0    0    0    0    0    0    0    0    2    0    0    0    0]
 [   0    0    0    0    0    1    0    0    0    0    0    0    0    0    1    0    0    0    0   39    0    0    0    0    0    0    0]
 [   0    0    0    0    1    0   31    0    0    0    0    0    0    0    0    0    0    0    0    0    0    0    0    0    0    0    0]
 [   1    0    0    0    5    0    0  246    0    0    0    0    0    0    0    0    0    0    0    0    3    0    0    0    0    0    0]
 [   1    0    0    0    0    0    0    0   38    0    0    0    0    0    0    0    0    0    0    0    0    0    2    0    0    0    0]
 [  35    0    0    0    0    0    0    0    0 1709    0    0    0    0    2    0    1    0    0    0    0    0    2    0    0    0    0]
 [   6    0    0    0    0    0    0    0    0    0   47    0    0    0    0    0    0    0    0    0    0    0    0    0    0    0    0]
 [   6    0    0    0    0    0    0    0    0    0    0  288    0    0    0    0    0    0    0    0    0    0    0    0    0    0    0]
 [   0    0    0    0    0    0    0    0    0    0    0    0    0    0    0    0    0    0    0   26    0    0    0    0    0    0    0]
 [   0    0    0    0    0    0    0    0    0    0    0    0    0    0    0    0    0    0    0   22    0    0    0    0    0    0    0]
 [   0    0    0    0    0    0    0    1    0    0    0    0    0    0   48    0    0    3    0   25    0    0    3    0    0    0    0]
 [   0    0    0    0    1    0    1    1    0    0    0    0    0    0    0    7    0    0    0    0    0    0    0    0    0    0    0]
 [   9    0    0    1    0    0    0    0    0    0    0    0    0    0    0    0   85    0    0    0    0    0    0    0    1    0    0]
 [   0    0    0    0    0    0    0    0    0    0    0    0    0    0    0    0    0   19    0   59    0    0    0    0    0    0    0]
 [   0    0    0    0    0    0    0    0    0    0    0    0    0    0    2    0    0    1    2   24    0    0    0    0    0    0    0]
 [   2    0    0    0    0    0    0    0    0    0    0    0    0    0    1    0    0    2    0   89    0    0    0    0    0    0    0]
 [   0    0    0    0    0    0    0    1    0    0    0    0    0    0    0    0    0    0    0    0  243    0    0    0    0    0    0]
 [   1    0    1    0    1    0    0    3    0    0    0    0    0    0    0    0    0    0    0    0    8   45    1    0    0    0    0]
 [   0    0    0    0    2    0    0    1    0    0    0    0    0    0    0    0    0    0    0    0    0    0  517    0    0    0    0]
 [   3    4    0    0    0    0    0    0    0    0    0    0    0    0    0    0    0    0    0    0    0    0    0    4    0    0    0]
 [   0    0    0    0    0    0    0    0    0    0    0    0    0    0    0    0    0    0    0    0    0    0    0    0    3    0    0]
 [   0    0    0    0    2    0    0    1    0    0    0    0    0    0    0    0    0    0    0    0    0    0    2    0    0    5    0]
 [   1    0    0    0    1    0    0    0    0    0    0    0    0    0    0    0    0    0    0    0    1    0    0    0    0    0   45]]

