Classifier: RandomForestClassifier
Params: {'bootstrap': True, 'class_weight': None, 'criterion': 'gini', 'max_depth': None, 'max_features': 'auto', 'max_leaf_nodes': None, 'min_impurity_decrease': 0.0, 'min_impurity_split': None, 'min_samples_leaf': 1, 'min_samples_split': 2, 'min_weight_fraction_leaf': 0.0, 'n_estimators': 100, 'n_jobs': 1, 'oob_score': False, 'random_state': None, 'verbose': 0, 'warm_start': False}

Labels: None

Training accuracy: 0.9954391451654939
Training confusion matrix:
[[14708     0     1     3     0     0     0     0     0     0     0     0     0     0     0     0     5     0     0     0     0     0     0     0     0     0     0]
 [    0   237     0     0     0     0     0     0     0     0     0     0     0     0     0     0     0     0     0     0     0     0     0     0     0     0     0]
 [    0     0   265     0     0     0     0     0     0     0     0     0     0     0     0     0     0     0     0     0     0     0     0     0     0     0     0]
 [    2     0     0   201     0     0     0     0     0     0     0     0     0     0     0     0     0     0     0     0     0     0     0     0     0     0     0]
 [    0     0     0     0   208     0     0     0     0     0     0     0     0     0     0     0     0     0     0     0     0     0     0     0     0     0     0]
 [    0     0     0     0     0   139     0     0     0     0     0     0     0     1     1     0     0     1     0     9     0     0     0     0     0     0     0]
 [    0     0     0     0     0     0   119     0     0     0     0     0     0     0     0     0     0     0     0     0     0     0     0     0     0     0     0]
 [    0     0     0     0     0     0     0   990     0     0     0     0     0     0     0     0     0     0     0     0     0     0     0     0     0     0     0]
 [    0     0     0     0     0     0     0     0   183     0     0     0     0     0     0     0     0     0     0     0     0     0     0     0     0     0     0]
 [    0     0     0     0     0     0     0     0     0  6803     0     0     0     0     0     0     0     0     0     0     0     0     0     0     0     0     0]
 [    0     0     0     0     0     0     0     0     0     0   216     0     0     0     0     0     0     0     0     0     0     0     0     0     0     0     0]
 [    0     0     0     0     0     0     0     0     0     0     0  1183     0     0     0     0     0     0     0     0     0     0     0     0     0     0     0]
 [    0     0     0     0     0     0     0     0     0     0     0     0    95     0     0     0     0     4     0    10     0     0     0     0     0     0     0]
 [    0     0     0     0     0     1     0     0     0     0     0     0     1    77     0     0     0     1     0     6     0     0     0     0     0     0     0]
 [    0     0     0     0     0     2     0     0     0     0     0     0     0     1   310     0     0     1     4     0     0     0     0     0     0     0     0]
 [    0     0     0     0     0     0     0     0     0     0     0     0     0     0     0    58     0     0     0     0     0     0     0     0     0     0     0]
 [    1     0     0     0     0     0     0     0     0     0     0     0     0     0     0     0   416     0     0     0     0     0     0     0     0     0     0]
 [    0     0     0     0     0     1     0     0     0     0     0     0     1     3     0     0     0   250     0    19     0     0     0     0     0     0     0]
 [    0     0     0     0     0     2     0     0     0     0     0     0     0     0     7     0     0     2   112     6     0     0     0     0     0     0     0]
 [    0     0     0     0     0     2     0     0     0     0     0     0    11     1     2     0     0    26     0   330     0     0     0     0     0     0     0]
 [    1     0     0     0     0     0     0     0     0     0     0     0     0     0     0     0     0     0     0     0  1003     0     0     0     0     0     0]
 [    0     0     0     0     0     0     0     0     0     0     0     0     0     0     0     0     0     0     0     0     0   210     0     0     0     0     0]
 [    0     0     0     0     0     0     0     0     0     0     0     0     0     0     0     0     0     0     0     0     0     0  2126     0     0     0     0]
 [    1     0     0     0     0     0     0     0     0     0     0     0     0     0     0     0     0     0     0     0     0     0     0    33     0     0     0]
 [    0     0     0     0     0     0     0     0     0     0     0     0     0     0     0     0     0     0     0     0     0     0     0     0    35     0     0]
 [    0     0     0     0     0     0     0     0     0     0     0     0     0     0     0     0     0     0     0     0     0     0     0     0     0    65     0]
 [    0     0     0     0     0     0     0     0     0     0     0     0     0     0     0     0     0     0     0     0     0     0     0     0     0     0   184]]

Accuracy: 0.9706802189210321

Precision: [0.9866 0.9048 0.9891 0.8780 0.8913 0.5278 0.9688 0.9688 1.0000 0.9989 1.0000 1.0000 0.3889 0.5000 0.8554 1.0000 0.9789 0.6812 0.7273 0.5312 0.9680 0.9811 1.0000 0.7273 0.7500 1.0000 1.0000]
Mean: 0.8593831479562203
Std: 0.18317750156231466

Recall: [0.9937 0.9344 0.9579 0.8780 0.9318 0.4634 0.9688 0.9725 0.9756 0.9966 0.8868 0.9966 0.5385 0.4091 0.8875 0.8000 0.9688 0.6026 0.5517 0.5426 0.9918 0.8667 0.9981 0.7273 1.0000 1.0000 0.9583]
Mean: 0.8444053634932607
Std: 0.18787439599957903

F1 score: [0.9901 0.9194 0.9733 0.8780 0.9111 0.4935 0.9688 0.9706 0.9877 0.9977 0.9400 0.9983 0.4516 0.4500 0.8712 0.8889 0.9738 0.6395 0.6275 0.5368 0.9798 0.9204 0.9990 0.7273 0.8571 1.0000 0.9787]
Mean: 0.8492593712861718
Std: 0.18225569696515004

Cohen Kappa score: 0.9588627247468973
Confusion matrix:
[[3614    6    0    5    0    0    0    1    0    1    0    0    0    1    1    0    2    2    0    0    0    1    0    3    0    0    0]
 [   4   57    0    0    0    0    0    0    0    0    0    0    0    0    0    0    0    0    0    0    0    0    0    0    0    0    0]
 [   0    0   91    0    3    0    0    0    0    0    0    0    0    0    0    0    0    0    0    0    1    0    0    0    0    0    0]
 [   5    0    0   36    0    0    0    0    0    0    0    0    0    0    0    0    0    0    0    0    0    0    0    0    0    0    0]
 [   1    0    0    0   41    0    1    1    0    0    0    0    0    0    0    0    0    0    0    0    0    0    0    0    0    0    0]
 [   3    0    0    0    0   19    0    0    0    0    0    0    2    3    1    0    0    3    0   10    0    0    0    0    0    0    0]
 [   0    0    0    0    0    0   31    1    0    0    0    0    0    0    0    0    0    0    0    0    0    0    0    0    0    0    0]
 [   4    0    0    0    0    0    0  248    0    0    0    0    0    0    0    0    0    0    0    0    3    0    0    0    0    0    0]
 [   1    0    0    0    0    0    0    0   40    0    0    0    0    0    0    0    0    0    0    0    0    0    0    0    0    0    0]
 [   6    0    0    0    0    0    0    0    0 1743    0    0    0    0    0    0    0    0    0    0    0    0    0    0    0    0    0]
 [   6    0    0    0    0    0    0    0    0    0   47    0    0    0    0    0    0    0    0    0    0    0    0    0    0    0    0]
 [   1    0    0    0    0    0    0    0    0    0    0  293    0    0    0    0    0    0    0    0    0    0    0    0    0    0    0]
 [   0    0    0    0    0    4    0    0    0    0    0    0   14    2    0    0    0    2    0    4    0    0    0    0    0    0    0]
 [   0    0    0    0    0    1    0    0    0    0    0    0    1    9    0    0    0    3    1    7    0    0    0    0    0    0    0]
 [   3    0    0    0    0    0    0    0    0    0    0    0    1    0   71    0    0    0    2    3    0    0    0    0    0    0    0]
 [   1    0    0    0    0    0    0    1    0    0    0    0    0    0    0    8    0    0    0    0    0    0    0    0    0    0    0]
 [   2    0    0    0    0    0    0    0    0    0    0    0    0    0    0    0   93    0    0    0    0    0    0    0    1    0    0]
 [   0    0    0    0    0    5    0    0    0    0    0    0    3    2    2    0    0   47    1   18    0    0    0    0    0    0    0]
 [   3    0    0    0    0    1    0    0    0    0    0    0    1    1    3    0    0    1   16    3    0    0    0    0    0    0    0]
 [   5    0    0    0    0    6    0    0    0    0    0    0   14    0    5    0    0   11    2   51    0    0    0    0    0    0    0]
 [   0    0    0    0    0    0    0    2    0    0    0    0    0    0    0    0    0    0    0    0  242    0    0    0    0    0    0]
 [   1    0    1    0    0    0    0    2    0    0    0    0    0    0    0    0    0    0    0    0    4   52    0    0    0    0    0]
 [   0    0    0    0    1    0    0    0    0    0    0    0    0    0    0    0    0    0    0    0    0    0  519    0    0    0    0]
 [   2    0    0    0    0    0    0    0    0    1    0    0    0    0    0    0    0    0    0    0    0    0    0    8    0    0    0]
 [   0    0    0    0    0    0    0    0    0    0    0    0    0    0    0    0    0    0    0    0    0    0    0    0    3    0    0]
 [   0    0    0    0    0    0    0    0    0    0    0    0    0    0    0    0    0    0    0    0    0    0    0    0    0   10    0]
 [   1    0    0    0    1    0    0    0    0    0    0    0    0    0    0    0    0    0    0    0    0    0    0    0    0    0   46]]

